NUMERO_ED;École doctorale;Sigle de l'ED;NUMERO_DS;DOMAINE_SCIENTIFIQUE;ANNEE;ANNEE_UNIVERSITAIRE;RENTREE;ANNEE_SOUTENANCE;PREMIERS_INSCRITS;PREMIERS_INSCRITS_F;PREMIERS_INSCRITS_H;TOTAL_INSCRITS;TOTAL_INSCRITS_F;TOTAL_INSCRITS_H;NOMBRE_SOUTENANCES;NOMBRE_SOUTENANCES_F;NOMBRE_SOUTENANCES_H;MOINS_DE_40_MOIS;DE_40_A_52_MOIS;DE_52_A_72_MOIS;PLUS_DE_6_ANS;id_paysage_ED
34;École doctorale Matériaux;;2;Physique;2023;2022-23;2022;2022;9;3;6;39;16;23;16;6;10;8;7;1;0;1Iufh
40;École doctorale Sciences chimiques;EDSC;5;Biologie, médecine et santé;2023;2022-23;2022;2022;0;0;0;6;5;1;3;3;0;1;2;0;0;wde3D
47;École doctorale Physique;;5;Biologie, médecine et santé;2023;2022-23;2022;2022;1;0;1;1;0;1;0;0;0;0;0;0;0;8kNpd
62;École doctorale Sciences de la vie et de la santé;;7;Sciences de la société;2023;2022-23;2022;2022;1;1;0;2;2;0;0;0;0;0;0;0;0;vZzE7
71;École doctorale Sciences pour l'ingénieur;;4;Chimie;2023;2022-23;2022;2022;2;2;0;7;4;3;1;0;1;0;1;0;0;H6UYp
73;École doctorale Sciences économiques, sociales, de l'aménagement et du management;SESAM;7;Sciences de la société;2023;2022-23;2022;2022;29;14;15;151;68;83;22;10;12;4;3;8;7;IQ0Hk
74;École doctorale Sciences juridiques, politique et de gestion;SJPG;7;Sciences de la société;2023;2022-23;2022;2022;45;17;28;255;127;128;24;15;9;0;3;7;14;3A2RY
77;École doctorale Informatique, automatique, électronique, électrotechnique, mathématiques;IAEM;1;Mathématiques et leurs interactions;2023;2022-23;2022;2022;8;0;8;37;6;31;16;0;16;10;4;2;0;TCHTA
77;École doctorale Informatique, automatique, électronique, électrotechnique, mathématiques;IAEM;8;Sciences pour l'ingénieur;2023;2022-23;2022;2022;8;1;7;29;6;23;9;1;8;4;5;0;0;TCHTA
79;École doctorale Sciences juridiques, politiques, économiques et de gestion;SJPEG;7;Sciences de la société;2023;2022-23;2022;2022;34;16;18;197;95;102;17;10;7;0;5;6;6;ea4x6
86;École doctorale Sociétés, humanités, arts, lettres;LSHS;6;Sciences humaines et humanités;2023;2022-23;2022;2022;63;40;23;285;181;104;37;19;18;7;10;10;10;O8E6y
98;École doctorale Droit-Normandie;EDDN;7;Sciences de la société;2023;2022-23;2022;2022;15;8;7;108;45;63;10;5;5;1;1;4;4;9fYyW
101;École doctorale de Sciences juridiques;;7;Sciences de la société;2023;2022-23;2022;2022;21;9;12;172;78;94;17;8;9;0;1;6;10;569G2
104;École doctorale Sciences de la matière, du rayonnement et de l'environnement;SMRE;3;Sciences de la terre et de l'univers, espace;2023;2022-23;2022;2022;10;5;5;38;19;19;13;7;6;6;6;1;0;Q5iFz
104;École doctorale Sciences de la matière, du rayonnement et de l'environnement;SMRE;4;Chimie;2023;2022-23;2022;2022;49;20;29;193;81;112;50;23;27;22;23;4;1;Q5iFz
104;École doctorale Sciences de la matière, du rayonnement et de l'environnement;SMRE;5;Biologie, médecine et santé;2023;2022-23;2022;2022;3;1;2;7;4;3;0;0;0;0;0;0;0;Q5iFz
104;École doctorale Sciences de la matière, du rayonnement et de l'environnement;SMRE;8;Sciences pour l'ingénieur;2023;2022-23;2022;2022;7;4;3;23;7;16;5;1;4;4;1;0;0;Q5iFz
119;École doctorale Science politique;;7;Sciences de la société;2023;2022-23;2022;2022;14;9;5;84;45;39;11;6;5;3;0;3;5;eyibb
127;École doctorale Astronomie et astrophysique d'Ile de France;A&A;3;Sciences de la terre et de l'univers, espace;2023;2022-23;2022;2022;58;22;36;187;64;123;41;9;32;33;8;0;0;cPXrq
129;École doctorale Sciences de l'environnement d'Ile de France;SEIF;3;Sciences de la terre et de l'univers, espace;2023;2022-23;2022;2022;63;23;40;219;105;114;42;24;18;11;28;2;1;TnAPh
129;École doctorale Sciences de l'environnement d'Ile de France;SEIF;4;Chimie;2023;2022-23;2022;2022;0;0;0;1;1;0;0;0;0;0;0;0;0;TnAPh
131;École doctorale Langue, littérature, image, civilisations et sciences humaines (domaines francophone et anglophone);LLI;6;Sciences humaines et humanités;2023;2022-23;2022;2022;25;16;9;151;103;48;15;11;4;1;4;4;6;a47aW
146;École doctorale Galilée;GALILEE;4;Chimie;2023;2022-23;2022;2022;0;0;0;5;5;0;1;0;1;1;0;0;0;71hqm
154;École doctorale Sciences de la vie et de la santé;SVS;5;Biologie, médecine et santé;2023;2022-23;2022;2022;114;76;38;418;254;164;97;61;36;33;59;5;0;hLn36
158;École doctorale Cerveau, cognition, comportement;3C;5;Biologie, médecine et santé;2023;2022-23;2022;2022;130;78;52;431;247;184;87;44;43;17;63;7;0;Il62F
166;École doctorale Information, structures et systèmes;I2S;2;Physique;2023;2022-23;2022;2022;20;3;17;65;15;50;16;5;11;9;7;0;0;2uO68
166;École doctorale Information, structures et systèmes;I2S;8;Sciences pour l'ingénieur;2023;2022-23;2022;2022;18;5;13;101;28;73;35;5;30;15;17;3;0;2uO68
173;École doctorale Sciences de l'univers, de l'environnement et de l'espace;SDU2E;1;Mathématiques et leurs interactions;2023;2022-23;2022;2022;0;0;0;2;0;2;0;0;0;0;0;0;0;R0Z9c
173;École doctorale Sciences de l'univers, de l'environnement et de l'espace;SDU2E;8;Sciences pour l'ingénieur;2023;2022-23;2022;2022;3;1;2;7;2;5;2;0;2;1;1;0;0;R0Z9c
173;École doctorale Sciences de l'univers, de l'environnement et de l'espace;SDU2E;9;Sciences et technologies de l'information et de la communication;2023;2022-23;2022;2022;0;0;0;7;0;7;0;0;0;0;0;0;0;R0Z9c
182;École doctorale Physique et chimie-physique;;2;Physique;2023;2022-23;2022;2022;45;14;31;148;45;103;42;13;29;23;19;0;0;3My6I
184;École doctorale Mathématiques et informatique de Marseille;;1;Mathématiques et leurs interactions;2023;2022-23;2022;2022;29;5;24;104;24;80;17;3;14;6;11;0;0;DDObG
205;École doctorale Interdisciplinaire Sciences-Santé;EDISS;5;Biologie, médecine et santé;2023;2022-23;2022;2022;52;32;20;253;164;89;59;36;23;30;24;5;0;69W38
205;École doctorale Interdisciplinaire Sciences-Santé;EDISS;6;Sciences humaines et humanités;2023;2022-23;2022;2022;5;1;4;15;4;11;3;1;2;2;0;1;0;69W38
205;École doctorale Interdisciplinaire Sciences-Santé;EDISS;8;Sciences pour l'ingénieur;2023;2022-23;2022;2022;1;1;0;2;2;0;0;0;0;0;0;0;0;69W38
211;École doctorale Sciences exactes et leurs applications;ED SEA;4;Chimie;2023;2022-23;2022;2022;19;5;14;93;44;49;33;13;20;22;10;1;0;1G1iC
216;École doctorale Ingénierie pour la santé, la cognition, l'environnement;EDISCE;9;Sciences et technologies de l'information et de la communication;2023;2022-23;2022;2022;1;0;1;1;0;1;0;0;0;0;0;0;0;fPs1t
220;École doctorale Électronique, électrotechnique, automatique, traitement du signal;EEATS;2;Physique;2023;2022-23;2022;2022;4;0;4;5;0;5;1;0;1;0;1;0;0;IxEaw
221;École doctorale Augustin Cournot - Sciences économiques et de gestion - Sciences, technologies et sociétés;EDAC;7;Sciences de la société;2023;2022-23;2022;2022;20;8;12;79;37;42;25;11;14;5;8;10;2;5z9rW
222;École doctorale Sciences chimiques;EDSC;4;Chimie;2023;2022-23;2022;2022;68;31;37;284;121;163;70;31;39;49;21;0;0;AdU8Q
222;École doctorale Sciences chimiques;EDSC;5;Biologie, médecine et santé;2023;2022-23;2022;2022;3;1;2;6;2;4;1;1;0;0;1;0;0;AdU8Q
222;École doctorale Sciences chimiques;EDSC;8;Sciences pour l'ingénieur;2023;2022-23;2022;2022;2;2;0;9;4;5;6;3;3;5;1;0;0;AdU8Q
262;École doctorale Sciences juridiques, politiques, économiques et de gestion;DEG;7;Sciences de la société;2023;2022-23;2022;2022;26;14;12;152;73;79;14;6;8;2;3;2;7;H7GyL
269;École doctorale Mathématiques, sciences de l'information et de l'ingénieur;MSII;1;Mathématiques et leurs interactions;2023;2022-23;2022;2022;12;1;11;43;7;36;10;1;9;7;3;0;0;5E625
286;École doctorale de l'Ehess;;7;Sciences de la société;2023;2022-23;2022;2022;139;70;69;855;457;398;106;68;38;9;8;34;55;2S146
304;École doctorale Sciences et environnements;;10;Sciences agronomiques et écologiques;2023;2022-23;2022;2022;13;10;3;52;29;23;15;7;8;5;10;0;0;2ywZn
305;École doctorale Énergie et environnement;E2;2;Physique;2023;2022-23;2022;2022;2;0;2;9;0;9;1;0;1;1;0;0;0;Kbt8I
305;École doctorale Énergie et environnement;E2;8;Sciences pour l'ingénieur;2023;2022-23;2022;2022;6;2;4;35;5;30;7;2;5;4;3;0;0;Kbt8I
309;École doctorale Systèmes;EDSYS;1;Mathématiques et leurs interactions;2023;2022-23;2022;2022;1;1;0;1;1;0;0;0;0;0;0;0;0;8TT4b
323;École doctorale Génie électrique, électronique et télécommunications;GEET;1;Mathématiques et leurs interactions;2023;2022-23;2022;2022;1;1;0;1;1;0;0;0;0;0;0;0;0;arcz6
323;École doctorale Génie électrique, électronique et télécommunications;GEET;8;Sciences pour l'ingénieur;2023;2022-23;2022;2022;51;13;38;168;32;136;44;13;31;15;20;7;2;arcz6
326;École doctorale Comportement, langage, éducation, socialisation, cognition;CLESCO;9;Sciences et technologies de l'information et de la communication;2023;2022-23;2022;2022;0;0;0;1;1;0;1;1;0;0;1;0;0;nWIlG
327;École doctorale Temps, espaces, sociétés, cultures;TESC;7;Sciences de la société;2023;2022-23;2022;2022;16;9;7;80;50;30;6;5;1;0;0;4;2;IjgiJ
327;École doctorale Temps, espaces, sociétés, cultures;TESC;10;Sciences agronomiques et écologiques;2023;2022-23;2022;2022;0;0;0;6;5;1;0;0;0;0;0;0;0;IjgiJ
328;École doctorale Arts, lettres, langues, philosophie et communication;ALLPH@;5;Biologie, médecine et santé;2023;2022-23;2022;2022;0;0;0;1;1;0;0;0;0;0;0;0;0;xLxMh
353;École doctorale Sciences pour l'ingénieur : mécanique, physique, micro et nanoélectronique;;8;Sciences pour l'ingénieur;2023;2022-23;2022;2022;43;9;34;186;42;144;47;8;39;22;24;1;0;vk5Kp
354;École doctorale Langues, lettres et arts;LLA;6;Sciences humaines et humanités;2023;2022-23;2022;2022;36;20;16;208;136;72;39;28;11;0;5;15;19;RwcSv
355;École doctorale Espaces, cultures, sociétés;;6;Sciences humaines et humanités;2023;2022-23;2022;2022;31;20;11;186;98;88;20;10;10;0;3;7;10;2kMf5
364;École doctorale Sciences fondamentales et appliquées;EDSFA;10;Sciences agronomiques et écologiques;2023;2022-23;2022;2022;2;1;1;8;4;4;0;0;0;0;0;0;0;E483q
377;École doctorale Environnement et société;;1;Mathématiques et leurs interactions;2023;2022-23;2022;2022;1;1;0;1;1;0;0;0;0;0;0;0;0;ZMG5u
377;École doctorale Environnement et société;;3;Sciences de la terre et de l'univers, espace;2023;2022-23;2022;2022;2;1;1;4;2;2;0;0;0;0;0;0;0;ZMG5u
377;École doctorale Environnement et société;;6;Sciences humaines et humanités;2023;2022-23;2022;2022;14;4;10;57;30;27;12;7;5;0;7;3;2;ZMG5u
386;École doctorale Sciences mathématiques de Paris centre;SMPC;1;Mathématiques et leurs interactions;2023;2022-23;2022;2022;112;25;87;476;99;377;120;26;94;55;52;12;1;wMj98
391;École doctorale Sciences mécaniques, acoustique et électronique et robotique de Paris;SMAER;8;Sciences pour l'ingénieur;2023;2022-23;2022;2022;39;10;29;177;49;128;58;13;45;24;32;2;0;k0eue
394;École doctorale Physiologie et physiopathologie;p2t;5;Biologie, médecine et santé;2023;2022-23;2022;2022;58;34;24;230;140;90;62;39;23;24;32;6;0;VMYmT
398;École doctorale Géosciences, ressources naturelles et environnement;GRNE;9;Sciences et technologies de l'information et de la communication;2023;2022-23;2022;2022;0;0;0;1;0;1;0;0;0;0;0;0;0;Zi4Zf
413;École doctorale Sciences de la terre et de l'environnement;STE;5;Biologie, médecine et santé;2023;2022-23;2022;2022;0;0;0;1;0;1;0;0;0;0;0;0;0;u9BA9
413;École doctorale Sciences de la terre et de l'environnement;STE;6;Sciences humaines et humanités;2023;2022-23;2022;2022;2;2;0;14;4;10;1;1;0;0;1;0;0;u9BA9
414;École doctorale Sciences de la vie et de la santé;;2;Physique;2023;2022-23;2022;2022;1;1;0;7;4;3;0;0;0;0;0;0;0;YI4xS
414;École doctorale Sciences de la vie et de la santé;;6;Sciences humaines et humanités;2023;2022-23;2022;2022;0;0;0;2;2;0;4;1;3;3;0;1;0;YI4xS
432;École doctorale Sciences des métiers de l'ingénieur;SMI;8;Sciences pour l'ingénieur;2023;2022-23;2022;2022;145;39;106;437;129;308;83;28;55;40;32;10;1;nSsHB
455;École doctorale Économie, Gestion, Information et Communication;EGIC;6;Sciences humaines et humanités;2023;2022-23;2022;2022;7;3;4;47;25;22;9;5;4;2;2;3;2;qCOg3
459;École doctorale Sciences chimiques Balard;;4;Chimie;2023;2022-23;2022;2022;75;35;40;247;118;129;72;43;29;50;20;2;0;YFs2W
461;École doctorale Droit et science politique;;7;Sciences de la société;2023;2022-23;2022;2022;30;17;13;213;114;99;25;12;13;1;3;8;13;QGArN
463;École doctorale Sciences du mouvement humain;SMH;6;Sciences humaines et humanités;2023;2022-23;2022;2022;3;3;0;15;10;5;1;1;0;0;1;0;0;UbtlY
467;École doctorale Aéronautique, astronautique;AA;9;Sciences et technologies de l'information et de la communication;2023;2022-23;2022;2022;0;0;0;10;4;6;2;0;2;1;1;0;0;U7l45
469;École doctorale du Pacifique;EDP;6;Sciences humaines et humanités;2023;2022-23;2022;2022;10;5;5;31;16;15;0;0;0;0;0;0;0;t9Z2n
472;École doctorale de l'EPHE;;7;Sciences de la société;2023;2022-23;2022;2022;7;2;5;33;16;17;7;5;2;0;1;2;4;27zK4
475;École doctorale Mathématiques, informatique, télécommunications de Toulouse;MITT;1;Mathématiques et leurs interactions;2023;2022-23;2022;2022;29;2;27;147;21;126;40;10;30;25;10;4;1;xcp2r
476;École doctorale Neurosciences et cognition;NSCO;5;Biologie, médecine et santé;2023;2022-23;2022;2022;32;20;12;153;94;59;39;26;13;10;21;6;2;B1H0x
480;École doctorale Montaigne-humanités;;2;Physique;2023;2022-23;2022;2022;2;0;2;10;4;6;3;2;1;0;3;0;0;f3SeZ
480;École doctorale Montaigne-humanités;;6;Sciences humaines et humanités;2023;2022-23;2022;2022;87;49;38;530;288;242;66;36;30;5;8;26;27;f3SeZ
483;École doctorale Histoire, géographie, aménagement, urbanisme, archéologie, science politique, sociologie, anthropologie;SCSO;6;Sciences humaines et humanités;2023;2022-23;2022;2022;56;27;29;335;189;146;47;24;23;6;7;14;20;hc6u4
485;École doctorale Éducation, Psychologie, Information et Communication;EPIC;9;Sciences et technologies de l'information et de la communication;2023;2022-23;2022;2022;0;0;0;4;1;3;0;0;0;0;0;0;0;O82eL
486;École doctorale Sciences économiques et de gestion;SEG;7;Sciences de la société;2023;2022-23;2022;2022;26;15;11;151;78;73;24;12;12;3;11;4;6;h1GZ3
488;École doctorale Sciences, ingénierie, santé;SIS;5;Biologie, médecine et santé;2023;2022-23;2022;2022;27;13;14;103;51;52;14;8;6;9;4;1;0;Fy2lK
488;École doctorale Sciences, ingénierie, santé;SIS;8;Sciences pour l'ingénieur;2023;2022-23;2022;2022;25;11;14;124;44;80;28;7;21;11;15;2;0;Fy2lK
497;École doctorale Normande de Biologie Intégrative, Santé, Environnement;Ed NBISE;5;Biologie, médecine et santé;2023;2022-23;2022;2022;62;40;22;284;168;116;63;30;33;25;31;4;3;0D9Je
509;École doctorale Civilisations et sociétés euro-méditerranéennes et comparées;;7;Sciences de la société;2023;2022-23;2022;2022;19;6;13;116;49;67;15;5;10;1;2;6;6;9tbyG
513;École doctorale Droit et sciences politiques, économiques et de gestion;DESPEG;7;Sciences de la société;2023;2022-23;2022;2022;43;22;21;222;101;121;50;26;24;7;15;15;13;aVHGU
515;École doctorale Complexité du vivant;CdV;5;Biologie, médecine et santé;2023;2022-23;2022;2022;70;39;31;309;177;132;70;39;31;20;49;1;0;CbV9s
515;École doctorale Complexité du vivant;CdV;10;Sciences agronomiques et écologiques;2023;2022-23;2022;2022;0;0;0;1;1;0;0;0;0;0;0;0;0;CbV9s
528;École doctorale Ville, transports et territoires;VTT;6;Sciences humaines et humanités;2023;2022-23;2022;2022;18;13;5;118;72;46;20;17;3;1;6;9;4;68zCc
528;École doctorale Ville, transports et territoires;VTT;8;Sciences pour l'ingénieur;2023;2022-23;2022;2022;3;2;1;16;6;10;5;1;4;3;1;1;0;68zCc
530;École doctorale Organisations, marchés, institutions;OMI;6;Sciences humaines et humanités;2023;2022-23;2022;2022;27;14;13;149;68;81;12;1;11;3;2;3;4;4htv7
530;École doctorale Organisations, marchés, institutions;OMI;9;Sciences et technologies de l'information et de la communication;2023;2022-23;2022;2022;1;1;0;7;6;1;1;1;0;1;0;0;0;4htv7
531;École doctorale Sciences, ingénierie et environnement;SIE;4;Chimie;2023;2022-23;2022;2022;7;4;3;33;21;12;16;10;6;7;8;1;0;b5BYq
531;École doctorale Sciences, ingénierie et environnement;SIE;8;Sciences pour l'ingénieur;2023;2022-23;2022;2022;64;19;45;168;44;124;47;14;33;23;21;3;0;b5BYq
536;École doctorale Sciences et agrosciences;;3;Sciences de la terre et de l'univers, espace;2023;2022-23;2022;2022;3;2;1;9;6;3;0;0;0;0;0;0;0;pHfqe
536;École doctorale Sciences et agrosciences;;4;Chimie;2023;2022-23;2022;2022;5;3;2;12;7;5;4;3;1;2;2;0;0;pHfqe
536;École doctorale Sciences et agrosciences;;5;Biologie, médecine et santé;2023;2022-23;2022;2022;7;5;2;20;10;10;5;3;2;4;1;0;0;pHfqe
536;École doctorale Sciences et agrosciences;;9;Sciences et technologies de l'information et de la communication;2023;2022-23;2022;2022;6;1;5;38;10;28;7;0;7;2;4;1;0;pHfqe
540;"École doctorale École transdisciplinaire ""lettres/sciences""";;5;Biologie, médecine et santé;2023;2022-23;2022;2022;1;1;0;4;3;1;1;0;1;0;0;1;0;tWWw7
541;École doctorale de sciences humaines et sociales de La Réunion;SHS;6;Sciences humaines et humanités;2023;2022-23;2022;2022;12;9;3;93;60;33;12;7;5;0;3;4;5;21SpE
541;École doctorale de sciences humaines et sociales de La Réunion;SHS;9;Sciences et technologies de l'information et de la communication;2023;2022-23;2022;2022;3;2;1;6;3;3;0;0;0;0;0;0;0;21SpE
541;École doctorale de sciences humaines et sociales de La Réunion;SHS;10;Sciences agronomiques et écologiques;2023;2022-23;2022;2022;0;0;0;1;0;1;0;0;0;0;0;0;0;21SpE
542;École doctorale de sciences de La Réunion;STS;2;Physique;2023;2022-23;2022;2022;4;2;2;20;9;11;5;2;3;2;1;1;1;2pAql
543;École doctorale de Dauphine;;7;Sciences de la société;2023;2022-23;2022;2022;57;24;33;274;127;147;59;26;33;6;29;17;7;u8w6A
548;École doctorale Mer et Sciences;;5;Biologie, médecine et santé;2023;2022-23;2022;2022;3;2;1;11;7;4;0;0;0;0;0;0;0;QX0fS
548;École doctorale Mer et Sciences;;9;Sciences et technologies de l'information et de la communication;2023;2022-23;2022;2022;11;3;8;24;7;17;6;1;5;3;3;0;0;QX0fS
553;École doctorale Carnot - Pasteur;;1;Mathématiques et leurs interactions;2023;2022-23;2022;2022;10;1;9;54;12;42;15;3;12;7;5;3;0;6h4Z7
553;École doctorale Carnot - Pasteur;;2;Physique;2023;2022-23;2022;2022;7;1;6;37;12;25;11;2;9;2;6;2;1;6h4Z7
554;École doctorale Environnements - Santé;E-S;5;Biologie, médecine et santé;2023;2022-23;2022;2022;63;35;28;283;151;132;54;32;22;22;27;4;1;ElyFU
558;École doctorale Histoire, Mémoire, Patrimoine, Langage;HMPL;6;Sciences humaines et humanités;2023;2022-23;2022;2022;61;39;22;327;178;149;33;18;15;3;4;13;13;uX3jT
558;École doctorale Histoire, Mémoire, Patrimoine, Langage;HMPL;7;Sciences de la société;2023;2022-23;2022;2022;3;1;2;4;1;3;0;0;0;0;0;0;0;uX3jT
560;École doctorale Sciences de la terre et de l'environnement et Physique de l'univers, Paris;STEP'UP;3;Sciences de la terre et de l'univers, espace;2023;2022-23;2022;2022;40;15;25;157;64;93;41;19;22;19;20;2;0;Z2VI9
565;École doctorale Droit de la Sorbonne;DS;7;Sciences de la société;2023;2022-23;2022;2022;87;50;37;603;314;289;62;23;39;2;8;19;33;aXJ7L
566;École doctorale Sciences du Sport, de la Motricité et du Mouvement Humain;SMMH;5;Biologie, médecine et santé;2023;2022-23;2022;2022;10;8;2;56;27;29;14;4;10;5;6;3;0;3iv8y
569;École doctorale Innovation thérapeutique : du fondamental à l'appliqué;;4;Chimie;2023;2022-23;2022;2022;12;4;8;34;16;18;11;4;7;7;4;0;0;jx8ET
570;École doctorale Santé Publique;EDSP;5;Biologie, médecine et santé;2023;2022-23;2022;2022;31;20;11;151;97;54;30;18;12;11;14;5;0;9lgE4
572;École doctorale Ondes et matière;EDOM;2;Physique;2023;2022-23;2022;2022;49;10;39;194;49;145;42;9;33;17;20;4;1;etSIi
573;École doctorale Interfaces : Approches Interdisciplinaires, Fondements, Applications et Innovation;ED INTERFACES;4;Chimie;2023;2022-23;2022;2022;2;1;1;11;6;5;4;3;1;3;1;0;0;gG820
573;École doctorale Interfaces : Approches Interdisciplinaires, Fondements, Applications et Innovation;ED INTERFACES;5;Biologie, médecine et santé;2023;2022-23;2022;2022;0;0;0;8;2;6;8;4;4;3;4;1;0;gG820
573;École doctorale Interfaces : Approches Interdisciplinaires, Fondements, Applications et Innovation;ED INTERFACES;7;Sciences de la société;2023;2022-23;2022;2022;2;0;2;4;2;2;0;0;0;0;0;0;0;gG820
574;École doctorale de Mathématiques Hadamard;EDMH;1;Mathématiques et leurs interactions;2023;2022-23;2022;2022;103;19;84;349;66;283;95;18;77;62;26;6;1;4pqal
575;École doctorale Electrical, Optical, Bio : Physics and Engineering;EOBE;1;Mathématiques et leurs interactions;2023;2022-23;2022;2022;0;0;0;2;0;2;0;0;0;0;0;0;0;dfhyn
575;École doctorale Electrical, Optical, Bio : Physics and Engineering;EOBE;9;Sciences et technologies de l'information et de la communication;2023;2022-23;2022;2022;3;2;1;16;3;13;5;3;2;2;3;0;0;dfhyn
577;École doctorale Structure et dynamique des systèmes vivants;SDSV;4;Chimie;2023;2022-23;2022;2022;0;0;0;2;1;1;0;0;0;0;0;0;0;4bsxJ
577;École doctorale Structure et dynamique des systèmes vivants;SDSV;5;Biologie, médecine et santé;2023;2022-23;2022;2022;64;41;23;247;149;98;43;22;21;9;31;3;0;4bsxJ
581;École doctorale Agriculture, alimentation, biologie, environnement, santé;ABIES;3;Sciences de la terre et de l'univers, espace;2023;2022-23;2022;2022;0;0;0;1;0;1;0;0;0;0;0;0;0;c1x56
581;École doctorale Agriculture, alimentation, biologie, environnement, santé;ABIES;10;Sciences agronomiques et écologiques;2023;2022-23;2022;2022;31;19;12;117;59;58;28;19;9;11;14;3;0;c1x56
582;École doctorale Cancérologie, Biologie, Médecine, Santé;CBMS;2;Physique;2023;2022-23;2022;2022;0;0;0;1;1;0;0;0;0;0;0;0;0;75bj4
583;École doctorale Risques et Société;;3;Sciences de la terre et de l'univers, espace;2023;2022-23;2022;2022;2;1;1;5;2;3;0;0;0;0;0;0;0;wUBi9
583;École doctorale Risques et Société;;5;Biologie, médecine et santé;2023;2022-23;2022;2022;2;1;1;6;4;2;1;1;0;0;1;0;0;wUBi9
583;École doctorale Risques et Société;;8;Sciences pour l'ingénieur;2023;2022-23;2022;2022;1;0;1;3;0;3;1;0;1;1;0;0;0;wUBi9
585;École doctorale Sciences, Technologie,  Sante;EDSTS;2;Physique;2023;2022-23;2022;2022;10;1;9;39;17;22;7;3;4;4;3;0;0;NM3Dl
585;École doctorale Sciences, Technologie,  Sante;EDSTS;8;Sciences pour l'ingénieur;2023;2022-23;2022;2022;20;8;12;55;23;32;18;9;9;8;6;4;0;NM3Dl
587;École doctorale Diversites, santé et développement en Amazonie;;5;Biologie, médecine et santé;2023;2022-23;2022;2022;4;1;3;19;10;9;1;1;0;0;0;0;1;V14tj
587;École doctorale Diversites, santé et développement en Amazonie;;8;Sciences pour l'ingénieur;2023;2022-23;2022;2022;1;1;0;5;2;3;0;0;0;0;0;0;0;V14tj
587;École doctorale Diversites, santé et développement en Amazonie;;9;Sciences et technologies de l'information et de la communication;2023;2022-23;2022;2022;0;0;0;1;0;1;0;0;0;0;0;0;0;V14tj
591;École doctorale Physique, Sciences de l'Ingenieur, Materiaux, Énergie;PSIME;4;Chimie;2023;2022-23;2022;2022;22;8;14;73;24;49;15;7;8;8;7;0;0;Hn5Om
594;École doctorale Sociétés, Espaces, Pratiques, Temps;ED SEPT;6;Sciences humaines et humanités;2023;2022-23;2022;2022;44;24;20;257;131;126;37;20;17;3;8;14;12;N85H3
596;École doctorale Matière, Molécules et Matériaux;ED 3M;2;Physique;2023;2022-23;2022;2022;30;8;22;90;29;61;23;9;14;15;7;1;0;77947
598;École doctorale Sciences de La Mer et du Littoral;SML;3;Sciences de la terre et de l'univers, espace;2023;2022-23;2022;2022;15;10;5;74;42;32;14;6;8;6;7;0;1;Smen6
598;École doctorale Sciences de La Mer et du Littoral;SML;6;Sciences humaines et humanités;2023;2022-23;2022;2022;5;4;1;12;11;1;2;2;0;0;0;1;1;Smen6
598;École doctorale Sciences de La Mer et du Littoral;SML;10;Sciences agronomiques et écologiques;2023;2022-23;2022;2022;16;6;10;64;31;33;11;7;4;2;8;1;0;Smen6
600;École doctorale Écologie, Géosciences, Agronomie et Alimentation;EGAAL;3;Sciences de la terre et de l'univers, espace;2023;2022-23;2022;2022;25;15;10;84;42;42;19;7;12;14;5;0;0;urS33
602;École doctorale Sciences pour l'Ingénieur;SPI;9;Sciences et technologies de l'information et de la communication;2023;2022-23;2022;2022;13;5;8;29;10;19;0;0;0;0;0;0;0;8yWbu
608;École doctorale Sciences et Ingénierie des Molécules, des Produits, des Procédés et de l'Énergie;SIMPPÉ;4;Chimie;2023;2022-23;2022;2022;2;1;1;10;7;3;2;0;2;1;1;0;0;TyNjM
610;École doctorale Sciences et Ingénierie des Systèmes, Mathématiques, Informatique;SISMI;2;Physique;2023;2022-23;2022;2022;0;0;0;0;0;0;1;0;1;0;1;0;0;dBCUB
613;École doctorale Sciences de la Société, Territoires, Sciences Economiques et de Gestion;SSTSEG;6;Sciences humaines et humanités;2023;2022-23;2022;2022;0;0;0;0;0;0;8;4;4;0;2;1;5;6eLRF
614;École doctorale Chimie, Écologie, Géosciences, Agrosciences - Théodore Monod;CEGA;10;Sciences agronomiques et écologiques;2023;2022-23;2022;2022;0;0;0;0;0;0;5;2;3;2;3;0;0;uc10I
617;École doctorale Sciences de la Société : Territoires, Economie et Droit;SSTED;6;Sciences humaines et humanités;2023;2022-23;2022;2022;6;3;3;62;29;33;5;3;2;1;0;2;2;Kl9ZX
619;École doctorale Sciences Fondamentales et Santé;SFS;4;Chimie;2023;2022-23;2022;2022;4;0;4;14;1;13;6;3;3;3;3;0;0;JiZVW
620;École doctorale Sciences du Numérique et de l'Ingénieur;SNI;4;Chimie;2023;2022-23;2022;2022;1;1;0;1;1;0;0;0;0;0;0;0;0;Dr40w
620;École doctorale Sciences du Numérique et de l'Ingénieur;SNI;5;Biologie, médecine et santé;2023;2022-23;2022;2022;0;0;0;1;0;1;1;1;0;0;0;1;0;Dr40w
621;École doctorale Ingénierie des Systèmes, Matériaux, Mécanique, Énergétique;ISMME;8;Sciences pour l'ingénieur;2023;2022-23;2022;2022;66;20;46;237;63;174;57;17;40;26;28;3;0;B2549
622;École doctorale Sciences du langage;SDL;7;Sciences de la société;2023;2022-23;2022;2022;1;0;1;1;0;1;1;0;1;0;0;1;0;9DsG2
623;École doctorale Savoir, Sciences, Éducation;SSE;2;Physique;2023;2022-23;2022;2022;0;0;0;4;2;2;0;0;0;0;0;0;0;98lMD
623;École doctorale Savoir, Sciences, Éducation;SSE;7;Sciences de la société;2023;2022-23;2022;2022;5;2;3;17;9;8;3;3;0;0;2;1;0;98lMD
624;École doctorale Sciences des Sociétés;SDS;6;Sciences humaines et humanités;2023;2022-23;2022;2022;23;11;12;133;68;65;27;14;13;0;3;13;11;cGIjW
624;École doctorale Sciences des Sociétés;SDS;7;Sciences de la société;2023;2022-23;2022;2022;24;18;6;155;103;52;19;12;7;0;0;8;11;cGIjW
626;École doctorale de l’Institut Polytechnique de Paris;;6;Sciences humaines et humanités;2023;2022-23;2022;2022;4;0;4;29;12;17;5;3;2;1;3;0;1;DL5fO
626;École doctorale de l’Institut Polytechnique de Paris;;8;Sciences pour l'ingénieur;2023;2022-23;2022;2022;20;4;16;110;32;78;21;8;13;10;9;2;0;DL5fO
627;École doctorale Éducation, Didactiques, Cognition;EDC;6;Sciences humaines et humanités;2023;2022-23;2022;2022;12;7;5;78;53;25;8;4;4;1;2;4;1;dE3nH
629;École doctorale Sciences sociales et Humanités;SSH;6;Sciences humaines et humanités;2023;2022-23;2022;2022;29;18;11;140;65;75;10;6;4;0;2;3;5;nnSns
634;École doctorale Sciences, Ingénierie, Environnement;SIE;9;Sciences et technologies de l'information et de la communication;2023;2022-23;2022;2022;7;2;5;25;10;15;2;0;2;0;1;1;0;TOc8f
635;École doctorale Polytechnique Hauts-de-France;PHF;6;Sciences humaines et humanités;2023;2022-23;2022;2022;18;11;7;93;54;39;11;6;5;2;1;4;4;p2m23
636;;;2;Physique;2023;2022-23;2022;2022;0;0;0;4;2;2;1;1;0;0;1;0;0;
636;;;5;Biologie, médecine et santé;2023;2022-23;2022;2022;8;5;3;57;33;24;9;7;2;2;6;1;0;
636;;;9;Sciences et technologies de l'information et de la communication;2023;2022-23;2022;2022;1;0;1;2;0;2;0;0;0;0;0;0;0;
638;École doctorale Science de la Matière, des Molécules et Matériaux;S3M;4;Chimie;2023;2022-23;2022;2022;43;21;22;133;60;73;41;18;23;23;18;0;0;7artx
640;École doctorale Sciences économiques et sciences de gestion - Pays de la Loire;EDGE;7;Sciences de la société;2023;2022-23;2022;2022;16;9;7;71;37;34;24;7;17;5;7;7;5;3sae7
641;École doctorale Mathématiques et Sciences et Technologies du numérique, de l’Information et de la Communication;MaSTIC;1;Mathématiques et leurs interactions;2023;2022-23;2022;2022;21;6;15;67;20;47;18;5;13;9;7;2;0;4kq8w
642;École doctorale Végétal, Animal, Aliment, Mer, Environnement;VAAME;4;Chimie;2023;2022-23;2022;2022;0;0;0;6;2;4;0;0;0;0;0;0;0;jcs9y
645;;;6;Sciences humaines et humanités;2023;2022-23;2022;2022;25;9;16;159;72;87;22;11;11;3;5;8;6;
645;;;7;Sciences de la société;2023;2022-23;2022;2022;15;7;8;79;37;42;14;11;3;1;3;5;5;
646;;;6;Sciences humaines et humanités;2023;2022-23;2022;2022;48;26;22;197;107;90;22;11;11;3;7;6;6;
651;;;8;Sciences pour l'ingénieur;2023;2022-23;2022;2022;35;8;27;166;35;131;0;0;0;0;0;0;0;
651;;;9;Sciences et technologies de l'information et de la communication;2023;2022-23;2022;2022;12;3;9;48;10;38;0;0;0;0;0;0;0;
652;École doctorale Biologie, Chimie, Santé;OMEGA-LIM;4;Chimie;2023;2022-23;2022;2022;2;1;1;6;4;2;1;1;0;0;1;0;0;wh5hf
653;École doctorale Sciences et Ingénierie;S&I;9;Sciences et technologies de l'information et de la communication;2023;2022-23;2022;2022;33;9;24;118;38;80;9;0;9;5;4;0;0;vpw2d
6;École doctorale Droit privé;;7;Sciences de la société;2022;2021-22;2021;2021;35;19;16;252;125;127;26;16;10;1;1;7;17;UMnW1
19;École doctorale Littératures françaises et comparée;;6;Sciences humaines et humanités;2022;2021-22;2021;2021;55;30;25;274;168;106;36;20;16;1;2;14;19;13M43
22;École doctorale Mondes anciens et médiévaux;;6;Sciences humaines et humanités;2022;2021-22;2021;2021;39;24;15;175;98;77;18;10;8;4;1;8;5;fqCbl
42;École doctorale Entreprise, économie, société;EES;7;Sciences de la société;2022;2021-22;2021;2021;22;9;13;111;52;59;18;4;14;4;5;7;2;uO01d
47;École doctorale Physique;;5;Biologie, médecine et santé;2022;2021-22;2021;2021;1;0;1;10;2;8;3;2;1;2;0;1;0;8kNpd
47;École doctorale Physique;;8;Sciences pour l'ingénieur;2022;2021-22;2021;2021;4;1;3;11;3;8;2;0;2;0;2;0;0;8kNpd
47;École doctorale Physique;;9;Sciences et technologies de l'information et de la communication;2022;2021-22;2021;2021;1;0;1;4;1;3;0;0;0;0;0;0;0;8kNpd
50;École doctorale Langues, littératures et sciences humaines;LLSH;9;Sciences et technologies de l'information et de la communication;2022;2021-22;2021;2021;3;1;2;34;18;16;10;2;8;2;3;2;3;8THzQ
60;École doctorale Territoires, temps, sociétés et développement;TTSD;7;Sciences de la société;2022;2021-22;2021;2021;15;9;6;89;48;41;12;6;6;2;1;7;2;fkIh6
71;École doctorale Sciences pour l'ingénieur;;8;Sciences pour l'ingénieur;2022;2021-22;2021;2021;38;16;22;138;51;87;46;15;31;13;30;2;1;H6UYp
78;École doctorale Sociétés, langages, temps, connaissances;STLC;6;Sciences humaines et humanités;2022;2021-22;2021;2021;37;23;14;201;122;79;34;19;15;7;7;15;5;vLU3i
85;École doctorale Sciences de la vie et de la santé;SVS;5;Biologie, médecine et santé;2022;2021-22;2021;2021;72;45;27;206;131;75;40;21;19;9;26;5;0;YdiMF
104;École doctorale Sciences de la matière, du rayonnement et de l'environnement;SMRE;5;Biologie, médecine et santé;2022;2021-22;2021;2021;2;2;0;4;3;1;0;0;0;0;0;0;0;Q5iFz
104;École doctorale Sciences de la matière, du rayonnement et de l'environnement;SMRE;10;Sciences agronomiques et écologiques;2022;2021-22;2021;2021;18;12;6;75;53;22;14;9;5;4;10;0;0;Q5iFz
112;École doctorale Archéologie;;6;Sciences humaines et humanités;2022;2021-22;2021;2021;34;20;14;177;111;66;18;12;6;0;2;2;14;EvU7R
122;École doctorale Europe latine - Amérique latine;;6;Sciences humaines et humanités;2022;2021-22;2021;2021;8;6;2;82;56;26;23;15;8;1;3;9;10;z9lZY
127;École doctorale Astronomie et astrophysique d'Ile de France;A&A;3;Sciences de la terre et de l'univers, espace;2022;2021-22;2021;2021;60;18;42;177;52;125;48;19;29;41;5;2;0;cPXrq
139;École doctorale Connaissance, langage, modélisation;CLM;1;Mathématiques et leurs interactions;2022;2021-22;2021;2021;1;0;1;5;2;3;0;0;0;0;0;0;0;1lxGH
151;École doctorale Biologie, santé, biotechnologies;;5;Biologie, médecine et santé;2022;2021-22;2021;2021;106;65;41;380;245;135;85;51;34;30;47;5;3;yP8w4
154;École doctorale Sciences de la vie et de la santé;SVS;5;Biologie, médecine et santé;2022;2021-22;2021;2021;112;76;36;402;239;163;99;61;38;38;52;9;0;hLn36
159;École doctorale Esthétique, sciences et technologies des arts;EDESTA;6;Sciences humaines et humanités;2022;2021-22;2021;2021;41;29;12;233;147;86;35;22;13;3;7;19;6;zj1Vj
160;École doctorale Électronique, électrotechnique, automatique;EEA;5;Biologie, médecine et santé;2022;2021-22;2021;2021;5;2;3;13;7;6;3;3;0;2;1;0;0;EgfMQ
160;École doctorale Électronique, électrotechnique, automatique;EEA;9;Sciences et technologies de l'information et de la communication;2022;2021-22;2021;2021;27;5;22;123;25;98;33;8;25;17;15;1;0;EgfMQ
166;École doctorale Information, structures et systèmes;I2S;8;Sciences pour l'ingénieur;2022;2021-22;2021;2021;28;10;18;131;32;99;31;6;25;11;19;1;0;2uO68
166;École doctorale Information, structures et systèmes;I2S;9;Sciences et technologies de l'information et de la communication;2022;2021-22;2021;2021;42;10;32;119;29;90;20;4;16;11;6;3;0;2uO68
173;École doctorale Sciences de l'univers, de l'environnement et de l'espace;SDU2E;9;Sciences et technologies de l'information et de la communication;2022;2021-22;2021;2021;3;0;3;6;0;6;0;0;0;0;0;0;0;R0Z9c
173;École doctorale Sciences de l'univers, de l'environnement et de l'espace;SDU2E;10;Sciences agronomiques et écologiques;2022;2021-22;2021;2021;5;4;1;22;11;11;9;5;4;3;3;2;1;R0Z9c
178;École doctorale Sciences fondamentales;;4;Chimie;2022;2021-22;2021;2021;18;8;10;50;22;28;18;5;13;11;7;0;0;1AiR7
182;École doctorale Physique et chimie-physique;;4;Chimie;2022;2021-22;2021;2021;15;6;9;51;21;30;17;9;8;11;5;1;0;3My6I
188;École doctorale Histoire moderne et contemporaine;;6;Sciences humaines et humanités;2022;2021-22;2021;2021;34;17;17;170;83;87;17;8;9;2;4;8;3;RSZ7F
206;École doctorale Chimie : chimie, procédés, environnement;;4;Chimie;2022;2021-22;2021;2021;74;32;42;338;151;187;85;36;49;55;27;2;1;m0UhD
209;École doctorale Sciences physiques et de L'ingénieur;SPI;9;Sciences et technologies de l'information et de la communication;2022;2021-22;2021;2021;39;7;32;167;36;131;28;6;22;8;17;3;0;tZcIZ
211;École doctorale Sciences exactes et leurs applications;ED SEA;4;Chimie;2022;2021-22;2021;2021;20;12;8;107;51;56;19;12;7;14;4;1;0;1G1iC
211;École doctorale Sciences exactes et leurs applications;ED SEA;9;Sciences et technologies de l'information et de la communication;2022;2021-22;2021;2021;2;0;2;18;5;13;8;2;6;2;5;1;0;1G1iC
216;École doctorale Ingénierie pour la santé, la cognition, l'environnement;EDISCE;1;Mathématiques et leurs interactions;2022;2021-22;2021;2021;1;0;1;5;1;4;1;1;0;0;0;1;0;fPs1t
216;École doctorale Ingénierie pour la santé, la cognition, l'environnement;EDISCE;2;Physique;2022;2021-22;2021;2021;0;0;0;3;0;3;0;0;0;0;0;0;0;fPs1t
216;École doctorale Ingénierie pour la santé, la cognition, l'environnement;EDISCE;10;Sciences agronomiques et écologiques;2022;2021-22;2021;2021;2;0;2;4;0;4;1;1;0;1;0;0;0;fPs1t
217;École doctorale Mathématiques, sciences et technologies de l'information, informatique;MSTII;1;Mathématiques et leurs interactions;2022;2021-22;2021;2021;29;10;19;144;38;106;46;7;39;22;20;4;0;Ehx7v
217;École doctorale Mathématiques, sciences et technologies de l'information, informatique;MSTII;2;Physique;2022;2021-22;2021;2021;1;0;1;1;0;1;0;0;0;0;0;0;0;Ehx7v
217;École doctorale Mathématiques, sciences et technologies de l'information, informatique;MSTII;8;Sciences pour l'ingénieur;2022;2021-22;2021;2021;5;3;2;19;9;10;5;2;3;1;2;2;0;Ehx7v
218;École doctorale Chimie et sciences du vivant;EDCSV;4;Chimie;2022;2021-22;2021;2021;27;13;14;118;51;67;24;9;15;12;12;0;0;8bcJh
218;École doctorale Chimie et sciences du vivant;EDCSV;5;Biologie, médecine et santé;2022;2021-22;2021;2021;67;41;26;242;150;92;44;25;19;15;24;4;1;8bcJh
222;École doctorale Sciences chimiques;EDSC;2;Physique;2022;2021-22;2021;2021;4;0;4;11;2;9;0;0;0;0;0;0;0;AdU8Q
224;École doctorale Cognition, langage, interaction;;9;Sciences et technologies de l'information et de la communication;2022;2021-22;2021;2021;13;5;8;35;17;18;11;5;6;3;3;3;2;7v43e
227;École doctorale Sciences de la nature et de l'homme;;2;Physique;2022;2021-22;2021;2021;0;0;0;1;1;0;3;2;1;1;1;1;0;xiDA5
227;École doctorale Sciences de la nature et de l'homme;;5;Biologie, médecine et santé;2022;2021-22;2021;2021;19;11;8;81;46;35;30;18;12;19;11;0;0;xiDA5
227;École doctorale Sciences de la nature et de l'homme;;7;Sciences de la société;2022;2021-22;2021;2021;2;1;1;10;6;4;1;1;0;0;1;0;0;xiDA5
245;École doctorale Sciences économiques, juridiques, politiques et de gestion;;7;Sciences de la société;2022;2021-22;2021;2021;30;13;17;163;68;95;40;13;27;5;11;20;4;ShLUg
251;École doctorale Sciences de l'environnement;;3;Sciences de la terre et de l'univers, espace;2022;2021-22;2021;2021;20;11;9;93;46;47;21;8;13;8;8;5;0;VR28y
251;École doctorale Sciences de l'environnement;;10;Sciences agronomiques et écologiques;2022;2021-22;2021;2021;9;2;7;48;25;23;5;4;1;0;5;0;0;VR28y
261;École doctorale Cognition, comportements, conduites humaines;3CH;6;Sciences humaines et humanités;2022;2021-22;2021;2021;40;30;10;163;114;49;21;14;7;5;14;2;0;KOLCy
269;École doctorale Mathématiques, sciences de l'information et de l'ingénieur;MSII;1;Mathématiques et leurs interactions;2022;2021-22;2021;2021;27;2;25;90;18;72;24;5;19;16;8;0;0;5E625
275;École doctorale Sciences de gestion;EDSG;7;Sciences de la société;2022;2021-22;2021;2021;18;6;12;60;29;31;7;3;4;2;3;1;1;6QC4I
300;École doctorale Sciences Économiques;ED SE;7;Sciences de la société;2022;2021-22;2021;2021;10;4;6;44;16;28;8;3;5;1;1;3;3;5x3fM
304;École doctorale Sciences et environnements;;3;Sciences de la terre et de l'univers, espace;2022;2021-22;2021;2021;8;4;4;22;11;11;5;2;3;1;3;1;0;2ywZn
304;École doctorale Sciences et environnements;;6;Sciences humaines et humanités;2022;2021-22;2021;2021;1;1;0;8;4;4;4;3;1;1;3;0;0;2ywZn
304;École doctorale Sciences et environnements;;7;Sciences de la société;2022;2021-22;2021;2021;3;3;0;12;10;2;0;0;0;0;0;0;0;2ywZn
305;École doctorale Énergie et environnement;E2;1;Mathématiques et leurs interactions;2022;2021-22;2021;2021;1;1;0;3;1;2;2;0;2;2;0;0;0;Kbt8I
309;École doctorale Systèmes;EDSYS;9;Sciences et technologies de l'information et de la communication;2022;2021-22;2021;2021;21;4;17;94;15;79;18;2;16;8;9;1;0;8TT4b
323;École doctorale Génie électrique, électronique et télécommunications;GEET;4;Chimie;2022;2021-22;2021;2021;1;0;1;1;0;1;0;0;0;0;0;0;0;arcz6
326;École doctorale Comportement, langage, éducation, socialisation, cognition;CLESCO;5;Biologie, médecine et santé;2022;2021-22;2021;2021;8;7;1;33;21;12;4;3;1;4;0;0;0;nWIlG
326;École doctorale Comportement, langage, éducation, socialisation, cognition;CLESCO;6;Sciences humaines et humanités;2022;2021-22;2021;2021;42;31;11;240;163;77;42;30;12;7;13;16;6;nWIlG
354;École doctorale Langues, lettres et arts;LLA;6;Sciences humaines et humanités;2022;2021-22;2021;2021;38;28;10;220;152;68;35;21;14;1;11;17;6;RwcSv
361;École doctorale Sciences et Technologies;ED ST;8;Sciences pour l'ingénieur;2022;2021-22;2021;2021;8;3;5;39;12;27;12;2;10;4;7;1;0;cOUmL
361;École doctorale Sciences et Technologies;ED ST;10;Sciences agronomiques et écologiques;2022;2021-22;2021;2021;4;3;1;19;13;6;1;1;0;0;0;1;0;cOUmL
364;École doctorale Sciences fondamentales et appliquées;EDSFA;9;Sciences et technologies de l'information et de la communication;2022;2021-22;2021;2021;3;2;1;6;3;3;0;0;0;0;0;0;0;E483q
370;École doctorale Lettres, sciences humaines et sociales;LSHS;6;Sciences humaines et humanités;2022;2021-22;2021;2021;43;31;12;206;115;91;22;10;12;2;5;9;6;xAXXx
372;École doctorale Sciences économiques et de gestion;;7;Sciences de la société;2022;2021-22;2021;2021;43;24;19;159;89;70;39;17;22;2;20;16;1;JK63A
391;École doctorale Sciences mécaniques, acoustique et électronique et robotique de Paris;SMAER;8;Sciences pour l'ingénieur;2022;2021-22;2021;2021;43;7;36;185;48;137;47;11;36;16;31;0;0;k0eue
395;École doctorale Milieux, cultures et sociétés du passé et du présent;MCSPP;6;Sciences humaines et humanités;2022;2021-22;2021;2021;29;18;11;207;134;73;32;18;14;1;6;10;15;2quEb
397;École doctorale Physique et chimie des matériaux;;4;Chimie;2022;2021-22;2021;2021;72;38;34;195;103;92;53;24;29;29;22;2;0;WxSt9
413;École doctorale Sciences de la terre et de l'environnement;STE;5;Biologie, médecine et santé;2022;2021-22;2021;2021;0;0;0;1;0;1;0;0;0;0;0;0;0;u9BA9
414;École doctorale Sciences de la vie et de la santé;;5;Biologie, médecine et santé;2022;2021-22;2021;2021;136;87;49;483;279;204;122;77;45;40;64;17;1;YI4xS
417;École doctorale Sciences et Ingénierie;S&I;3;Sciences de la terre et de l'univers, espace;2022;2021-22;2021;2021;3;1;2;13;5;8;0;0;0;0;0;0;0;SSBvE
417;École doctorale Sciences et Ingénierie;S&I;4;Chimie;2022;2021-22;2021;2021;12;4;8;34;12;22;6;1;5;1;5;0;0;SSBvE
417;École doctorale Sciences et Ingénierie;S&I;9;Sciences et technologies de l'information et de la communication;2022;2021-22;2021;2021;1;0;1;6;2;4;2;1;1;1;1;0;0;SSBvE
432;École doctorale Sciences des métiers de l'ingénieur;SMI;9;Sciences et technologies de l'information et de la communication;2022;2021-22;2021;2021;9;4;5;24;10;14;7;3;4;6;1;0;0;nSsHB
433;École doctorale Concepts et langages;;9;Sciences et technologies de l'information et de la communication;2022;2021-22;2021;2021;5;3;2;33;24;9;4;1;3;0;1;2;1;v8q34
434;École doctorale Géographie de Paris - Espaces, sociétés, aménagement;EDGP;6;Sciences humaines et humanités;2022;2021-22;2021;2021;34;18;16;241;139;102;26;19;7;1;4;17;4;1FmLX
446;École doctorale Biologie - Santé;EDBSL;6;Sciences humaines et humanités;2022;2021-22;2021;2021;1;0;1;6;1;5;3;2;1;1;2;0;0;4iEUF
458;École doctorale Sciences écologiques, vétérinaires, agronomiques et bioingénieries;SEVAB;10;Sciences agronomiques et écologiques;2022;2021-22;2021;2021;63;35;28;230;129;101;62;30;32;21;39;1;1;Yf3TI
460;École doctorale Sciences juridiques;SJ;7;Sciences de la société;2022;2021-22;2021;2021;22;12;10;135;79;56;13;8;5;0;1;3;9;ZB5I5
461;École doctorale Droit et science politique;;7;Sciences de la société;2022;2021-22;2021;2021;36;24;12;238;122;116;23;11;12;2;3;10;8;QGArN
463;École doctorale Sciences du mouvement humain;SMH;6;Sciences humaines et humanités;2022;2021-22;2021;2021;1;1;0;12;8;4;8;6;2;2;2;3;1;UbtlY
467;École doctorale Aéronautique, astronautique;AA;1;Mathématiques et leurs interactions;2022;2021-22;2021;2021;6;2;4;24;4;20;3;0;3;3;0;0;0;U7l45
467;École doctorale Aéronautique, astronautique;AA;5;Biologie, médecine et santé;2022;2021-22;2021;2021;0;0;0;3;0;3;1;0;1;0;1;0;0;U7l45
469;École doctorale du Pacifique;EDP;6;Sciences humaines et humanités;2022;2021-22;2021;2021;14;5;9;29;14;15;2;2;0;0;0;1;1;t9Z2n
469;École doctorale du Pacifique;EDP;7;Sciences de la société;2022;2021-22;2021;2021;3;1;2;15;5;10;2;1;1;0;1;1;0;t9Z2n
469;École doctorale du Pacifique;EDP;8;Sciences pour l'ingénieur;2022;2021-22;2021;2021;1;0;1;5;1;4;0;0;0;0;0;0;0;t9Z2n
469;École doctorale du Pacifique;EDP;10;Sciences agronomiques et écologiques;2022;2021-22;2021;2021;5;2;3;15;8;7;8;4;4;4;4;0;0;t9Z2n
472;École doctorale de l'EPHE;;5;Biologie, médecine et santé;2022;2021-22;2021;2021;8;5;3;39;25;14;9;5;4;0;5;1;3;27zK4
472;École doctorale de l'EPHE;;8;Sciences pour l'ingénieur;2022;2021-22;2021;2021;1;1;0;2;1;1;0;0;0;0;0;0;0;27zK4
475;École doctorale Mathématiques, informatique, télécommunications de Toulouse;MITT;1;Mathématiques et leurs interactions;2022;2021-22;2021;2021;50;9;41;162;32;130;33;13;20;21;9;2;1;xcp2r
476;École doctorale Neurosciences et cognition;NSCO;5;Biologie, médecine et santé;2022;2021-22;2021;2021;33;21;12;142;88;54;27;13;14;12;9;5;1;B1H0x
480;École doctorale Montaigne-humanités;;3;Sciences de la terre et de l'univers, espace;2022;2021-22;2021;2021;0;0;0;14;6;8;4;2;2;1;1;2;0;f3SeZ
489;École doctorale Sciences et ingénierie des systèmes, de l'environnement et des organisations;SISEO;9;Sciences et technologies de l'information et de la communication;2022;2021-22;2021;2021;0;0;0;0;0;0;1;1;0;0;1;0;0;6pT77
493;École doctorale Erasme;;5;Biologie, médecine et santé;2022;2021-22;2021;2021;5;3;2;19;11;8;3;1;2;0;2;1;0;FPW4T
493;École doctorale Erasme;;6;Sciences humaines et humanités;2022;2021-22;2021;2021;31;21;10;132;86;46;18;12;6;2;1;8;7;FPW4T
497;École doctorale Normande de Biologie Intégrative, Santé, Environnement;Ed NBISE;4;Chimie;2022;2021-22;2021;2021;2;2;0;3;3;0;0;0;0;0;0;0;0;0D9Je
509;École doctorale Civilisations et sociétés euro-méditerranéennes et comparées;;6;Sciences humaines et humanités;2022;2021-22;2021;2021;13;8;5;37;22;15;7;5;2;0;3;3;1;9tbyG
519;École doctorale Sciences humaines et sociales - Perspectives européennes;SHS-PE;7;Sciences de la société;2022;2021-22;2021;2021;16;13;3;86;53;33;7;3;4;0;0;5;2;2f5qs
519;École doctorale Sciences humaines et sociales - Perspectives européennes;SHS-PE;9;Sciences et technologies de l'information et de la communication;2022;2021-22;2021;2021;0;0;0;5;0;5;2;1;1;0;0;0;2;2f5qs
528;École doctorale Ville, transports et territoires;VTT;6;Sciences humaines et humanités;2022;2021-22;2021;2021;14;9;5;96;61;35;23;15;8;1;4;11;7;68zCc
530;École doctorale Organisations, marchés, institutions;OMI;7;Sciences de la société;2022;2021-22;2021;2021;18;7;11;80;40;40;12;6;6;1;4;3;4;4htv7
531;École doctorale Sciences, ingénierie et environnement;SIE;5;Biologie, médecine et santé;2022;2021-22;2021;2021;2;1;1;14;10;4;18;9;9;3;12;3;0;b5BYq
531;École doctorale Sciences, ingénierie et environnement;SIE;9;Sciences et technologies de l'information et de la communication;2022;2021-22;2021;2021;1;0;1;1;0;1;0;0;0;0;0;0;0;b5BYq
532;École doctorale Mathématiques et sciences et technologies de l'information et de la communication;MSTIC;8;Sciences pour l'ingénieur;2022;2021-22;2021;2021;1;0;1;1;0;1;0;0;0;0;0;0;0;t43KM
532;École doctorale Mathématiques et sciences et technologies de l'information et de la communication;MSTIC;9;Sciences et technologies de l'information et de la communication;2022;2021-22;2021;2021;35;6;29;146;37;109;35;8;27;14;15;6;0;t43KM
540;"École doctorale École transdisciplinaire ""lettres/sciences""";;4;Chimie;2022;2021-22;2021;2021;0;0;0;1;0;1;0;0;0;0;0;0;0;tWWw7
540;"École doctorale École transdisciplinaire ""lettres/sciences""";;7;Sciences de la société;2022;2021-22;2021;2021;5;1;4;17;8;9;1;0;1;0;0;1;0;tWWw7
541;École doctorale de sciences humaines et sociales de La Réunion;SHS;3;Sciences de la terre et de l'univers, espace;2022;2021-22;2021;2021;0;0;0;2;1;1;0;0;0;0;0;0;0;21SpE
541;École doctorale de sciences humaines et sociales de La Réunion;SHS;7;Sciences de la société;2022;2021-22;2021;2021;5;2;3;14;4;10;4;2;2;0;2;1;1;21SpE
541;École doctorale de sciences humaines et sociales de La Réunion;SHS;10;Sciences agronomiques et écologiques;2022;2021-22;2021;2021;0;0;0;1;0;1;0;0;0;0;0;0;0;21SpE
542;École doctorale de sciences de La Réunion;STS;3;Sciences de la terre et de l'univers, espace;2022;2021-22;2021;2021;3;2;1;4;3;1;4;2;2;2;2;0;0;2pAql
542;École doctorale de sciences de La Réunion;STS;8;Sciences pour l'ingénieur;2022;2021-22;2021;2021;4;1;3;11;4;7;3;0;3;2;1;0;0;2pAql
544;École doctorale Inter-Med : Espaces, temps, cultures;INTER-MED;7;Sciences de la société;2022;2021-22;2021;2021;8;5;3;104;42;62;13;5;8;3;3;5;2;7VjtD
545;École doctorale Sociétés, politique et santé publique;SP2;5;Biologie, médecine et santé;2022;2021-22;2021;2021;25;21;4;95;62;33;19;9;10;11;6;2;0;IAKR4
545;École doctorale Sociétés, politique et santé publique;SP2;7;Sciences de la société;2022;2021-22;2021;2021;22;10;12;125;62;63;17;9;8;1;2;8;6;IAKR4
549;École doctorale Santé, Sciences Biologiques et Chimie du Vivant;SSBCV;2;Physique;2022;2021-22;2021;2021;0;0;0;1;0;1;0;0;0;0;0;0;0;B9ggO
551;École doctorale Mathématiques, Informatique, Physique Théorique et Ingénierie des Systèmes;MIPTIS;9;Sciences et technologies de l'information et de la communication;2022;2021-22;2021;2021;25;4;21;77;17;60;7;1;6;2;4;1;0;Mpudz
552;École doctorale Énergie - Matériaux - Sciences de la Terre et de l'Univers;EMTSU;4;Chimie;2022;2021-22;2021;2021;9;7;2;39;27;12;11;4;7;4;6;1;0;NTZhw
553;École doctorale Carnot - Pasteur;;2;Physique;2022;2021-22;2021;2021;12;6;6;42;14;28;8;2;6;3;4;1;0;6h4Z7
554;École doctorale Environnements - Santé;E-S;10;Sciences agronomiques et écologiques;2022;2021-22;2021;2021;36;22;14;107;65;42;23;12;11;8;11;4;0;ElyFU
566;École doctorale Sciences du Sport, de la Motricité et du Mouvement Humain;SMMH;6;Sciences humaines et humanités;2022;2021-22;2021;2021;9;4;5;41;22;19;5;3;2;1;3;1;0;3iv8y
567;École doctorale Sciences du Végétal : du gène à l'écosystème;;10;Sciences agronomiques et écologiques;2022;2021-22;2021;2021;17;9;8;57;29;28;8;5;3;2;6;0;0;tuDkA
571;École doctorale Sciences Chimiques : Molécules, Matériaux, Instrumentation et Biosystemes;2MIB;8;Sciences pour l'ingénieur;2022;2021-22;2021;2021;0;0;0;1;0;1;0;0;0;0;0;0;0;zbi37
573;École doctorale Interfaces : Approches Interdisciplinaires, Fondements, Applications et Innovation;ED INTERFACES;7;Sciences de la société;2022;2021-22;2021;2021;1;1;0;2;2;0;0;0;0;0;0;0;0;gG820
573;École doctorale Interfaces : Approches Interdisciplinaires, Fondements, Applications et Innovation;ED INTERFACES;9;Sciences et technologies de l'information et de la communication;2022;2021-22;2021;2021;2;1;1;11;1;10;2;0;2;1;1;0;0;gG820
575;École doctorale Electrical, Optical, Bio : Physics and Engineering;EOBE;4;Chimie;2022;2021-22;2021;2021;0;0;0;3;1;2;0;0;0;0;0;0;0;dfhyn
576;École doctorale Particules, Hadrons, Énergie, Noyau, Instrumentation, Imagerie, Cosmos et Simulation;PHENIICS;4;Chimie;2022;2021-22;2021;2021;0;0;0;9;4;5;0;0;0;0;0;0;0;qC4rf
577;École doctorale Structure et dynamique des systèmes vivants;SDSV;10;Sciences agronomiques et écologiques;2022;2021-22;2021;2021;3;2;1;7;2;5;0;0;0;0;0;0;0;4bsxJ
581;École doctorale Agriculture, alimentation, biologie, environnement, santé;ABIES;4;Chimie;2022;2021-22;2021;2021;0;0;0;4;3;1;2;1;1;1;1;0;0;c1x56
581;École doctorale Agriculture, alimentation, biologie, environnement, santé;ABIES;7;Sciences de la société;2022;2021-22;2021;2021;21;10;11;67;41;26;14;8;6;4;7;3;0;c1x56
582;École doctorale Cancérologie, Biologie, Médecine, Santé;CBMS;2;Physique;2022;2021-22;2021;2021;1;0;1;1;0;1;0;0;0;0;0;0;0;75bj4
585;École doctorale Sciences, Technologie,  Sante;EDSTS;2;Physique;2022;2021-22;2021;2021;11;6;5;39;19;20;7;4;3;2;3;2;0;NM3Dl
585;École doctorale Sciences, Technologie,  Sante;EDSTS;9;Sciences et technologies de l'information et de la communication;2022;2021-22;2021;2021;21;4;17;74;21;53;24;9;15;10;13;1;0;NM3Dl
587;École doctorale Diversites, santé et développement en Amazonie;;3;Sciences de la terre et de l'univers, espace;2022;2021-22;2021;2021;0;0;0;2;1;1;0;0;0;0;0;0;0;V14tj
588;École doctorale Milieu insulaire tropical : dynamiques de développement, sociétés, patrimoine et culture dans l'espace Caraïbes-Amériques;;7;Sciences de la société;2022;2021-22;2021;2021;15;10;5;58;36;22;9;5;4;0;2;1;6;4W5IO
590;École doctorale Mathematiques, Information, Ingenierie des Systemes;MIIS;9;Sciences et technologies de l'information et de la communication;2022;2021-22;2021;2021;43;12;31;146;34;112;35;10;25;17;17;1;0;L20t5
591;École doctorale Physique, Sciences de l'Ingenieur, Materiaux, Énergie;PSIME;3;Sciences de la terre et de l'univers, espace;2022;2021-22;2021;2021;3;0;3;9;1;8;2;0;2;2;0;0;0;Hn5Om
596;École doctorale Matière, Molécules et Matériaux;ED 3M;4;Chimie;2022;2021-22;2021;2021;75;34;41;248;110;138;71;30;41;45;23;3;0;77947
598;École doctorale Sciences de La Mer et du Littoral;SML;3;Sciences de la terre et de l'univers, espace;2022;2021-22;2021;2021;30;13;17;85;43;42;16;6;10;5;10;1;0;Smen6
598;École doctorale Sciences de La Mer et du Littoral;SML;5;Biologie, médecine et santé;2022;2021-22;2021;2021;11;9;2;58;37;21;10;4;6;3;7;0;0;Smen6
598;École doctorale Sciences de La Mer et du Littoral;SML;7;Sciences de la société;2022;2021-22;2021;2021;5;3;2;16;9;7;3;2;1;0;2;0;1;Smen6
600;École doctorale Écologie, Géosciences, Agronomie et Alimentation;EGAAL;3;Sciences de la terre et de l'univers, espace;2022;2021-22;2021;2021;20;10;10;66;24;42;16;8;8;10;6;0;0;urS33
600;École doctorale Écologie, Géosciences, Agronomie et Alimentation;EGAAL;10;Sciences agronomiques et écologiques;2022;2021-22;2021;2021;52;27;25;188;103;85;53;30;23;28;24;1;0;urS33
604;École doctorale Sociétés, Temps, Territoires;STT;6;Sciences humaines et humanités;2022;2021-22;2021;2021;70;37;33;371;181;190;55;21;34;10;10;15;20;SZI5T
605;École doctorale Biologie Santé;ED BS;6;Sciences humaines et humanités;2022;2021-22;2021;2021;1;0;1;2;0;2;0;0;0;0;0;0;0;w8CxU
610;École doctorale Sciences et Ingénierie des Systèmes, Mathématiques, Informatique;SISMI;2;Physique;2022;2021-22;2021;2021;5;3;2;18;8;10;5;1;4;2;2;1;0;dBCUB
614;École doctorale Chimie, Écologie, Géosciences, Agrosciences - Théodore Monod;CEGA;5;Biologie, médecine et santé;2022;2021-22;2021;2021;7;4;3;14;8;6;4;2;2;3;1;0;0;uc10I
615;École doctorale Sciences Biologiques et Santé;SBS;5;Biologie, médecine et santé;2022;2021-22;2021;2021;48;29;19;172;100;72;35;19;16;14;17;4;0;TNa15
616;École doctorale Humanités et Langues;H&L;5;Biologie, médecine et santé;2022;2021-22;2021;2021;2;1;1;7;3;4;0;0;0;0;0;0;0;FYOlf
617;École doctorale Sciences de la Société : Territoires, Economie et Droit;SSTED;3;Sciences de la terre et de l'univers, espace;2022;2021-22;2021;2021;0;0;0;2;1;1;0;0;0;0;0;0;0;Kl9ZX
617;École doctorale Sciences de la Société : Territoires, Economie et Droit;SSTED;6;Sciences humaines et humanités;2022;2021-22;2021;2021;9;5;4;71;36;35;9;3;6;2;3;2;2;Kl9ZX
618;École doctorale EUCLIDE;;5;Biologie, médecine et santé;2022;2021-22;2021;2021;3;1;2;9;3;6;3;0;3;0;3;0;0;qveTN
619;École doctorale Sciences Fondamentales et Santé;SFS;6;Sciences humaines et humanités;2022;2021-22;2021;2021;0;0;0;2;0;2;1;0;1;0;0;0;1;JiZVW
620;École doctorale Sciences du Numérique et de l'Ingénieur;SNI;2;Physique;2022;2021-22;2021;2021;2;0;2;12;5;7;2;1;1;1;1;0;0;Dr40w
620;École doctorale Sciences du Numérique et de l'Ingénieur;SNI;3;Sciences de la terre et de l'univers, espace;2022;2021-22;2021;2021;1;0;1;1;0;1;0;0;0;0;0;0;0;Dr40w
622;École doctorale Sciences du langage;SDL;6;Sciences humaines et humanités;2022;2021-22;2021;2021;41;32;9;271;196;75;37;23;14;2;13;12;10;9DsG2
623;École doctorale Savoir, Sciences, Éducation;SSE;2;Physique;2022;2021-22;2021;2021;1;1;0;4;2;2;0;0;0;0;0;0;0;98lMD
623;École doctorale Savoir, Sciences, Éducation;SSE;7;Sciences de la société;2022;2021-22;2021;2021;4;2;2;16;10;6;6;3;3;0;1;5;0;98lMD
624;École doctorale Sciences des Sociétés;SDS;6;Sciences humaines et humanités;2022;2021-22;2021;2021;24;12;12;153;81;72;30;16;14;3;5;13;9;cGIjW
626;École doctorale de l’Institut Polytechnique de Paris;;4;Chimie;2022;2021-22;2021;2021;11;8;3;41;22;19;12;6;6;8;3;1;0;DL5fO
626;École doctorale de l’Institut Polytechnique de Paris;;6;Sciences humaines et humanités;2022;2021-22;2021;2021;11;6;5;32;16;16;4;1;3;0;2;2;0;DL5fO
626;École doctorale de l’Institut Polytechnique de Paris;;9;Sciences et technologies de l'information et de la communication;2022;2021-22;2021;2021;68;24;44;311;90;221;80;22;58;38;33;9;0;DL5fO
629;École doctorale Sciences sociales et Humanités;SSH;6;Sciences humaines et humanités;2022;2021-22;2021;2021;28;10;18;136;60;76;14;7;7;0;2;5;7;nnSns
633;École doctorale Cultures, Sociétés, Territoires;CST;9;Sciences et technologies de l'information et de la communication;2022;2021-22;2021;2021;1;1;0;7;2;5;0;0;0;0;0;0;0;54818
634;École doctorale Sciences, Ingénierie, Environnement;SIE;2;Physique;2022;2021-22;2021;2021;0;0;0;2;0;2;0;0;0;0;0;0;0;TOc8f
634;École doctorale Sciences, Ingénierie, Environnement;SIE;3;Sciences de la terre et de l'univers, espace;2022;2021-22;2021;2021;2;0;2;8;4;4;0;0;0;0;0;0;0;TOc8f
634;École doctorale Sciences, Ingénierie, Environnement;SIE;9;Sciences et technologies de l'information et de la communication;2022;2021-22;2021;2021;8;3;5;16;6;10;0;0;0;0;0;0;0;TOc8f
635;École doctorale Polytechnique Hauts-de-France;PHF;7;Sciences de la société;2022;2021-22;2021;2021;5;4;1;19;11;8;0;0;0;0;0;0;0;p2m23
635;École doctorale Polytechnique Hauts-de-France;PHF;8;Sciences pour l'ingénieur;2022;2021-22;2021;2021;8;0;8;41;10;31;3;2;1;0;3;0;0;p2m23
6;École doctorale Droit privé;;7;Sciences de la société;2021;2020-21;2020;2020;37;21;16;277;143;134;25;9;16;0;8;6;11;UMnW1
20;École doctorale Civilisations, cultures, littératures et sociétés;;6;Sciences humaines et humanités;2021;2020-21;2020;2020;42;32;10;205;151;54;29;21;8;4;13;10;2;agjNi
22;École doctorale Mondes anciens et médiévaux;;6;Sciences humaines et humanités;2021;2020-21;2020;2020;38;18;20;159;87;72;19;11;8;6;3;6;4;fqCbl
37;École doctorale Sciences physiques pour l'ingénieur et microtechniques;SPIM;9;Sciences et technologies de l'information et de la communication;2021;2020-21;2020;2020;54;17;37;212;65;147;51;19;32;24;20;6;1;F7G1B
39;École doctorale Mathématiques et Informatique;EDMIB;9;Sciences et technologies de l'information et de la communication;2021;2020-21;2020;2020;30;11;19;118;27;91;24;6;18;14;7;3;0;TBj2X
47;École doctorale Physique;;3;Sciences de la terre et de l'univers, espace;2021;2020-21;2020;2020;2;0;2;9;2;7;0;0;0;0;0;0;0;8kNpd
47;École doctorale Physique;;8;Sciences pour l'ingénieur;2021;2020-21;2020;2020;1;0;1;9;2;7;1;1;0;1;0;0;0;8kNpd
58;École doctorale Langues, littératures, cultures, civilisations;LLCC;6;Sciences humaines et humanités;2021;2020-21;2020;2020;105;67;38;467;275;192;47;29;18;4;13;14;16;I9ATR
62;École doctorale Sciences de la vie et de la santé;;1;Mathématiques et leurs interactions;2021;2020-21;2020;2020;0;0;0;0;0;0;1;0;1;1;0;0;0;vZzE7
62;École doctorale Sciences de la vie et de la santé;;4;Chimie;2021;2020-21;2020;2020;0;0;0;1;1;0;0;0;0;0;0;0;0;vZzE7
62;École doctorale Sciences de la vie et de la santé;;7;Sciences de la société;2021;2020-21;2020;2020;0;0;0;1;0;1;0;0;0;0;0;0;0;vZzE7
70;École doctorale Sciences pour l'ingénieur;EDSPI;9;Sciences et technologies de l'information et de la communication;2021;2020-21;2020;2020;1;0;1;41;11;30;16;6;10;5;8;3;0;G413P
71;École doctorale Sciences pour l'ingénieur;;5;Biologie, médecine et santé;2021;2020-21;2020;2020;3;0;3;10;4;6;3;2;1;0;3;0;0;H6UYp
72;École doctorale Sciences pour l'ingénieur;SPI;8;Sciences pour l'ingénieur;2021;2020-21;2020;2020;59;17;42;226;69;157;64;15;49;39;22;3;0;47QPx
77;École doctorale Informatique, automatique, électronique, électrotechnique, mathématiques;IAEM;9;Sciences et technologies de l'information et de la communication;2021;2020-21;2020;2020;74;14;60;288;71;217;53;13;40;21;25;7;0;TCHTA
84;École doctorale Sciences et technologies de l'information et de la communication;STIC;1;Mathématiques et leurs interactions;2021;2020-21;2020;2020;0;0;0;0;0;0;1;0;1;0;1;0;0;9wS2W
84;École doctorale Sciences et technologies de l'information et de la communication;STIC;9;Sciences et technologies de l'information et de la communication;2021;2020-21;2020;2020;71;17;54;229;65;164;43;11;32;24;16;3;0;9wS2W
85;École doctorale Sciences de la vie et de la santé;SVS;5;Biologie, médecine et santé;2021;2020-21;2020;2020;49;31;18;178;109;69;52;38;14;16;32;4;0;YdiMF
98;École doctorale Droit-Normandie;EDDN;7;Sciences de la société;2021;2020-21;2020;2020;15;8;7;111;46;65;10;6;4;0;0;1;9;9fYyW
112;École doctorale Archéologie;;6;Sciences humaines et humanités;2021;2020-21;2020;2020;25;16;9;178;113;65;19;9;10;1;1;11;6;EvU7R
122;École doctorale Europe latine - Amérique latine;;7;Sciences de la société;2021;2020-21;2020;2020;3;1;2;41;25;16;2;2;0;0;0;0;2;z9lZY
124;École doctorale Histoire de l'art et archéologie;;6;Sciences humaines et humanités;2021;2020-21;2020;2020;26;18;8;149;105;44;15;8;7;0;3;7;5;MBN4L
129;École doctorale Sciences de l'environnement d'Ile de France;SEIF;3;Sciences de la terre et de l'univers, espace;2021;2020-21;2020;2020;54;22;32;184;90;94;33;16;17;23;10;0;0;TnAPh
129;École doctorale Sciences de l'environnement d'Ile de France;SEIF;4;Chimie;2021;2020-21;2020;2020;0;0;0;2;2;0;0;0;0;0;0;0;0;TnAPh
129;École doctorale Sciences de l'environnement d'Ile de France;SEIF;7;Sciences de la société;2021;2020-21;2020;2020;1;0;1;1;0;1;0;0;0;0;0;0;0;TnAPh
130;École doctorale Informatique, télécommunications et électronique de Paris;EDITE;9;Sciences et technologies de l'information et de la communication;2021;2020-21;2020;2020;104;23;81;480;102;378;83;16;67;58;24;1;0;O5ysj
139;École doctorale Connaissance, langage, modélisation;CLM;8;Sciences pour l'ingénieur;2021;2020-21;2020;2020;3;0;3;19;3;16;3;1;2;1;2;0;0;1lxGH
158;École doctorale Cerveau, cognition, comportement;3C;5;Biologie, médecine et santé;2021;2020-21;2020;2020;109;64;45;381;212;169;60;33;27;18;39;3;0;Il62F
158;École doctorale Cerveau, cognition, comportement;3C;6;Sciences humaines et humanités;2021;2020-21;2020;2020;2;1;1;10;1;9;0;0;0;0;0;0;0;Il62F
162;École doctorale Mécanique, énergétique, génie civil, acoustique;MEGA;5;Biologie, médecine et santé;2021;2020-21;2020;2020;8;5;3;39;14;25;7;4;3;4;3;0;0;7wCke
166;École doctorale Information, structures et systèmes;I2S;3;Sciences de la terre et de l'univers, espace;2021;2020-21;2020;2020;0;0;0;2;0;2;0;0;0;0;0;0;0;2uO68
166;École doctorale Information, structures et systèmes;I2S;9;Sciences et technologies de l'information et de la communication;2021;2020-21;2020;2020;32;11;21;94;22;72;26;5;21;15;7;4;0;2uO68
168;École doctorale Sciences chimiques et biologiques pour la santé;SCBS;5;Biologie, médecine et santé;2021;2020-21;2020;2020;116;67;49;425;240;185;90;51;39;40;47;3;0;8cEME
173;École doctorale Sciences de l'univers, de l'environnement et de l'espace;SDU2E;1;Mathématiques et leurs interactions;2021;2020-21;2020;2020;1;0;1;1;0;1;0;0;0;0;0;0;0;R0Z9c
173;École doctorale Sciences de l'univers, de l'environnement et de l'espace;SDU2E;9;Sciences et technologies de l'information et de la communication;2021;2020-21;2020;2020;3;0;3;3;0;3;0;0;0;0;0;0;0;R0Z9c
173;École doctorale Sciences de l'univers, de l'environnement et de l'espace;SDU2E;10;Sciences agronomiques et écologiques;2021;2020-21;2020;2020;4;1;3;26;12;14;1;1;0;0;1;0;0;R0Z9c
182;École doctorale Physique et chimie-physique;;4;Chimie;2021;2020-21;2020;2020;27;14;13;101;46;55;27;13;14;21;6;0;0;3My6I
182;École doctorale Physique et chimie-physique;;9;Sciences et technologies de l'information et de la communication;2021;2020-21;2020;2020;0;0;0;1;0;1;0;0;0;0;0;0;0;3My6I
206;École doctorale Chimie : chimie, procédés, environnement;;5;Biologie, médecine et santé;2021;2020-21;2020;2020;0;0;0;1;0;1;0;0;0;0;0;0;0;m0UhD
211;École doctorale Sciences exactes et leurs applications;ED SEA;2;Physique;2021;2020-21;2020;2020;8;2;6;17;7;10;4;2;2;4;0;0;0;1G1iC
216;École doctorale Ingénierie pour la santé, la cognition, l'environnement;EDISCE;1;Mathématiques et leurs interactions;2021;2020-21;2020;2020;2;0;2;6;2;4;3;0;3;2;1;0;0;fPs1t
217;École doctorale Mathématiques, sciences et technologies de l'information, informatique;MSTII;1;Mathématiques et leurs interactions;2021;2020-21;2020;2020;31;9;22;93;19;74;18;4;14;10;8;0;0;Ehx7v
217;École doctorale Mathématiques, sciences et technologies de l'information, informatique;MSTII;10;Sciences agronomiques et écologiques;2021;2020-21;2020;2020;0;0;0;2;0;2;0;0;0;0;0;0;0;Ehx7v
220;École doctorale Électronique, électrotechnique, automatique, traitement du signal;EEATS;1;Mathématiques et leurs interactions;2021;2020-21;2020;2020;4;0;4;9;2;7;2;0;2;0;2;0;0;IxEaw
222;École doctorale Sciences chimiques;EDSC;2;Physique;2021;2020-21;2020;2020;4;3;1;9;4;5;2;1;1;1;1;0;0;AdU8Q
222;École doctorale Sciences chimiques;EDSC;8;Sciences pour l'ingénieur;2021;2020-21;2020;2020;3;0;3;9;3;6;1;0;1;0;1;0;0;AdU8Q
224;École doctorale Cognition, langage, interaction;;8;Sciences pour l'ingénieur;2021;2020-21;2020;2020;4;2;2;14;8;6;1;0;1;1;0;0;0;7v43e
227;École doctorale Sciences de la nature et de l'homme;;2;Physique;2021;2020-21;2020;2020;0;0;0;4;2;2;1;0;1;1;0;0;0;xiDA5
251;École doctorale Sciences de l'environnement;;8;Sciences pour l'ingénieur;2021;2020-21;2020;2020;5;3;2;17;9;8;3;3;0;2;1;0;0;VR28y
269;École doctorale Mathématiques, sciences de l'information et de l'ingénieur;MSII;5;Biologie, médecine et santé;2021;2020-21;2020;2020;1;1;0;8;3;5;0;0;0;0;0;0;0;5E625
269;École doctorale Mathématiques, sciences de l'information et de l'ingénieur;MSII;8;Sciences pour l'ingénieur;2021;2020-21;2020;2020;18;5;13;74;23;51;18;6;12;8;7;3;0;5E625
270;École doctorale Théologie et sciences religieuses;;6;Sciences humaines et humanités;2021;2020-21;2020;2020;10;5;5;96;36;60;15;2;13;3;2;4;6;BRKC1
279;École doctorale Arts plastiques, esthétique et sciences de l'art;APESA;6;Sciences humaines et humanités;2021;2020-21;2020;2020;23;17;6;159;112;47;15;11;4;1;2;5;7;BpW1j
286;École doctorale de l'Ehess;;6;Sciences humaines et humanités;2021;2020-21;2020;2020;80;46;34;469;243;226;65;34;31;6;7;19;33;2S146
305;École doctorale Énergie et environnement;E2;8;Sciences pour l'ingénieur;2021;2020-21;2020;2020;8;1;7;39;11;28;9;4;5;5;3;1;0;Kbt8I
309;École doctorale Systèmes;EDSYS;9;Sciences et technologies de l'information et de la communication;2021;2020-21;2020;2020;18;3;15;93;16;77;22;10;12;12;10;0;0;8TT4b
326;École doctorale Comportement, langage, éducation, socialisation, cognition;CLESCO;8;Sciences pour l'ingénieur;2021;2020-21;2020;2020;0;0;0;1;0;1;0;0;0;0;0;0;0;nWIlG
328;École doctorale Arts, lettres, langues, philosophie et communication;ALLPH@;6;Sciences humaines et humanités;2021;2020-21;2020;2020;65;35;30;320;201;119;17;8;9;1;2;10;4;xLxMh
361;École doctorale Sciences et Technologies;ED ST;9;Sciences et technologies de l'information et de la communication;2021;2020-21;2020;2020;28;12;16;143;60;83;19;8;11;7;10;2;0;cOUmL
370;École doctorale Lettres, sciences humaines et sociales;LSHS;9;Sciences et technologies de l'information et de la communication;2021;2020-21;2020;2020;0;0;0;0;0;0;1;1;0;0;1;0;0;xAXXx
377;École doctorale Environnement et société;;4;Chimie;2021;2020-21;2020;2020;2;0;2;7;1;6;0;0;0;0;0;0;0;ZMG5u
386;École doctorale Sciences mathématiques de Paris centre;SMPC;9;Sciences et technologies de l'information et de la communication;2021;2020-21;2020;2020;0;0;0;1;0;1;0;0;0;0;0;0;0;wMj98
393;École doctorale Pierre Louis de Santé Publique : Épidémiologie et Sciences de l'information biomédicale;PLSP;5;Biologie, médecine et santé;2021;2020-21;2020;2020;60;31;29;227;124;103;55;32;23;26;21;4;4;69445
432;École doctorale Sciences des métiers de l'ingénieur;SMI;1;Mathématiques et leurs interactions;2021;2020-21;2020;2020;0;0;0;7;2;5;1;0;1;1;0;0;0;nSsHB
432;École doctorale Sciences des métiers de l'ingénieur;SMI;2;Physique;2021;2020-21;2020;2020;1;0;1;1;0;1;0;0;0;0;0;0;0;nSsHB
432;École doctorale Sciences des métiers de l'ingénieur;SMI;8;Sciences pour l'ingénieur;2021;2020-21;2020;2020;105;32;73;362;113;249;77;20;57;47;26;4;0;nSsHB
433;École doctorale Concepts et langages;;9;Sciences et technologies de l'information et de la communication;2021;2020-21;2020;2020;7;3;4;56;31;25;5;4;1;0;2;1;2;v8q34
434;École doctorale Géographie de Paris - Espaces, sociétés, aménagement;EDGP;6;Sciences humaines et humanités;2021;2020-21;2020;2020;30;17;13;247;148;99;30;19;11;5;7;11;7;1FmLX
454;École doctorale Sciences de l'homme, du politique et du territoire;SHPT;7;Sciences de la société;2021;2020-21;2020;2020;19;14;5;82;48;34;13;9;4;0;1;7;5;Opv31
460;École doctorale Sciences juridiques;SJ;6;Sciences humaines et humanités;2021;2020-21;2020;2020;15;9;6;16;10;6;0;0;0;0;0;0;0;ZB5I5
461;École doctorale Droit et science politique;;7;Sciences de la société;2021;2020-21;2020;2020;44;20;24;251;121;130;28;20;8;2;6;9;11;QGArN
463;École doctorale Sciences du mouvement humain;SMH;6;Sciences humaines et humanités;2021;2020-21;2020;2020;5;4;1;17;11;6;3;2;1;2;0;1;0;UbtlY
463;École doctorale Sciences du mouvement humain;SMH;8;Sciences pour l'ingénieur;2021;2020-21;2020;2020;10;2;8;41;16;25;10;4;6;1;6;2;1;UbtlY
467;École doctorale Aéronautique, astronautique;AA;4;Chimie;2021;2020-21;2020;2020;0;0;0;1;0;1;1;1;0;1;0;0;0;U7l45
467;École doctorale Aéronautique, astronautique;AA;5;Biologie, médecine et santé;2021;2020-21;2020;2020;2;0;2;5;0;5;0;0;0;0;0;0;0;U7l45
467;École doctorale Aéronautique, astronautique;AA;7;Sciences de la société;2021;2020-21;2020;2020;0;0;0;6;4;2;0;0;0;0;0;0;0;U7l45
469;École doctorale du Pacifique;EDP;10;Sciences agronomiques et écologiques;2021;2020-21;2020;2020;1;1;0;17;11;6;2;1;1;0;2;0;0;t9Z2n
476;École doctorale Neurosciences et cognition;NSCO;6;Sciences humaines et humanités;2021;2020-21;2020;2020;3;2;1;23;15;8;4;2;2;3;0;0;1;B1H0x
481;École doctorale Sciences sociales et humanités;SSH;7;Sciences de la société;2021;2020-21;2020;2020;32;14;18;168;79;89;20;11;9;2;4;6;8;E3z5j
487;École doctorale Philosophie;PHCR;6;Sciences humaines et humanités;2021;2020-21;2020;2020;28;9;19;148;68;80;18;6;12;3;8;5;2;3BRzJ
489;École doctorale Sciences et ingénierie des systèmes, de l'environnement et des organisations;SISEO;3;Sciences de la terre et de l'univers, espace;2021;2020-21;2020;2020;2;2;0;9;6;3;2;1;1;1;0;1;0;6pT77
489;École doctorale Sciences et ingénierie des systèmes, de l'environnement et des organisations;SISEO;4;Chimie;2021;2020-21;2020;2020;0;0;0;10;6;4;2;2;0;1;1;0;0;6pT77
497;École doctorale Normande de Biologie Intégrative, Santé, Environnement;Ed NBISE;10;Sciences agronomiques et écologiques;2021;2020-21;2020;2020;5;0;5;20;8;12;9;4;5;3;6;0;0;0D9Je
512;École doctorale Informatique et mathématiques;InfoMaths;8;Sciences pour l'ingénieur;2021;2020-21;2020;2020;3;1;2;7;3;4;3;1;2;0;0;0;3;t86bi
528;École doctorale Ville, transports et territoires;VTT;6;Sciences humaines et humanités;2021;2020-21;2020;2020;9;4;5;108;69;39;16;11;5;1;3;3;9;68zCc
541;École doctorale de sciences humaines et sociales de La Réunion;SHS;7;Sciences de la société;2021;2020-21;2020;2020;1;0;1;13;5;8;0;0;0;0;0;0;0;21SpE
542;École doctorale de sciences de La Réunion;STS;3;Sciences de la terre et de l'univers, espace;2021;2020-21;2020;2020;0;0;0;4;2;2;4;2;2;3;1;0;0;2pAql
542;École doctorale de sciences de La Réunion;STS;4;Chimie;2021;2020-21;2020;2020;0;0;0;5;3;2;3;2;1;0;1;2;0;2pAql
545;École doctorale Sociétés, politique et santé publique;SP2;6;Sciences humaines et humanités;2021;2020-21;2020;2020;27;12;15;144;75;69;12;4;8;6;5;1;0;IAKR4
548;École doctorale Mer et Sciences;;2;Physique;2021;2020-21;2020;2020;1;0;1;3;0;3;3;1;2;3;0;0;0;QX0fS
548;École doctorale Mer et Sciences;;5;Biologie, médecine et santé;2021;2020-21;2020;2020;2;1;1;7;5;2;2;1;1;0;2;0;0;QX0fS
548;École doctorale Mer et Sciences;;6;Sciences humaines et humanités;2021;2020-21;2020;2020;3;1;2;9;3;6;1;0;1;0;1;0;0;QX0fS
549;École doctorale Santé, Sciences Biologiques et Chimie du Vivant;SSBCV;6;Sciences humaines et humanités;2021;2020-21;2020;2020;3;3;0;7;6;1;4;2;2;3;1;0;0;B9ggO
549;École doctorale Santé, Sciences Biologiques et Chimie du Vivant;SSBCV;10;Sciences agronomiques et écologiques;2021;2020-21;2020;2020;0;0;0;1;0;1;2;1;1;2;0;0;0;B9ggO
551;École doctorale Mathématiques, Informatique, Physique Théorique et Ingénierie des Systèmes;MIPTIS;9;Sciences et technologies de l'information et de la communication;2021;2020-21;2020;2020;17;4;13;66;17;49;7;2;5;3;4;0;0;Mpudz
552;École doctorale Énergie - Matériaux - Sciences de la Terre et de l'Univers;EMTSU;9;Sciences et technologies de l'information et de la communication;2021;2020-21;2020;2020;3;0;3;11;0;11;0;0;0;0;0;0;0;NTZhw
554;École doctorale Environnements - Santé;E-S;3;Sciences de la terre et de l'univers, espace;2021;2020-21;2020;2020;7;3;4;22;9;13;4;1;3;1;3;0;0;ElyFU
555;École doctorale Sciences de l'Homme et de la Société;SHS;7;Sciences de la société;2021;2020-21;2020;2020;28;11;17;138;56;82;12;6;6;1;4;6;1;44G6m
556;École doctorale Homme, Sociétés, Risques, Territoire;HSRT;6;Sciences humaines et humanités;2021;2020-21;2020;2020;14;8;6;119;26;93;26;13;13;3;9;10;4;5QEaX
559;École doctorale Management Panthéon-Sorbonne;;7;Sciences de la société;2021;2020-21;2020;2020;46;21;25;175;86;89;34;19;15;3;13;14;4;4SP7k
561;École doctorale Hématologie, Oncogenèse et Biothérapies;HOB;5;Biologie, médecine et santé;2021;2020-21;2020;2020;50;31;19;219;133;86;37;22;15;12;21;3;1;7Klb2
566;École doctorale Sciences du Sport, de la Motricité et du Mouvement Humain;SMMH;8;Sciences pour l'ingénieur;2021;2020-21;2020;2020;1;0;1;2;1;1;0;0;0;0;0;0;0;3iv8y
567;École doctorale Sciences du Végétal : du gène à l'écosystème;;5;Biologie, médecine et santé;2021;2020-21;2020;2020;12;8;4;52;25;27;13;7;6;4;7;2;0;tuDkA
569;École doctorale Innovation thérapeutique : du fondamental à l'appliqué;;4;Chimie;2021;2020-21;2020;2020;6;3;3;31;14;17;1;0;1;1;0;0;0;jx8ET
571;École doctorale Sciences Chimiques : Molécules, Matériaux, Instrumentation et Biosystemes;2MIB;2;Physique;2021;2020-21;2020;2020;5;1;4;17;5;12;5;2;3;3;2;0;0;zbi37
571;École doctorale Sciences Chimiques : Molécules, Matériaux, Instrumentation et Biosystemes;2MIB;4;Chimie;2021;2020-21;2020;2020;79;35;44;282;143;139;46;21;25;31;12;3;0;zbi37
573;École doctorale Interfaces : Approches Interdisciplinaires, Fondements, Applications et Innovation;ED INTERFACES;1;Mathématiques et leurs interactions;2021;2020-21;2020;2020;9;2;7;21;4;17;2;0;2;2;0;0;0;gG820
573;École doctorale Interfaces : Approches Interdisciplinaires, Fondements, Applications et Innovation;ED INTERFACES;7;Sciences de la société;2021;2020-21;2020;2020;1;1;0;2;2;0;0;0;0;0;0;0;0;gG820
573;École doctorale Interfaces : Approches Interdisciplinaires, Fondements, Applications et Innovation;ED INTERFACES;10;Sciences agronomiques et écologiques;2021;2020-21;2020;2020;0;0;0;1;1;0;0;0;0;0;0;0;0;gG820
574;École doctorale de Mathématiques Hadamard;EDMH;1;Mathématiques et leurs interactions;2021;2020-21;2020;2020;104;25;79;341;61;280;80;16;64;46;33;1;0;4pqal
576;École doctorale Particules, Hadrons, Énergie, Noyau, Instrumentation, Imagerie, Cosmos et Simulation;PHENIICS;4;Chimie;2021;2020-21;2020;2020;2;1;1;9;4;5;1;1;0;1;0;0;0;qC4rf
577;École doctorale Structure et dynamique des systèmes vivants;SDSV;1;Mathématiques et leurs interactions;2021;2020-21;2020;2020;0;0;0;0;0;0;2;1;1;1;1;0;0;4bsxJ
577;École doctorale Structure et dynamique des systèmes vivants;SDSV;5;Biologie, médecine et santé;2021;2020-21;2020;2020;62;36;26;223;132;91;39;22;17;12;25;2;0;4bsxJ
580;École doctorale Sciences et technologies de l'information et de la communication;STIC;1;Mathématiques et leurs interactions;2021;2020-21;2020;2020;2;0;2;10;3;7;1;0;1;1;0;0;0;AzCC0
581;École doctorale Agriculture, alimentation, biologie, environnement, santé;ABIES;1;Mathématiques et leurs interactions;2021;2020-21;2020;2020;0;0;0;4;2;2;1;1;0;1;0;0;0;c1x56
581;École doctorale Agriculture, alimentation, biologie, environnement, santé;ABIES;10;Sciences agronomiques et écologiques;2021;2020-21;2020;2020;24;11;13;95;50;45;31;20;11;21;10;0;0;c1x56
583;École doctorale Risques et Société;;6;Sciences humaines et humanités;2021;2020-21;2020;2020;1;1;0;14;7;7;1;1;0;1;0;0;0;wUBi9
585;École doctorale Sciences, Technologie,  Sante;EDSTS;4;Chimie;2021;2020-21;2020;2020;14;5;9;72;34;38;13;6;7;8;5;0;0;NM3Dl
587;École doctorale Diversites, santé et développement en Amazonie;;3;Sciences de la terre et de l'univers, espace;2021;2020-21;2020;2020;0;0;0;1;1;0;2;2;0;1;1;0;0;V14tj
588;École doctorale Milieu insulaire tropical : dynamiques de développement, sociétés, patrimoine et culture dans l'espace Caraïbes-Amériques;;7;Sciences de la société;2021;2020-21;2020;2020;21;8;13;49;32;17;5;3;2;1;1;2;1;4W5IO
589;École doctorale Milieu insulaire tropical à risques : protection, valorisation , santé et développement;;2;Physique;2021;2020-21;2020;2020;0;0;0;6;1;5;2;0;2;0;1;1;0;2cqi3
589;École doctorale Milieu insulaire tropical à risques : protection, valorisation , santé et développement;;4;Chimie;2021;2020-21;2020;2020;1;1;0;6;3;3;0;0;0;0;0;0;0;2cqi3
589;École doctorale Milieu insulaire tropical à risques : protection, valorisation , santé et développement;;8;Sciences pour l'ingénieur;2021;2020-21;2020;2020;0;0;0;3;0;3;1;0;1;0;1;0;0;2cqi3
589;École doctorale Milieu insulaire tropical à risques : protection, valorisation , santé et développement;;10;Sciences agronomiques et écologiques;2021;2020-21;2020;2020;2;2;0;8;5;3;2;2;0;0;1;0;1;2cqi3
591;École doctorale Physique, Sciences de l'Ingenieur, Materiaux, Énergie;PSIME;3;Sciences de la terre et de l'univers, espace;2021;2020-21;2020;2020;1;1;0;7;2;5;1;0;1;1;0;0;0;Hn5Om
594;École doctorale Sociétés, Espaces, Pratiques, Temps;ED SEPT;7;Sciences de la société;2021;2020-21;2020;2020;10;8;2;54;30;24;10;5;5;1;2;2;5;N85H3
598;École doctorale Sciences de La Mer et du Littoral;SML;8;Sciences pour l'ingénieur;2021;2020-21;2020;2020;6;4;2;19;7;12;6;4;2;2;4;0;0;Smen6
601;École doctorale Mathématiques et Sciences et Technologies de l'information et de la Communication;MathSTIC;2;Physique;2021;2020-21;2020;2020;0;0;0;1;1;0;0;0;0;0;0;0;0;3Ue20
601;École doctorale Mathématiques et Sciences et Technologies de l'information et de la Communication;MathSTIC;3;Sciences de la terre et de l'univers, espace;2021;2020-21;2020;2020;1;1;0;1;1;0;0;0;0;0;0;0;0;3Ue20
601;École doctorale Mathématiques et Sciences et Technologies de l'information et de la Communication;MathSTIC;9;Sciences et technologies de l'information et de la communication;2021;2020-21;2020;2020;227;51;176;838;212;626;218;51;167;127;73;17;1;3Ue20
604;École doctorale Sociétés, Temps, Territoires;STT;7;Sciences de la société;2021;2020-21;2020;2020;9;5;4;78;41;37;8;3;5;0;2;3;3;SZI5T
605;École doctorale Biologie Santé;ED BS;10;Sciences agronomiques et écologiques;2021;2020-21;2020;2020;3;2;1;3;2;1;0;0;0;0;0;0;0;w8CxU
609;École doctorale Sciences et Ingénierie des Matériaux, Mécanique, Énergétique -;SIMME;2;Physique;2021;2020-21;2020;2020;9;0;9;26;3;23;7;1;6;3;4;0;0;N4Rjy
609;École doctorale Sciences et Ingénierie des Matériaux, Mécanique, Énergétique -;SIMME;5;Biologie, médecine et santé;2021;2020-21;2020;2020;1;0;1;2;0;2;0;0;0;0;0;0;0;N4Rjy
609;École doctorale Sciences et Ingénierie des Matériaux, Mécanique, Énergétique -;SIMME;8;Sciences pour l'ingénieur;2021;2020-21;2020;2020;45;10;35;165;42;123;35;11;24;17;16;2;0;N4Rjy
610;École doctorale Sciences et Ingénierie des Systèmes, Mathématiques, Informatique;SISMI;2;Physique;2021;2020-21;2020;2020;6;3;3;17;5;12;3;1;2;2;1;0;0;dBCUB
610;École doctorale Sciences et Ingénierie des Systèmes, Mathématiques, Informatique;SISMI;9;Sciences et technologies de l'information et de la communication;2021;2020-21;2020;2020;18;3;15;107;24;83;12;5;7;3;7;1;1;dBCUB
611;École doctorale Sciences du Langage, Psychologie, Cognition, Education;SLPCE;6;Sciences humaines et humanités;2021;2020-21;2020;2020;19;13;6;91;53;38;13;8;5;3;2;5;3;z8agK
613;École doctorale Sciences de la Société, Territoires, Sciences Economiques et de Gestion;SSTSEG;6;Sciences humaines et humanités;2021;2020-21;2020;2020;6;3;3;44;23;21;11;3;8;1;4;5;1;6eLRF
617;École doctorale Sciences de la Société : Territoires, Economie et Droit;SSTED;8;Sciences pour l'ingénieur;2021;2020-21;2020;2020;0;0;0;2;1;1;0;0;0;0;0;0;0;Kl9ZX
618;École doctorale EUCLIDE;;1;Mathématiques et leurs interactions;2021;2020-21;2020;2020;4;0;4;8;2;6;0;0;0;0;0;0;0;qveTN
618;École doctorale EUCLIDE;;4;Chimie;2021;2020-21;2020;2020;4;1;3;17;7;10;5;2;3;3;2;0;0;qveTN
619;École doctorale Sciences Fondamentales et Santé;SFS;6;Sciences humaines et humanités;2021;2020-21;2020;2020;1;0;1;4;0;4;0;0;0;0;0;0;0;JiZVW
619;École doctorale Sciences Fondamentales et Santé;SFS;7;Sciences de la société;2021;2020-21;2020;2020;1;0;1;1;0;1;0;0;0;0;0;0;0;JiZVW
623;École doctorale Savoir, Sciences, Éducation;SSE;2;Physique;2021;2020-21;2020;2020;0;0;0;6;3;3;1;1;0;0;0;1;0;98lMD
626;École doctorale de l’Institut Polytechnique de Paris;;1;Mathématiques et leurs interactions;2021;2020-21;2020;2020;9;1;8;29;5;24;2;0;2;2;0;0;0;DL5fO
626;École doctorale de l’Institut Polytechnique de Paris;;3;Sciences de la terre et de l'univers, espace;2021;2020-21;2020;2020;1;1;0;12;4;8;2;1;1;2;0;0;0;DL5fO
629;École doctorale Sciences sociales et Humanités;SSH;7;Sciences de la société;2021;2020-21;2020;2020;5;2;3;70;32;38;5;4;1;0;1;3;1;nnSns
22;École doctorale Mondes anciens et médiévaux;;6;Sciences humaines et humanités;2011;2010-11;2010;2010;36;23;13;260;154;106;33;17;16;;;;;fqCbl
31;École doctorale Pratiques et théories du sens;;7;Sciences de la société;2011;2010-11;2010;2010;10;4;6;41;14;27;0;0;0;;;;;1S466
37;École doctorale Sciences physiques pour l'ingénieur et microtechniques;SPIM;8;Sciences pour l'ingénieur;2011;2010-11;2010;2010;54;14;40;197;46;151;39;5;34;;;;;F7G1B
38;École doctorale Langages, espaces, temps, sociétés;;6;Sciences humaines et humanités;2011;2010-11;2010;2010;58;29;29;337;179;158;50;26;24;;;;;pGgDX
38;École doctorale Langages, espaces, temps, sociétés;;7;Sciences de la société;2011;2010-11;2010;2010;11;6;5;34;17;17;5;3;2;;;;;pGgDX
38;École doctorale Langages, espaces, temps, sociétés;;9;Sciences et technologies de l'information et de la communication;2011;2010-11;2010;2010;2;2;0;3;2;1;0;0;0;;;;;pGgDX
39;École doctorale Mathématiques et Informatique;EDMIB;9;Sciences et technologies de l'information et de la communication;2011;2010-11;2010;2010;32;5;27;150;26;124;22;4;18;;;;;TBj2X
60;École doctorale Territoires, temps, sociétés et développement;TTSD;6;Sciences humaines et humanités;2011;2010-11;2010;2010;34;17;17;195;117;78;46;21;25;;;;;fkIh6
65;École doctorale Sciences de la Vie, Santé, Agronomie, Environnement;;5;Biologie, médecine et santé;2011;2010-11;2010;2010;42;25;17;150;78;72;18;7;11;;;;;MAOG4
72;École doctorale Sciences pour l'ingénieur;SPI;1;Mathématiques et leurs interactions;2011;2010-11;2010;2010;18;7;11;61;16;45;15;4;11;;;;;47QPx
72;École doctorale Sciences pour l'ingénieur;SPI;9;Sciences et technologies de l'information et de la communication;2011;2010-11;2010;2010;130;45;85;449;134;315;120;28;92;;;;;47QPx
77;École doctorale Informatique, automatique, électronique, électrotechnique, mathématiques;IAEM;1;Mathématiques et leurs interactions;2011;2010-11;2010;2010;12;1;11;53;11;42;16;5;11;;;;;TCHTA
84;École doctorale Sciences et technologies de l'information et de la communication;STIC;9;Sciences et technologies de l'information et de la communication;2011;2010-11;2010;2010;62;15;47;273;51;222;64;9;55;;;;;9wS2W
104;École doctorale Sciences de la matière, du rayonnement et de l'environnement;SMRE;6;Sciences humaines et humanités;2011;2010-11;2010;2010;0;0;0;5;0;5;0;0;0;;;;;Q5iFz
107;École doctorale Physique de la région parisienne;;2;Physique;2011;2010-11;2010;2010;84;14;70;278;45;233;74;10;64;;;;;O3g7O
109;École doctorale Sciences de la terre;;3;Sciences de la terre et de l'univers, espace;2011;2010-11;2010;2010;35;15;20;136;57;79;18;10;8;;;;;BQNt6
113;École doctorale Histoire;;6;Sciences humaines et humanités;2011;2010-11;2010;2010;92;43;49;475;217;258;59;22;37;;;;;G5wHs
149;École doctorale Carnot;;2;Physique;2011;2010-11;2010;2010;13;1;12;51;6;45;11;5;6;;;;;zuThw
160;École doctorale Électronique, électrotechnique, automatique;EEA;8;Sciences pour l'ingénieur;2011;2010-11;2010;2010;31;4;27;113;18;95;23;9;14;;;;;EgfMQ
166;École doctorale Information, structures et systèmes;I2S;1;Mathématiques et leurs interactions;2011;2010-11;2010;2010;15;6;9;45;9;36;18;5;13;;;;;2uO68
171;École doctorale Toulouse sciences économiques;TSE;7;Sciences de la société;2011;2010-11;2010;2010;26;6;20;96;35;61;27;10;17;;;;;Q5nNQ
173;École doctorale Sciences de l'univers, de l'environnement et de l'espace;SDU2E;3;Sciences de la terre et de l'univers, espace;2011;2010-11;2010;2010;59;21;38;236;103;133;46;19;27;;;;;R0Z9c
173;École doctorale Sciences de l'univers, de l'environnement et de l'espace;SDU2E;10;Sciences agronomiques et écologiques;2011;2010-11;2010;2010;10;9;1;23;15;8;4;1;3;;;;;R0Z9c
177;École doctorale Sciences et technologies de l'université d'Orléans;;2;Physique;2011;2010-11;2010;2010;12;2;10;39;8;31;20;8;12;;;;;JI65m
177;École doctorale Sciences et technologies de l'université d'Orléans;;5;Biologie, médecine et santé;2011;2010-11;2010;2010;18;12;6;53;27;26;16;12;4;;;;;JI65m
178;École doctorale Sciences fondamentales;;1;Mathématiques et leurs interactions;2011;2010-11;2010;2010;4;0;4;16;6;10;1;1;0;;;;;1AiR7
178;École doctorale Sciences fondamentales;;3;Sciences de la terre et de l'univers, espace;2011;2010-11;2010;2010;8;5;3;39;21;18;9;4;5;;;;;1AiR7
181;École doctorale Structure, informations, matière et matériaux;Simem;4;Chimie;2011;2010-11;2010;2010;18;6;12;53;17;36;23;10;13;;;;;c1D6f
182;École doctorale Physique et chimie-physique;;2;Physique;2011;2010-11;2010;2010;44;10;34;160;44;116;40;7;33;;;;;3My6I
182;École doctorale Physique et chimie-physique;;8;Sciences pour l'ingénieur;2011;2010-11;2010;2010;3;0;3;6;0;6;0;0;0;;;;;3My6I
188;École doctorale Histoire moderne et contemporaine;;6;Sciences humaines et humanités;2011;2010-11;2010;2010;46;21;25;226;95;131;25;11;14;;;;;RSZ7F
206;École doctorale Chimie : chimie, procédés, environnement;;4;Chimie;2011;2010-11;2010;2010;102;50;52;355;155;200;86;33;53;;;;;m0UhD
208;École doctorale Science politique de Bordeaux;;7;Sciences de la société;2011;2010-11;2010;2010;23;13;10;94;46;48;16;7;9;;;;;bwslk
209;École doctorale Sciences physiques et de L'ingénieur;SPI;8;Sciences pour l'ingénieur;2011;2010-11;2010;2010;30;10;20;116;33;83;21;4;17;;;;;tZcIZ
211;École doctorale Sciences exactes et leurs applications;ED SEA;2;Physique;2011;2010-11;2010;2010;1;0;1;16;3;13;5;2;3;;;;;1G1iC
211;École doctorale Sciences exactes et leurs applications;ED SEA;6;Sciences humaines et humanités;2011;2010-11;2010;2010;0;0;0;4;1;3;0;0;0;;;;;1G1iC
211;École doctorale Sciences exactes et leurs applications;ED SEA;8;Sciences pour l'ingénieur;2011;2010-11;2010;2010;11;2;9;38;10;28;10;4;6;;;;;1G1iC
211;École doctorale Sciences exactes et leurs applications;ED SEA;10;Sciences agronomiques et écologiques;2011;2010-11;2010;2010;1;0;1;8;2;6;1;1;0;;;;;1G1iC
216;École doctorale Ingénierie pour la santé, la cognition, l'environnement;EDISCE;5;Biologie, médecine et santé;2011;2010-11;2010;2010;22;12;10;118;44;74;29;10;19;;;;;fPs1t
216;École doctorale Ingénierie pour la santé, la cognition, l'environnement;EDISCE;6;Sciences humaines et humanités;2011;2010-11;2010;2010;11;6;5;38;23;15;9;6;3;;;;;fPs1t
218;École doctorale Chimie et sciences du vivant;EDCSV;10;Sciences agronomiques et écologiques;2011;2010-11;2010;2010;7;3;4;18;8;10;7;4;3;;;;;8bcJh
221;École doctorale Augustin Cournot - Sciences économiques et de gestion - Sciences, technologies et sociétés;EDAC;7;Sciences de la société;2011;2010-11;2010;2010;24;11;13;111;51;60;12;7;5;;;;;5z9rW
227;École doctorale Sciences de la nature et de l'homme;;9;Sciences et technologies de l'information et de la communication;2011;2010-11;2010;2010;1;1;0;2;2;0;1;1;0;;;;;xiDA5
231;École doctorale Économie et gestion;EDEG;7;Sciences de la société;2011;2010-11;2010;2010;46;20;26;184;93;91;38;21;17;;;;;KT720
240;École doctorale Sciences de l'homme et de la société;SHS;7;Sciences de la société;2011;2010-11;2010;2010;27;10;17;75;34;41;4;2;2;;;;;j345k
254;École doctorale Sciences de la matière;;1;Mathématiques et leurs interactions;2011;2010-11;2010;2010;1;0;1;1;0;1;0;0;0;;;;;365F2
254;École doctorale Sciences de la matière;;3;Sciences de la terre et de l'univers, espace;2011;2010-11;2010;2010;7;2;5;42;17;25;8;2;6;;;;;365F2
254;École doctorale Sciences de la matière;;6;Sciences humaines et humanités;2011;2010-11;2010;2010;3;3;0;17;12;5;1;0;1;;;;;365F2
260;École doctorale pluridisciplinaire;;1;Mathématiques et leurs interactions;2011;2010-11;2010;2010;7;1;6;31;11;20;8;3;5;;;;;sCk1f
260;École doctorale pluridisciplinaire;;10;Sciences agronomiques et écologiques;2011;2010-11;2010;2010;9;7;2;59;38;21;7;2;5;;;;;sCk1f
263;École doctorale Sciences juridiques, économiques et de gestion;;7;Sciences de la société;2011;2010-11;2010;2010;34;18;16;170;93;77;23;15;8;;;;;1nUr6
269;École doctorale Mathématiques, sciences de l'information et de l'ingénieur;MSII;8;Sciences pour l'ingénieur;2011;2010-11;2010;2010;22;5;17;72;17;55;12;4;8;;;;;5E625
283;École doctorale Droit international et européen;;7;Sciences de la société;2011;2010-11;2010;2010;30;16;14;161;86;75;18;15;3;;;;;uIq4K
285;École doctorale Sciences pratiques;;5;Biologie, médecine et santé;2011;2010-11;2010;2010;2;2;0;7;6;1;0;0;0;;;;;Jd3t2
285;École doctorale Sciences pratiques;;8;Sciences pour l'ingénieur;2011;2010-11;2010;2010;40;9;31;126;28;98;32;3;29;;;;;Jd3t2
304;École doctorale Sciences et environnements;;5;Biologie, médecine et santé;2011;2010-11;2010;2010;7;4;3;25;11;14;4;4;0;;;;;2ywZn
304;École doctorale Sciences et environnements;;6;Sciences humaines et humanités;2011;2010-11;2010;2010;4;2;2;21;8;13;3;2;1;;;;;2ywZn
305;École doctorale Énergie et environnement;E2;2;Physique;2011;2010-11;2010;2010;3;1;2;8;1;7;0;0;0;;;;;Kbt8I
305;École doctorale Énergie et environnement;E2;3;Sciences de la terre et de l'univers, espace;2011;2010-11;2010;2010;7;5;2;18;9;9;4;0;4;;;;;Kbt8I
306;École doctorale Sciences des procédés, sciences des aliments;;4;Chimie;2011;2010-11;2010;2010;8;0;8;10;2;8;9;7;2;;;;;adF7W
306;École doctorale Sciences des procédés, sciences des aliments;;10;Sciences agronomiques et écologiques;2011;2010-11;2010;2010;14;10;4;34;25;9;7;4;3;;;;;adF7W
309;École doctorale Systèmes;EDSYS;9;Sciences et technologies de l'information et de la communication;2011;2010-11;2010;2010;13;2;11;79;10;69;7;0;7;;;;;8TT4b
350;École doctorale Sciences humaines et sociales : savoirs, critique, expertises;;6;Sciences humaines et humanités;2011;2010-11;2010;2010;75;50;25;384;194;190;36;15;21;;;;;Dg9jV
351;École doctorale Sciences physiques, mathématiques et de l'information pour l'ingénieur;SPMII;4;Chimie;2011;2010-11;2010;2010;2;1;1;12;4;8;4;1;3;;;;;rY4EP
354;École doctorale Langues, lettres et arts;LLA;6;Sciences humaines et humanités;2011;2010-11;2010;2010;34;19;15;172;113;59;35;25;10;;;;;RwcSv
358;École doctorale Sciences, technologies, santé;;5;Biologie, médecine et santé;2011;2010-11;2010;2010;17;8;9;61;34;27;12;5;7;;;;;OZA3U
358;École doctorale Sciences, technologies, santé;;10;Sciences agronomiques et écologiques;2011;2010-11;2010;2010;5;3;2;37;16;21;6;4;2;;;;;OZA3U
364;École doctorale Sciences fondamentales et appliquées;EDSFA;1;Mathématiques et leurs interactions;2011;2010-11;2010;2010;22;2;20;67;15;52;11;5;6;;;;;E483q
369;École doctorale Homme, environnement, santé;;5;Biologie, médecine et santé;2011;2010-11;2010;2010;20;10;10;84;44;40;15;5;10;;;;;uZ8W7
372;École doctorale Sciences économiques et de gestion;;7;Sciences de la société;2011;2010-11;2010;2010;49;22;27;324;142;182;55;22;33;;;;;JK63A
373;École doctorale Santé, information/communications et mathématiques, matière;SICMA;8;Sciences pour l'ingénieur;2011;2010-11;2010;2010;16;7;9;82;23;59;23;5;18;;;;;hTJF5
377;École doctorale Environnement et société;;1;Mathématiques et leurs interactions;2011;2010-11;2010;2010;5;2;3;15;5;10;0;0;0;;;;;ZMG5u
377;École doctorale Environnement et société;;4;Chimie;2011;2010-11;2010;2010;4;2;2;19;5;14;2;1;1;;;;;ZMG5u
377;École doctorale Environnement et société;;6;Sciences humaines et humanités;2011;2010-11;2010;2010;14;9;5;72;43;29;13;4;9;;;;;ZMG5u
377;École doctorale Environnement et société;;7;Sciences de la société;2011;2010-11;2010;2010;10;2;8;48;13;35;9;3;6;;;;;ZMG5u
378;École doctorale Sciences de l'homme et de la société;SHS;5;Biologie, médecine et santé;2011;2010-11;2010;2010;0;0;0;4;0;4;2;0;2;;;;;3XKuF
386;École doctorale Sciences mathématiques de Paris centre;SMPC;9;Sciences et technologies de l'information et de la communication;2011;2010-11;2010;2010;26;8;18;84;18;66;15;4;11;;;;;wMj98
387;École doctorale Interdisciplinaire pour le vivant;I-ViV;2;Physique;2011;2010-11;2010;2010;4;3;1;26;13;13;5;2;3;;;;;06uKM
389;École doctorale La physique, de la particule à la matière condensée;;2;Physique;2011;2010-11;2010;2010;37;8;29;127;36;91;32;10;22;;;;;2ydfg
396;École doctorale Économie, organisations, société;EOS;6;Sciences humaines et humanités;2011;2010-11;2010;2010;5;2;3;58;26;32;5;1;4;;;;;Es5e7
396;École doctorale Économie, organisations, société;EOS;7;Sciences de la société;2011;2010-11;2010;2010;60;28;32;330;147;183;57;32;25;;;;;Es5e7
396;École doctorale Économie, organisations, société;EOS;8;Sciences pour l'ingénieur;2011;2010-11;2010;2010;1;0;1;1;0;1;0;0;0;;;;;Es5e7
397;École doctorale Physique et chimie des matériaux;;4;Chimie;2011;2010-11;2010;2010;30;9;21;104;45;59;21;11;10;;;;;WxSt9
400;École doctorale Savoirs scientifiques : épistémologie, histoire des sciences, didactique des disciplines;;2;Physique;2011;2010-11;2010;2010;4;0;4;14;2;12;4;3;1;;;;;nRax3
400;École doctorale Savoirs scientifiques : épistémologie, histoire des sciences, didactique des disciplines;;5;Biologie, médecine et santé;2011;2010-11;2010;2010;6;2;4;21;9;12;6;2;4;;;;;nRax3
401;École doctorale Sciences sociales;;7;Sciences de la société;2011;2010-11;2010;2010;52;30;22;295;137;158;25;13;12;;;;;raQ7K
401;École doctorale Sciences sociales;;9;Sciences et technologies de l'information et de la communication;2011;2010-11;2010;2010;6;1;5;13;4;9;1;0;1;;;;;raQ7K
405;École doctorale Économie, management,mathématiques et physique de Cergy;EM2C;1;Mathématiques et leurs interactions;2011;2010-11;2010;2010;11;7;4;22;11;11;4;0;4;;;;;QbwSB
410;École doctorale Sciences et ingénierie des ressources, procédés, produits, environnement;RP2E;8;Sciences pour l'ingénieur;2011;2010-11;2010;2010;48;15;33;183;69;114;43;12;31;;;;;Q5fxV
411;École doctorale Humanités nouvelles : Fernand Braudel;;7;Sciences de la société;2011;2010-11;2010;2010;8;6;2;44;29;15;6;3;3;;;;;l2rFh
417;École doctorale Sciences et Ingénierie;S&I;3;Sciences de la terre et de l'univers, espace;2011;2010-11;2010;2010;3;2;1;14;4;10;1;0;1;;;;;SSBvE
422;École doctorale Sciences et technologies de l'information, des télécommunications et des systèmes;;8;Sciences pour l'ingénieur;2011;2010-11;2010;2010;21;4;17;65;21;44;11;2;9;;;;;998UM
425;École doctorale Innovation thérapeutique : du fondamental à l'appliqué;;5;Biologie, médecine et santé;2011;2010-11;2010;2010;45;28;17;230;141;89;61;35;26;;;;;DkgNy
433;École doctorale Concepts et langages;;6;Sciences humaines et humanités;2011;2010-11;2010;2010;104;60;44;471;271;200;74;34;40;;;;;v8q34
434;École doctorale Géographie de Paris - Espaces, sociétés, aménagement;EDGP;6;Sciences humaines et humanités;2011;2010-11;2010;2010;60;30;30;344;183;161;39;20;19;;;;;1FmLX
435;École doctorale Agriculture, alimentation, biologie, environnement et santé;;5;Biologie, médecine et santé;2011;2010-11;2010;2010;27;16;11;129;86;43;42;34;8;;;;;mC35U
436;École doctorale Médicament, toxicologie, chimie, environnement;MTCE;5;Biologie, médecine et santé;2011;2010-11;2010;2010;32;18;14;123;65;58;37;21;16;;;;;dPsg3
447;École doctorale de l'école polytechnique;;5;Biologie, médecine et santé;2011;2010-11;2010;2010;2;1;1;5;2;3;2;0;2;;;;;zgCCh
456;École doctorale Sciences du sport, de la motricité et du mouvement humain;;6;Sciences humaines et humanités;2011;2010-11;2010;2010;14;4;10;57;32;25;13;6;7;;;;;GqvEI
459;École doctorale Sciences chimiques Balard;;4;Chimie;2011;2010-11;2010;2010;77;42;35;223;102;121;57;23;34;;;;;YFs2W
461;École doctorale Droit et science politique;;7;Sciences de la société;2011;2010-11;2010;2010;127;78;49;480;268;212;61;29;32;;;;;QGArN
462;École doctorale Sciences de l'homme et de la société;;7;Sciences de la société;2011;2010-11;2010;2010;25;9;16;96;45;51;17;6;11;;;;;KsM6i
467;École doctorale Aéronautique, astronautique;AA;6;Sciences humaines et humanités;2011;2010-11;2010;2010;2;1;1;6;2;4;1;0;1;;;;;U7l45
467;École doctorale Aéronautique, astronautique;AA;8;Sciences pour l'ingénieur;2011;2010-11;2010;2010;7;2;5;23;4;19;3;1;2;;;;;U7l45
469;École doctorale du Pacifique;EDP;1;Mathématiques et leurs interactions;2011;2010-11;2010;2010;1;0;1;1;0;1;0;0;0;;;;;t9Z2n
469;École doctorale du Pacifique;EDP;7;Sciences de la société;2011;2010-11;2010;2010;7;5;2;14;7;7;0;0;0;;;;;t9Z2n
469;École doctorale du Pacifique;EDP;10;Sciences agronomiques et écologiques;2011;2010-11;2010;2010;0;0;0;4;2;2;3;1;2;;;;;t9Z2n
472;École doctorale de l'EPHE;;6;Sciences humaines et humanités;2011;2010-11;2010;2010;115;65;50;556;295;261;61;24;37;;;;;27zK4
473;École doctorale Sciences de l'homme et de la société;SHS;6;Sciences humaines et humanités;2011;2010-11;2010;2010;111;67;44;546;326;220;83;48;35;;;;;8qKD9
474;École doctorale Interdisciplinaire européenne frontières du vivant;FDV;6;Sciences humaines et humanités;2011;2010-11;2010;2010;0;0;0;0;0;0;1;0;1;;;;;E727j
480;École doctorale Montaigne-humanités;;6;Sciences humaines et humanités;2011;2010-11;2010;2010;104;61;43;649;363;286;103;50;53;;;;;f3SeZ
481;École doctorale Sciences sociales et humanités;SSH;7;Sciences de la société;2011;2010-11;2010;2010;32;17;15;135;63;72;21;6;15;;;;;E3z5j
482;École doctorale Sciences de la matière;SDM;4;Chimie;2011;2010-11;2010;2010;80;37;43;258;99;159;60;21;39;;;;;kmeZ4
485;École doctorale Éducation, Psychologie, Information et Communication;EPIC;6;Sciences humaines et humanités;2011;2010-11;2010;2010;64;35;29;331;196;135;43;19;24;;;;;O82eL
485;École doctorale Éducation, Psychologie, Information et Communication;EPIC;9;Sciences et technologies de l'information et de la communication;2011;2010-11;2010;2010;13;10;3;60;38;22;9;5;4;;;;;O82eL
490;École doctorale Environnement - Santé/STIC;E2S;6;Sciences humaines et humanités;2011;2010-11;2010;2010;12;5;7;31;15;16;3;2;1;;;;;sYTua
490;École doctorale Environnement - Santé/STIC;E2S;9;Sciences et technologies de l'information et de la communication;2011;2010-11;2010;2010;16;4;12;88;15;73;18;1;17;;;;;sYTua
491;École doctorale Langages, idées, sociétés, institutions, territoires;LISIT;7;Sciences de la société;2011;2010-11;2010;2010;43;26;17;242;117;125;18;10;8;;;;;iB25j
494;École doctorale Jean-Henri Lambert;;4;Chimie;2011;2010-11;2010;2010;15;6;9;55;23;32;15;6;9;;;;;A3m51
494;École doctorale Jean-Henri Lambert;;8;Sciences pour l'ingénieur;2011;2010-11;2010;2010;19;7;12;66;17;49;22;6;16;;;;;A3m51
496;École doctorale Sociétés, cultures, échanges;SCE;6;Sciences humaines et humanités;2011;2010-11;2010;2010;71;36;35;348;199;149;39;27;12;;;;;633tC
497;École doctorale Normande de Biologie Intégrative, Santé, Environnement;Ed NBISE;5;Biologie, médecine et santé;2011;2010-11;2010;2010;61;35;26;250;133;117;70;36;34;;;;;0D9Je
498;École doctorale Sciences pour l'ingénieur, géosciences, architecture;SPIGA;3;Sciences de la terre et de l'univers, espace;2011;2010-11;2010;2010;1;0;1;2;0;2;4;1;3;;;;;0vlKH
498;École doctorale Sciences pour l'ingénieur, géosciences, architecture;SPIGA;6;Sciences humaines et humanités;2011;2010-11;2010;2010;0;0;0;9;3;6;2;1;1;;;;;0vlKH
500;École doctorale Matière, molécules, matériaux en Pays de Loire;3MPL;2;Physique;2011;2010-11;2010;2010;32;8;24;111;26;85;26;9;17;;;;;822tM
500;École doctorale Matière, molécules, matériaux en Pays de Loire;3MPL;8;Sciences pour l'ingénieur;2011;2010-11;2010;2010;1;0;1;4;1;3;2;1;1;;;;;822tM
501;École doctorale Droit, économie-gestion, sociétés, territoires;;7;Sciences de la société;2011;2010-11;2010;2010;78;31;47;360;172;188;40;21;19;;;;;wE7WM
511;École doctorale Sciences et ingénierie;S&I;1;Mathématiques et leurs interactions;2011;2010-11;2010;2010;5;2;3;10;4;6;4;2;2;;;;;7aXuB
511;École doctorale Sciences et ingénierie;S&I;2;Physique;2011;2010-11;2010;2010;0;0;0;0;0;0;1;0;1;;;;;7aXuB
518;École doctorale Matière condensée et interfaces;;2;Physique;2011;2010-11;2010;2010;32;8;24;85;22;63;17;2;15;;;;;Sg04R
522;École doctorale Sciences et ingénierie en matériaux, mécanique, énergétique et aéronautique;SI-MMEA;8;Sciences pour l'ingénieur;2011;2010-11;2010;2010;55;8;47;192;32;160;48;9;39;;;;;82F19
524;École doctorale Biologie - santé;;5;Biologie, médecine et santé;2011;2010-11;2010;2010;47;20;27;125;55;70;34;19;15;;;;;S7Kk6
525;"École doctorale Lettres, pensée, arts et histoire, ""Civilisation de l'antiquité à nos jours""";LPAH;6;Sciences humaines et humanités;2011;2010-11;2010;2010;61;33;28;287;165;122;36;20;16;;;;;19Rpr
528;École doctorale Ville, transports et territoires;VTT;3;Sciences de la terre et de l'univers, espace;2011;2010-11;2010;2010;1;1;0;1;1;0;0;0;0;;;;;68zCc
528;École doctorale Ville, transports et territoires;VTT;7;Sciences de la société;2011;2010-11;2010;2010;6;3;3;6;3;3;0;0;0;;;;;68zCc
529;École doctorale Cultures et sociétés;CS;0;;2011;2010-11;2010;2010;25;25;0;134;134;0;11;11;0;;;;;XU9tb
531;École doctorale Sciences, ingénierie et environnement;SIE;3;Sciences de la terre et de l'univers, espace;2011;2010-11;2010;2010;13;7;6;42;17;25;10;4;6;;;;;b5BYq
531;École doctorale Sciences, ingénierie et environnement;SIE;8;Sciences pour l'ingénieur;2011;2010-11;2010;2010;57;19;38;168;45;123;33;7;26;;;;;b5BYq
532;École doctorale Mathématiques et sciences et technologies de l'information et de la communication;MSTIC;3;Sciences de la terre et de l'univers, espace;2011;2010-11;2010;2010;3;1;2;17;6;11;5;1;4;;;;;t43KM
533;École doctorale Sciences du management : Gestion, organisation, décision, information;GODI;7;Sciences de la société;2011;2010-11;2010;2010;60;24;36;197;93;104;36;21;15;;;;;ld7FG
536;École doctorale Sciences et agrosciences;;1;Mathématiques et leurs interactions;2011;2010-11;2010;2010;0;0;0;4;1;3;1;0;1;;;;;pHfqe
536;École doctorale Sciences et agrosciences;;4;Chimie;2011;2010-11;2010;2010;4;3;1;12;9;3;0;0;0;;;;;pHfqe
539;École doctorale Sciences et technologies de Versailles;;2;Physique;2011;2010-11;2010;2010;2;0;2;18;5;13;3;0;3;;;;;nv3h8
541;École doctorale de sciences humaines et sociales de La Réunion;SHS;7;Sciences de la société;2011;2010-11;2010;2010;16;8;8;85;40;45;2;2;0;;;;;21SpE
530;École doctorale Organisations, marchés, institutions;OMI;0;;2011;2010-11;2010;2010;43;0;0;156;0;0;19;0;0;;;;;4htv7
34;École doctorale Matériaux;;3;Sciences de la terre et de l'univers, espace;2018;2017-18;2017;2017;0;0;0;0;0;0;3;1;2;;;;;1Iufh
37;École doctorale Sciences physiques pour l'ingénieur et microtechniques;SPIM;8;Sciences pour l'ingénieur;2018;2017-18;2017;2017;47;14;33;225;59;166;53;16;37;;;;;F7G1B
37;École doctorale Sciences physiques pour l'ingénieur et microtechniques;SPIM;9;Sciences et technologies de l'information et de la communication;2018;2017-18;2017;2017;45;10;35;190;49;141;38;10;28;;;;;F7G1B
39;École doctorale Mathématiques et Informatique;EDMIB;9;Sciences et technologies de l'information et de la communication;2018;2017-18;2017;2017;29;4;25;104;17;87;36;7;29;;;;;TBj2X
47;École doctorale Physique;;2;Physique;2018;2017-18;2017;2017;102;19;83;340;77;263;103;29;74;;;;;8kNpd
52;École doctorale Physique et astrophysique de Lyon;PHAST;2;Physique;2018;2017-18;2017;2017;37;13;24;143;37;106;45;10;35;;;;;61XPb
60;École doctorale Territoires, temps, sociétés et développement;TTSD;7;Sciences de la société;2018;2017-18;2017;2017;11;6;5;61;32;29;14;7;7;;;;;fkIh6
65;École doctorale Sciences de la Vie, Santé, Agronomie, Environnement;;8;Sciences pour l'ingénieur;2018;2017-18;2017;2017;0;0;0;2;0;2;0;0;0;;;;;MAOG4
72;École doctorale Sciences pour l'ingénieur;SPI;1;Mathématiques et leurs interactions;2018;2017-18;2017;2017;16;6;10;61;25;36;17;5;12;;;;;47QPx
84;École doctorale Sciences et technologies de l'information et de la communication;STIC;1;Mathématiques et leurs interactions;2018;2017-18;2017;2017;0;0;0;1;1;0;1;0;1;;;;;9wS2W
85;École doctorale Sciences de la vie et de la santé;SVS;5;Biologie, médecine et santé;2018;2017-18;2017;2017;44;26;18;224;145;79;40;23;17;;;;;YdiMF
92;École doctorale Vie -  Agro - Santé;;5;Biologie, médecine et santé;2018;2017-18;2017;2017;0;0;0;0;0;0;17;11;6;;;;;RjvXY
104;École doctorale Sciences de la matière, du rayonnement et de l'environnement;SMRE;2;Physique;2018;2017-18;2017;2017;22;13;9;69;31;38;19;5;14;;;;;Q5iFz
104;École doctorale Sciences de la matière, du rayonnement et de l'environnement;SMRE;3;Sciences de la terre et de l'univers, espace;2018;2017-18;2017;2017;13;5;8;40;14;26;9;3;6;;;;;Q5iFz
130;École doctorale Informatique, télécommunications et électronique de Paris;EDITE;9;Sciences et technologies de l'information et de la communication;2018;2017-18;2017;2017;129;33;96;634;155;479;182;54;128;;;;;O5ysj
139;École doctorale Connaissance, langage, modélisation;CLM;8;Sciences pour l'ingénieur;2018;2017-18;2017;2017;5;1;4;24;5;19;3;0;3;;;;;1lxGH
156;École doctorale Sciences de la mer;;5;Biologie, médecine et santé;2018;2017-18;2017;2017;0;0;0;0;0;0;2;1;1;;;;;EGY9P
156;École doctorale Sciences de la mer;;7;Sciences de la société;2018;2017-18;2017;2017;0;0;0;0;0;0;3;2;1;;;;;EGY9P
168;École doctorale Sciences chimiques et biologiques pour la santé;SCBS;4;Chimie;2018;2017-18;2017;2017;1;1;0;7;5;2;1;0;1;;;;;8cEME
171;École doctorale Toulouse sciences économiques;TSE;7;Sciences de la société;2018;2017-18;2017;2017;16;5;11;102;32;70;16;2;14;;;;;Q5nNQ
173;École doctorale Sciences de l'univers, de l'environnement et de l'espace;SDU2E;3;Sciences de la terre et de l'univers, espace;2018;2017-18;2017;2017;72;21;51;304;112;192;64;21;43;;;;;R0Z9c
178;École doctorale Sciences fondamentales;;5;Biologie, médecine et santé;2018;2017-18;2017;2017;0;0;0;2;2;0;2;1;1;;;;;1AiR7
182;École doctorale Physique et chimie-physique;;3;Sciences de la terre et de l'univers, espace;2018;2017-18;2017;2017;2;0;2;7;0;7;5;0;5;;;;;3My6I
182;École doctorale Physique et chimie-physique;;8;Sciences pour l'ingénieur;2018;2017-18;2017;2017;1;0;1;2;0;2;1;0;1;;;;;3My6I
184;École doctorale Mathématiques et informatique de Marseille;;1;Mathématiques et leurs interactions;2018;2017-18;2017;2017;19;8;11;97;30;67;32;9;23;;;;;DDObG
184;École doctorale Mathématiques et informatique de Marseille;;5;Biologie, médecine et santé;2018;2017-18;2017;2017;1;0;1;1;0;1;1;0;1;;;;;DDObG
184;École doctorale Mathématiques et informatique de Marseille;;8;Sciences pour l'ingénieur;2018;2017-18;2017;2017;1;0;1;13;0;13;1;0;1;;;;;DDObG
188;École doctorale Histoire moderne et contemporaine;;6;Sciences humaines et humanités;2018;2017-18;2017;2017;37;20;17;160;77;83;22;9;13;;;;;RSZ7F
205;École doctorale Interdisciplinaire Sciences-Santé;EDISS;6;Sciences humaines et humanités;2018;2017-18;2017;2017;4;0;4;18;9;9;3;1;2;;;;;69W38
206;École doctorale Chimie : chimie, procédés, environnement;;4;Chimie;2018;2017-18;2017;2017;86;41;45;317;150;167;87;31;56;;;;;m0UhD
206;École doctorale Chimie : chimie, procédés, environnement;;5;Biologie, médecine et santé;2018;2017-18;2017;2017;0;0;0;1;0;1;0;0;0;;;;;m0UhD
211;École doctorale Sciences exactes et leurs applications;ED SEA;9;Sciences et technologies de l'information et de la communication;2018;2017-18;2017;2017;9;3;6;24;7;17;5;2;3;;;;;1G1iC
211;École doctorale Sciences exactes et leurs applications;ED SEA;10;Sciences agronomiques et écologiques;2018;2017-18;2017;2017;5;4;1;17;10;7;2;1;1;;;;;1G1iC
216;École doctorale Ingénierie pour la santé, la cognition, l'environnement;EDISCE;8;Sciences pour l'ingénieur;2018;2017-18;2017;2017;3;2;1;8;4;4;7;3;4;;;;;fPs1t
217;École doctorale Mathématiques, sciences et technologies de l'information, informatique;MSTII;1;Mathématiques et leurs interactions;2018;2017-18;2017;2017;26;4;22;90;14;76;21;8;13;;;;;Ehx7v
218;École doctorale Chimie et sciences du vivant;EDCSV;5;Biologie, médecine et santé;2018;2017-18;2017;2017;57;30;27;188;109;79;58;38;20;;;;;8bcJh
220;École doctorale Électronique, électrotechnique, automatique, traitement du signal;EEATS;2;Physique;2018;2017-18;2017;2017;15;8;7;64;21;43;8;1;7;;;;;IxEaw
220;École doctorale Électronique, électrotechnique, automatique, traitement du signal;EEATS;4;Chimie;2018;2017-18;2017;2017;0;0;0;1;0;1;0;0;0;;;;;IxEaw
222;École doctorale Sciences chimiques;EDSC;2;Physique;2018;2017-18;2017;2017;2;1;1;9;4;5;3;0;3;;;;;AdU8Q
227;École doctorale Sciences de la nature et de l'homme;;3;Sciences de la terre et de l'univers, espace;2018;2017-18;2017;2017;0;0;0;4;1;3;1;0;1;;;;;xiDA5
227;École doctorale Sciences de la nature et de l'homme;;5;Biologie, médecine et santé;2018;2017-18;2017;2017;12;6;6;49;25;24;27;13;14;;;;;xiDA5
227;École doctorale Sciences de la nature et de l'homme;;6;Sciences humaines et humanités;2018;2017-18;2017;2017;5;4;1;42;23;19;18;11;7;;;;;xiDA5
234;École doctorale de Sciences Po;;6;Sciences humaines et humanités;2018;2017-18;2017;2017;61;31;30;325;165;160;48;27;21;;;;;ux756
242;École doctorale Économie - Gestion - Normandie;;7;Sciences de la société;2018;2017-18;2017;2017;15;8;7;80;39;41;10;6;4;;;;;z35ku
245;École doctorale Sciences économiques, juridiques, politiques et de gestion;;7;Sciences de la société;2018;2017-18;2017;2017;37;16;21;200;84;116;29;13;16;;;;;ShLUg
251;École doctorale Sciences de l'environnement;;4;Chimie;2018;2017-18;2017;2017;7;4;3;19;12;7;2;2;0;;;;;VR28y
251;École doctorale Sciences de l'environnement;;6;Sciences humaines et humanités;2018;2017-18;2017;2017;0;0;0;7;5;2;0;0;0;;;;;VR28y
254;École doctorale Sciences de la matière;;2;Physique;2018;2017-18;2017;2017;0;0;0;0;0;0;5;1;4;;;;;365F2
267;École doctorale Arts et médias;;6;Sciences humaines et humanités;2018;2017-18;2017;2017;29;19;10;250;170;80;39;25;14;;;;;eCF5C
269;École doctorale Mathématiques, sciences de l'information et de l'ingénieur;MSII;4;Chimie;2018;2017-18;2017;2017;0;0;0;40;23;17;0;0;0;;;;;5E625
269;École doctorale Mathématiques, sciences de l'information et de l'ingénieur;MSII;6;Sciences humaines et humanités;2018;2017-18;2017;2017;1;0;1;19;0;19;0;0;0;;;;;5E625
269;École doctorale Mathématiques, sciences de l'information et de l'ingénieur;MSII;8;Sciences pour l'ingénieur;2018;2017-18;2017;2017;30;3;27;63;14;49;40;10;30;;;;;5E625
286;École doctorale de l'Ehess;;7;Sciences de la société;2018;2017-18;2017;2017;150;86;64;1042;593;449;103;57;46;;;;;2S146
304;École doctorale Sciences et environnements;;7;Sciences de la société;2018;2017-18;2017;2017;0;0;0;9;7;2;1;1;0;;;;;2ywZn
305;École doctorale Énergie et environnement;E2;1;Mathématiques et leurs interactions;2018;2017-18;2017;2017;2;0;2;8;6;2;1;0;1;;;;;Kbt8I
305;École doctorale Énergie et environnement;E2;3;Sciences de la terre et de l'univers, espace;2018;2017-18;2017;2017;4;3;1;13;7;6;4;0;4;;;;;Kbt8I
305;École doctorale Énergie et environnement;E2;9;Sciences et technologies de l'information et de la communication;2018;2017-18;2017;2017;1;0;1;5;1;4;2;1;1;;;;;Kbt8I
323;École doctorale Génie électrique, électronique et télécommunications;GEET;8;Sciences pour l'ingénieur;2018;2017-18;2017;2017;63;20;43;213;63;150;67;13;54;;;;;arcz6
328;École doctorale Arts, lettres, langues, philosophie et communication;ALLPH@;3;Sciences de la terre et de l'univers, espace;2018;2017-18;2017;2017;0;0;0;1;1;0;0;0;0;;;;;xLxMh
341;École doctorale Évolution, écosystèmes, microbiologie, modélisation;E2M2;10;Sciences agronomiques et écologiques;2018;2017-18;2017;2017;9;6;3;55;34;21;12;3;9;;;;;J83I0
353;École doctorale Sciences pour l'ingénieur : mécanique, physique, micro et nanoélectronique;;4;Chimie;2018;2017-18;2017;2017;0;0;0;5;3;2;0;0;0;;;;;vk5Kp
355;École doctorale Espaces, cultures, sociétés;;6;Sciences humaines et humanités;2018;2017-18;2017;2017;24;10;14;216;120;96;51;30;21;;;;;2kMf5
355;École doctorale Espaces, cultures, sociétés;;9;Sciences et technologies de l'information et de la communication;2018;2017-18;2017;2017;0;0;0;1;0;1;0;0;0;;;;;2kMf5
364;École doctorale Sciences fondamentales et appliquées;EDSFA;2;Physique;2018;2017-18;2017;2017;20;5;15;55;16;39;13;4;9;;;;;E483q
372;École doctorale Sciences économiques et de gestion;;7;Sciences de la société;2018;2017-18;2017;2017;47;31;16;177;93;84;33;18;15;;;;;JK63A
396;École doctorale Économie, organisations, société;EOS;1;Mathématiques et leurs interactions;2018;2017-18;2017;2017;0;0;0;4;3;1;0;0;0;;;;;Es5e7
396;École doctorale Économie, organisations, société;EOS;6;Sciences humaines et humanités;2018;2017-18;2017;2017;1;1;0;24;7;17;6;4;2;;;;;Es5e7
397;École doctorale Physique et chimie des matériaux;;4;Chimie;2018;2017-18;2017;2017;69;30;39;232;100;132;79;36;43;;;;;WxSt9
398;École doctorale Géosciences, ressources naturelles et environnement;GRNE;1;Mathématiques et leurs interactions;2018;2017-18;2017;2017;0;0;0;1;0;1;0;0;0;;;;;Zi4Zf
400;École doctorale Savoirs scientifiques : épistémologie, histoire des sciences, didactique des disciplines;;8;Sciences pour l'ingénieur;2018;2017-18;2017;2017;0;0;0;1;0;1;0;0;0;;;;;nRax3
410;École doctorale Sciences et ingénierie des ressources, procédés, produits, environnement;RP2E;4;Chimie;2018;2017-18;2017;2017;0;0;0;4;3;1;1;0;1;;;;;Q5fxV
410;École doctorale Sciences et ingénierie des ressources, procédés, produits, environnement;RP2E;10;Sciences agronomiques et écologiques;2018;2017-18;2017;2017;28;14;14;98;55;43;49;28;21;;;;;Q5fxV
411;École doctorale Humanités nouvelles : Fernand Braudel;;9;Sciences et technologies de l'information et de la communication;2018;2017-18;2017;2017;8;6;2;32;20;12;3;2;1;;;;;l2rFh
412;École doctorale Lorraine de chimie et physique moléculaires : synthèses, expériences, simulations, applications : de la molécule aux édifices supramoléculaires;SESAMES;2;Physique;2018;2017-18;2017;2017;3;0;3;18;2;16;4;2;2;;;;;mvHX2
413;École doctorale Sciences de la terre et de l'environnement;STE;3;Sciences de la terre et de l'univers, espace;2018;2017-18;2017;2017;17;4;13;72;28;44;12;4;8;;;;;u9BA9
413;École doctorale Sciences de la terre et de l'environnement;STE;5;Biologie, médecine et santé;2018;2017-18;2017;2017;0;0;0;2;2;0;0;0;0;;;;;u9BA9
413;École doctorale Sciences de la terre et de l'environnement;STE;6;Sciences humaines et humanités;2018;2017-18;2017;2017;3;1;2;16;6;10;3;2;1;;;;;u9BA9
414;École doctorale Sciences de la vie et de la santé;;10;Sciences agronomiques et écologiques;2018;2017-18;2017;2017;3;2;1;11;5;6;2;1;1;;;;;YI4xS
417;École doctorale Sciences et Ingénierie;S&I;2;Physique;2018;2017-18;2017;2017;3;0;3;8;1;7;1;0;1;;;;;SSBvE
417;École doctorale Sciences et Ingénierie;S&I;5;Biologie, médecine et santé;2018;2017-18;2017;2017;4;3;1;9;5;4;3;1;2;;;;;SSBvE
433;École doctorale Concepts et langages;;6;Sciences humaines et humanités;2018;2017-18;2017;2017;90;53;37;499;279;220;56;32;24;;;;;v8q34
446;École doctorale Biologie - Santé;EDBSL;6;Sciences humaines et humanités;2018;2017-18;2017;2017;4;2;2;6;4;2;2;0;2;;;;;4iEUF
461;École doctorale Droit et science politique;;7;Sciences de la société;2018;2017-18;2017;2017;73;43;30;276;155;121;33;16;17;;;;;QGArN
465;École doctorale Économie Panthéon Sorbonne;EPS;7;Sciences de la société;2018;2017-18;2017;2017;64;27;37;307;137;170;63;20;43;;;;;MV68S
467;École doctorale Aéronautique, astronautique;AA;4;Chimie;2018;2017-18;2017;2017;3;1;2;4;1;3;0;0;0;;;;;U7l45
468;École doctorale Mécanique, énergétique, génie civil, procédés;MEGEP;8;Sciences pour l'ingénieur;2018;2017-18;2017;2017;110;31;79;467;126;341;105;43;62;;;;;4XUTB
469;École doctorale du Pacifique;EDP;6;Sciences humaines et humanités;2018;2017-18;2017;2017;3;2;1;17;7;10;2;0;2;;;;;t9Z2n
472;École doctorale de l'EPHE;;2;Physique;2018;2017-18;2017;2017;1;1;0;1;1;0;0;0;0;;;;;27zK4
475;École doctorale Mathématiques, informatique, télécommunications de Toulouse;MITT;1;Mathématiques et leurs interactions;2018;2017-18;2017;2017;40;15;25;135;43;92;28;11;17;;;;;xcp2r
476;École doctorale Neurosciences et cognition;NSCO;6;Sciences humaines et humanités;2018;2017-18;2017;2017;12;7;5;35;18;17;5;4;1;;;;;B1H0x
488;École doctorale Sciences, ingénierie, santé;SIS;8;Sciences pour l'ingénieur;2018;2017-18;2017;2017;26;9;17;98;28;70;26;8;18;;;;;Fy2lK
488;École doctorale Sciences, ingénierie, santé;SIS;10;Sciences agronomiques et écologiques;2018;2017-18;2017;2017;0;0;0;3;2;1;1;1;0;;;;;Fy2lK
489;École doctorale Sciences et ingénierie des systèmes, de l'environnement et des organisations;SISEO;3;Sciences de la terre et de l'univers, espace;2018;2017-18;2017;2017;1;0;1;8;3;5;3;2;1;;;;;6pT77
489;École doctorale Sciences et ingénierie des systèmes, de l'environnement et des organisations;SISEO;6;Sciences humaines et humanités;2018;2017-18;2017;2017;5;4;1;21;17;4;1;0;1;;;;;6pT77
493;École doctorale Erasme;;6;Sciences humaines et humanités;2018;2017-18;2017;2017;12;7;5;114;75;39;20;14;6;;;;;FPW4T
502;École doctorale Biologie - Santé;;5;Biologie, médecine et santé;2018;2017-18;2017;2017;0;0;0;0;0;0;36;20;16;;;;;JCFV7
502;École doctorale Biologie - Santé;;10;Sciences agronomiques et écologiques;2018;2017-18;2017;2017;0;0;0;0;0;0;2;0;2;;;;;JCFV7
507;École doctorale Sciences humaines et sociales;;6;Sciences humaines et humanités;2018;2017-18;2017;2017;0;0;0;0;0;0;31;15;16;;;;;3e7VM
509;École doctorale Civilisations et sociétés euro-méditerranéennes et comparées;;7;Sciences de la société;2018;2017-18;2017;2017;42;16;26;163;64;99;15;8;7;;;;;9tbyG
510;École doctorale Ingénierie - Matériaux, mécanique, environnement, énergétique, procédés, production;IMEP2;8;Sciences pour l'ingénieur;2018;2017-18;2017;2017;133;48;85;399;131;268;102;23;79;;;;;Ce7NF
512;École doctorale Informatique et mathématiques;InfoMaths;1;Mathématiques et leurs interactions;2018;2017-18;2017;2017;24;7;17;97;26;71;26;3;23;;;;;t86bi
512;École doctorale Informatique et mathématiques;InfoMaths;9;Sciences et technologies de l'information et de la communication;2018;2017-18;2017;2017;51;12;39;225;49;176;51;15;36;;;;;t86bi
513;École doctorale Droit et sciences politiques, économiques et de gestion;DESPEG;7;Sciences de la société;2018;2017-18;2017;2017;70;29;41;293;143;150;41;24;17;;;;;aVHGU
519;École doctorale Sciences humaines et sociales - Perspectives européennes;SHS-PE;6;Sciences humaines et humanités;2018;2017-18;2017;2017;43;24;19;294;180;114;21;17;4;;;;;2f5qs
521;École doctorale Sciences et ingénierie pour l'information, mathématiques;S2I;1;Mathématiques et leurs interactions;2018;2017-18;2017;2017;10;1;9;47;14;33;15;4;11;;;;;V6i83
521;École doctorale Sciences et ingénierie pour l'information, mathématiques;S2I;9;Sciences et technologies de l'information et de la communication;2018;2017-18;2017;2017;32;5;27;132;27;105;25;5;20;;;;;V6i83
522;École doctorale Sciences et ingénierie en matériaux, mécanique, énergétique et aéronautique;SI-MMEA;2;Physique;2018;2017-18;2017;2017;8;1;7;34;6;28;7;4;3;;;;;82F19
523;École doctorale Sciences pour l'environnement - Gay Lussac;;5;Biologie, médecine et santé;2018;2017-18;2017;2017;4;2;2;17;9;8;10;4;6;;;;;6xD69
523;École doctorale Sciences pour l'environnement - Gay Lussac;;6;Sciences humaines et humanités;2018;2017-18;2017;2017;2;2;0;6;4;2;1;0;1;;;;;6xD69
523;École doctorale Sciences pour l'environnement - Gay Lussac;;8;Sciences pour l'ingénieur;2018;2017-18;2017;2017;0;0;0;1;1;0;0;0;0;;;;;6xD69
524;École doctorale Biologie - santé;;10;Sciences agronomiques et écologiques;2018;2017-18;2017;2017;0;0;0;1;1;0;0;0;0;;;;;S7Kk6
525;"École doctorale Lettres, pensée, arts et histoire, ""Civilisation de l'antiquité à nos jours""";LPAH;6;Sciences humaines et humanités;2018;2017-18;2017;2017;61;33;28;271;149;122;36;21;15;;;;;19Rpr
528;École doctorale Ville, transports et territoires;VTT;8;Sciences pour l'ingénieur;2018;2017-18;2017;2017;5;1;4;23;5;18;4;3;1;;;;;68zCc
529;École doctorale Cultures et sociétés;CS;9;Sciences et technologies de l'information et de la communication;2018;2017-18;2017;2017;3;0;3;3;0;3;0;0;0;;;;;XU9tb
530;École doctorale Organisations, marchés, institutions;OMI;7;Sciences de la société;2018;2017-18;2017;2017;13;7;6;116;62;54;15;9;6;;;;;4htv7
531;École doctorale Sciences, ingénierie et environnement;SIE;5;Biologie, médecine et santé;2018;2017-18;2017;2017;1;1;0;5;3;2;0;0;0;;;;;b5BYq
531;École doctorale Sciences, ingénierie et environnement;SIE;6;Sciences humaines et humanités;2018;2017-18;2017;2017;0;0;0;2;1;1;0;0;0;;;;;b5BYq
531;École doctorale Sciences, ingénierie et environnement;SIE;10;Sciences agronomiques et écologiques;2018;2017-18;2017;2017;0;0;0;6;3;3;1;1;0;;;;;b5BYq
536;École doctorale Sciences et agrosciences;;1;Mathématiques et leurs interactions;2018;2017-18;2017;2017;0;0;0;2;1;1;4;1;3;;;;;pHfqe
536;École doctorale Sciences et agrosciences;;5;Biologie, médecine et santé;2018;2017-18;2017;2017;5;4;1;8;5;3;2;0;2;;;;;pHfqe
540;"École doctorale École transdisciplinaire ""lettres/sciences""";;4;Chimie;2018;2017-18;2017;2017;0;0;0;2;0;2;1;1;0;;;;;tWWw7
540;"École doctorale École transdisciplinaire ""lettres/sciences""";;6;Sciences humaines et humanités;2018;2017-18;2017;2017;46;19;27;161;78;83;22;12;10;;;;;tWWw7
541;École doctorale de sciences humaines et sociales de La Réunion;SHS;7;Sciences de la société;2018;2017-18;2017;2017;0;0;0;0;0;0;12;5;7;;;;;21SpE
542;École doctorale de sciences de La Réunion;STS;2;Physique;2018;2017-18;2017;2017;8;1;7;33;11;22;4;2;2;;;;;2pAql
543;École doctorale de Dauphine;;9;Sciences et technologies de l'information et de la communication;2018;2017-18;2017;2017;14;2;12;40;11;29;10;3;7;;;;;u8w6A
545;École doctorale Sociétés, politique et santé publique;SP2;5;Biologie, médecine et santé;2018;2017-18;2017;2017;15;6;9;66;35;31;21;11;10;;;;;IAKR4
546;École doctorale Abbé Grégoire;;6;Sciences humaines et humanités;2018;2017-18;2017;2017;13;7;6;135;80;55;18;11;7;;;;;ZSn7q
546;École doctorale Abbé Grégoire;;7;Sciences de la société;2018;2017-18;2017;2017;20;13;7;113;57;56;8;5;3;;;;;ZSn7q
547;École doctorale Sciences, Technologie, Santé;EDSTS;2;Physique;2018;2017-18;2017;2017;7;3;4;24;12;12;3;1;2;;;;;wEdn2
547;École doctorale Sciences, Technologie, Santé;EDSTS;5;Biologie, médecine et santé;2018;2017-18;2017;2017;10;6;4;72;45;27;17;11;6;;;;;wEdn2
548;École doctorale Mer et Sciences;;1;Mathématiques et leurs interactions;2018;2017-18;2017;2017;5;1;4;19;4;15;3;2;1;;;;;QX0fS
548;École doctorale Mer et Sciences;;4;Chimie;2018;2017-18;2017;2017;7;5;2;21;9;12;4;3;1;;;;;QX0fS
549;École doctorale Santé, Sciences Biologiques et Chimie du Vivant;SSBCV;6;Sciences humaines et humanités;2018;2017-18;2017;2017;2;1;1;6;3;3;6;4;2;;;;;B9ggO
551;École doctorale Mathématiques, Informatique, Physique Théorique et Ingénierie des Systèmes;MIPTIS;9;Sciences et technologies de l'information et de la communication;2018;2017-18;2017;2017;20;5;15;78;20;58;19;3;16;;;;;Mpudz
552;École doctorale Énergie - Matériaux - Sciences de la Terre et de l'Univers;EMTSU;3;Sciences de la terre et de l'univers, espace;2018;2017-18;2017;2017;13;8;5;52;21;31;13;4;9;;;;;NTZhw
552;École doctorale Énergie - Matériaux - Sciences de la Terre et de l'Univers;EMTSU;4;Chimie;2018;2017-18;2017;2017;15;10;5;52;25;27;13;5;8;;;;;NTZhw
553;École doctorale Carnot - Pasteur;;2;Physique;2018;2017-18;2017;2017;14;2;12;52;9;43;10;2;8;;;;;6h4Z7
554;École doctorale Environnements - Santé;E-S;10;Sciences agronomiques et écologiques;2018;2017-18;2017;2017;23;7;16;68;30;38;10;5;5;;;;;ElyFU
555;École doctorale Sciences de l'Homme et de la Société;SHS;6;Sciences humaines et humanités;2018;2017-18;2017;2017;24;13;11;104;54;50;10;5;5;;;;;44G6m
556;École doctorale Homme, Sociétés, Risques, Territoire;HSRT;7;Sciences de la société;2018;2017-18;2017;2017;16;6;10;55;21;34;3;1;2;;;;;5QEaX
558;École doctorale Histoire, Mémoire, Patrimoine, Langage;HMPL;6;Sciences humaines et humanités;2018;2017-18;2017;2017;78;36;42;343;183;160;46;24;22;;;;;uX3jT
559;École doctorale Management Panthéon-Sorbonne;;7;Sciences de la société;2018;2017-18;2017;2017;51;25;26;211;102;109;30;12;18;;;;;4SP7k
561;École doctorale Hématologie, Oncogenèse et Biothérapies;HOB;5;Biologie, médecine et santé;2018;2017-18;2017;2017;58;32;26;197;121;76;44;26;18;;;;;7Klb2
563;École doctorale Médicament - Toxicologie - Chimie - Imageries;MTCI;4;Chimie;2018;2017-18;2017;2017;19;9;10;49;25;24;11;3;8;;;;;j8uk1
563;École doctorale Médicament - Toxicologie - Chimie - Imageries;MTCI;5;Biologie, médecine et santé;2018;2017-18;2017;2017;41;31;10;156;86;70;45;26;19;;;;;j8uk1
566;École doctorale Sciences du Sport, de la Motricité et du Mouvement Humain;SMMH;5;Biologie, médecine et santé;2018;2017-18;2017;2017;12;8;4;71;36;35;13;6;7;;;;;3iv8y
566;École doctorale Sciences du Sport, de la Motricité et du Mouvement Humain;SMMH;6;Sciences humaines et humanités;2018;2017-18;2017;2017;8;3;5;41;17;24;14;10;4;;;;;3iv8y
571;École doctorale Sciences Chimiques : Molécules, Matériaux, Instrumentation et Biosystemes;2MIB;5;Biologie, médecine et santé;2018;2017-18;2017;2017;0;0;0;1;1;0;0;0;0;;;;;zbi37
573;École doctorale Interfaces : Approches Interdisciplinaires, Fondements, Applications et Innovation;ED INTERFACES;5;Biologie, médecine et santé;2018;2017-18;2017;2017;4;2;2;22;9;13;6;2;4;;;;;gG820
573;École doctorale Interfaces : Approches Interdisciplinaires, Fondements, Applications et Innovation;ED INTERFACES;9;Sciences et technologies de l'information et de la communication;2018;2017-18;2017;2017;11;2;9;39;7;32;14;4;10;;;;;gG820
575;École doctorale Electrical, Optical, Bio : Physics and Engineering;EOBE;1;Mathématiques et leurs interactions;2018;2017-18;2017;2017;1;0;1;1;0;1;0;0;0;;;;;dfhyn
575;École doctorale Electrical, Optical, Bio : Physics and Engineering;EOBE;9;Sciences et technologies de l'information et de la communication;2018;2017-18;2017;2017;6;1;5;37;10;27;5;0;5;;;;;dfhyn
576;École doctorale Particules, Hadrons, Énergie, Noyau, Instrumentation, Imagerie, Cosmos et Simulation;PHENIICS;5;Biologie, médecine et santé;2018;2017-18;2017;2017;1;0;1;1;0;1;0;0;0;;;;;qC4rf
580;École doctorale Sciences et technologies de l'information et de la communication;STIC;9;Sciences et technologies de l'information et de la communication;2018;2017-18;2017;2017;191;49;142;750;190;560;129;37;92;;;;;AzCC0
582;École doctorale Cancérologie, Biologie, Médecine, Santé;CBMS;8;Sciences pour l'ingénieur;2018;2017-18;2017;2017;0;0;0;1;1;0;0;0;0;;;;;75bj4
582;École doctorale Cancérologie, Biologie, Médecine, Santé;CBMS;9;Sciences et technologies de l'information et de la communication;2018;2017-18;2017;2017;1;0;1;1;0;1;0;0;0;;;;;75bj4
583;École doctorale Risques et Société;;7;Sciences de la société;2018;2017-18;2017;2017;1;1;0;7;2;5;0;0;0;;;;;wUBi9
584;École doctorale Biodiversité, Agriculture, Alimentation, Environnement, Terre, Eau;GAIA;5;Biologie, médecine et santé;2018;2017-18;2017;2017;15;7;8;66;34;32;18;9;9;;;;;F1h5f
584;École doctorale Biodiversité, Agriculture, Alimentation, Environnement, Terre, Eau;GAIA;8;Sciences pour l'ingénieur;2018;2017-18;2017;2017;0;0;0;53;25;28;21;12;9;;;;;F1h5f
584;École doctorale Biodiversité, Agriculture, Alimentation, Environnement, Terre, Eau;GAIA;10;Sciences agronomiques et écologiques;2018;2017-18;2017;2017;128;65;63;373;180;193;77;41;36;;;;;F1h5f
585;École doctorale Sciences, Technologie,  Sante;EDSTS;2;Physique;2018;2017-18;2017;2017;1;1;0;12;6;6;4;3;1;;;;;NM3Dl
586;École doctorale Sciences Humaines et Sociales;EDSHS;6;Sciences humaines et humanités;2018;2017-18;2017;2017;51;25;26;198;104;94;25;11;14;;;;;0RKVX
587;École doctorale Diversites, santé et développement en Amazonie;;5;Biologie, médecine et santé;2018;2017-18;2017;2017;4;4;0;22;18;4;5;2;3;;;;;V14tj
589;École doctorale Milieu insulaire tropical à risques : protection, valorisation , santé et développement;;4;Chimie;2018;2017-18;2017;2017;1;0;1;6;4;2;1;1;0;;;;;2cqi3
590;École doctorale Mathematiques, Information, Ingenierie des Systemes;MIIS;2;Physique;2018;2017-18;2017;2017;0;0;0;1;0;1;0;0;0;;;;;L20t5
591;École doctorale Physique, Sciences de l'Ingenieur, Materiaux, Énergie;PSIME;2;Physique;2018;2017-18;2017;2017;26;9;17;97;26;71;33;10;23;;;;;Hn5Om
591;École doctorale Physique, Sciences de l'Ingenieur, Materiaux, Énergie;PSIME;3;Sciences de la terre et de l'univers, espace;2018;2017-18;2017;2017;1;0;1;8;4;4;2;1;1;;;;;Hn5Om
596;École doctorale Matière, Molécules et Matériaux;ED 3M;8;Sciences pour l'ingénieur;2018;2017-18;2017;2017;0;0;0;1;0;1;0;0;0;;;;;77947
597;École doctorale Sciences économiques et sciences de Gestion;EDGE;7;Sciences de la société;2018;2017-18;2017;2017;57;24;33;267;111;156;39;16;23;;;;;d8Zuu
598;École doctorale Sciences de La Mer et du Littoral;SML;5;Biologie, médecine et santé;2018;2017-18;2017;2017;7;3;4;43;25;18;8;4;4;;;;;Smen6
598;École doctorale Sciences de La Mer et du Littoral;SML;8;Sciences pour l'ingénieur;2018;2017-18;2017;2017;5;2;3;24;8;16;3;3;0;;;;;Smen6
600;École doctorale Écologie, Géosciences, Agronomie et Alimentation;EGAAL;10;Sciences agronomiques et écologiques;2018;2017-18;2017;2017;73;35;38;223;119;104;30;17;13;;;;;urS33
603;École doctorale Éducation, Langages, Interactions, Cognition, Clinique, Expertise - ED 603;ELICCE;6;Sciences humaines et humanités;2018;2017-18;2017;2017;93;48;45;387;229;158;38;21;17;;;;;1Mzw7
604;École doctorale Sociétés, Temps, Territoires;STT;7;Sciences de la société;2018;2017-18;2017;2017;19;10;9;70;41;29;5;4;1;;;;;SZI5T
34;École doctorale Matériaux;;4;Chimie;2013;2012-13;2012;2012;15;6;9;50;27;23;7;5;2;;;;;1Iufh
34;École doctorale Matériaux;;8;Sciences pour l'ingénieur;2013;2012-13;2012;2012;10;4;6;31;18;13;6;2;4;;;;;1Iufh
37;École doctorale Sciences physiques pour l'ingénieur et microtechniques;SPIM;9;Sciences et technologies de l'information et de la communication;2013;2012-13;2012;2012;51;8;43;180;26;154;23;6;17;;;;;F7G1B
47;École doctorale Physique;;2;Physique;2013;2012-13;2012;2012;104;29;75;361;94;267;119;36;83;;;;;8kNpd
60;École doctorale Territoires, temps, sociétés et développement;TTSD;7;Sciences de la société;2013;2012-13;2012;2012;19;10;9;71;38;33;11;7;4;;;;;fkIh6
60;École doctorale Territoires, temps, sociétés et développement;TTSD;10;Sciences agronomiques et écologiques;2013;2012-13;2012;2012;0;0;0;4;2;2;0;0;0;;;;;fkIh6
65;École doctorale Sciences de la Vie, Santé, Agronomie, Environnement;;5;Biologie, médecine et santé;2013;2012-13;2012;2012;40;31;9;151;91;60;31;20;11;;;;;MAOG4
71;École doctorale Sciences pour l'ingénieur;;1;Mathématiques et leurs interactions;2013;2012-13;2012;2012;3;2;1;7;5;2;0;0;0;;;;;H6UYp
71;École doctorale Sciences pour l'ingénieur;;8;Sciences pour l'ingénieur;2013;2012-13;2012;2012;56;22;34;200;75;125;45;22;23;;;;;H6UYp
73;École doctorale Sciences économiques, sociales, de l'aménagement et du management;SESAM;1;Mathématiques et leurs interactions;2013;2012-13;2012;2012;3;0;3;6;2;4;2;1;1;;;;;IQ0Hk
74;École doctorale Sciences juridiques, politique et de gestion;SJPG;7;Sciences de la société;2013;2012-13;2012;2012;59;20;39;314;157;157;20;13;7;;;;;3A2RY
88;École doctorale Droit et science politique;DSP;7;Sciences de la société;2013;2012-13;2012;2012;55;25;30;333;149;184;36;12;24;;;;;elnAJ
101;École doctorale de Sciences juridiques;;7;Sciences de la société;2013;2012-13;2012;2012;40;19;21;315;162;153;42;18;24;;;;;569G2
104;École doctorale Sciences de la matière, du rayonnement et de l'environnement;SMRE;2;Physique;2013;2012-13;2012;2012;17;5;12;66;25;41;12;4;8;;;;;Q5iFz
105;École doctorale Terre, univers, environnement;;3;Sciences de la terre et de l'univers, espace;2013;2012-13;2012;2012;48;20;28;206;79;127;42;16;26;;;;;lcWAf
112;École doctorale Archéologie;;6;Sciences humaines et humanités;2013;2012-13;2012;2012;53;34;19;322;203;119;35;26;9;;;;;EvU7R
120;École doctorale Littérature française et comparée;;6;Sciences humaines et humanités;2013;2012-13;2012;2012;62;43;19;284;209;75;35;24;11;;;;;3ULpe
122;École doctorale Europe latine - Amérique latine;;6;Sciences humaines et humanités;2013;2012-13;2012;2012;50;30;20;260;165;95;60;20;40;;;;;z9lZY
127;École doctorale Astronomie et astrophysique d'Ile de France;A&A;3;Sciences de la terre et de l'univers, espace;2013;2012-13;2012;2012;46;14;32;163;57;106;47;19;28;;;;;cPXrq
139;École doctorale Connaissance, langage, modélisation;CLM;2;Physique;2013;2012-13;2012;2012;4;0;4;29;7;22;8;3;5;;;;;1lxGH
141;École doctorale Droit et science politique;DSP;7;Sciences de la société;2013;2012-13;2012;2012;48;21;27;298;130;168;23;10;13;;;;;CyNBf
146;École doctorale Galilée;GALILEE;8;Sciences pour l'ingénieur;2013;2012-13;2012;2012;13;6;7;32;12;20;7;4;3;;;;;71hqm
156;École doctorale Sciences de la mer;;3;Sciences de la terre et de l'univers, espace;2013;2012-13;2012;2012;17;8;9;63;26;37;18;6;12;;;;;EGY9P
156;École doctorale Sciences de la mer;;5;Biologie, médecine et santé;2013;2012-13;2012;2012;16;11;5;54;30;24;15;9;6;;;;;EGY9P
158;École doctorale Cerveau, cognition, comportement;3C;5;Biologie, médecine et santé;2013;2012-13;2012;2012;101;53;48;364;208;156;70;38;32;;;;;Il62F
159;École doctorale Esthétique, sciences et technologies des arts;EDESTA;6;Sciences humaines et humanités;2013;2012-13;2012;2012;57;35;22;311;196;115;27;14;13;;;;;zj1Vj
166;École doctorale Information, structures et systèmes;I2S;9;Sciences et technologies de l'information et de la communication;2013;2012-13;2012;2012;52;12;40;160;31;129;48;7;41;;;;;2uO68
171;École doctorale Toulouse sciences économiques;TSE;7;Sciences de la société;2013;2012-13;2012;2012;20;6;14;96;33;63;18;3;15;;;;;Q5nNQ
173;École doctorale Sciences de l'univers, de l'environnement et de l'espace;SDU2E;10;Sciences agronomiques et écologiques;2013;2012-13;2012;2012;7;6;1;28;18;10;3;2;1;;;;;R0Z9c
180;École doctorale Sciences humaines et sociales : cultures, individus, sociétés;SHS;6;Sciences humaines et humanités;2013;2012-13;2012;2012;23;18;5;91;66;25;19;12;7;;;;;D2BT3
181;École doctorale Structure, informations, matière et matériaux;Simem;9;Sciences et technologies de l'information et de la communication;2013;2012-13;2012;2012;10;1;9;40;9;31;12;3;9;;;;;c1D6f
188;École doctorale Histoire moderne et contemporaine;;6;Sciences humaines et humanités;2013;2012-13;2012;2012;44;13;31;220;89;131;34;10;24;;;;;RSZ7F
209;École doctorale Sciences physiques et de L'ingénieur;SPI;8;Sciences pour l'ingénieur;2013;2012-13;2012;2012;22;6;16;91;30;61;33;5;28;;;;;tZcIZ
211;École doctorale Sciences exactes et leurs applications;ED SEA;1;Mathématiques et leurs interactions;2013;2012-13;2012;2012;6;3;3;28;8;20;3;1;2;;;;;1G1iC
211;École doctorale Sciences exactes et leurs applications;ED SEA;6;Sciences humaines et humanités;2013;2012-13;2012;2012;0;0;0;2;1;1;1;0;1;;;;;1G1iC
216;École doctorale Ingénierie pour la santé, la cognition, l'environnement;EDISCE;10;Sciences agronomiques et écologiques;2013;2012-13;2012;2012;0;0;0;4;3;1;2;2;0;;;;;fPs1t
218;École doctorale Chimie et sciences du vivant;EDCSV;4;Chimie;2013;2012-13;2012;2012;26;17;9;99;53;46;31;12;19;;;;;8bcJh
218;École doctorale Chimie et sciences du vivant;EDCSV;5;Biologie, médecine et santé;2013;2012-13;2012;2012;66;32;34;233;137;96;51;23;28;;;;;8bcJh
220;École doctorale Électronique, électrotechnique, automatique, traitement du signal;EEATS;8;Sciences pour l'ingénieur;2013;2012-13;2012;2012;28;6;22;105;22;83;31;11;20;;;;;IxEaw
220;École doctorale Électronique, électrotechnique, automatique, traitement du signal;EEATS;9;Sciences et technologies de l'information et de la communication;2013;2012-13;2012;2012;100;23;77;414;98;316;101;20;81;;;;;IxEaw
221;École doctorale Augustin Cournot - Sciences économiques et de gestion - Sciences, technologies et sociétés;EDAC;6;Sciences humaines et humanités;2013;2012-13;2012;2012;2;1;1;10;5;5;0;0;0;;;;;5z9rW
221;École doctorale Augustin Cournot - Sciences économiques et de gestion - Sciences, technologies et sociétés;EDAC;7;Sciences de la société;2013;2012-13;2012;2012;17;6;11;81;33;48;16;3;13;;;;;5z9rW
222;École doctorale Sciences chimiques;EDSC;2;Physique;2013;2012-13;2012;2012;0;0;0;2;2;0;1;0;1;;;;;AdU8Q
224;École doctorale Cognition, langage, interaction;;6;Sciences humaines et humanités;2013;2012-13;2012;2012;56;37;19;193;134;59;37;20;17;;;;;7v43e
227;École doctorale Sciences de la nature et de l'homme;;3;Sciences de la terre et de l'univers, espace;2013;2012-13;2012;2012;3;2;1;4;3;1;6;3;3;;;;;xiDA5
227;École doctorale Sciences de la nature et de l'homme;;4;Chimie;2013;2012-13;2012;2012;0;0;0;1;1;0;0;0;0;;;;;xiDA5
227;École doctorale Sciences de la nature et de l'homme;;7;Sciences de la société;2013;2012-13;2012;2012;0;0;0;1;1;0;0;0;0;;;;;xiDA5
227;École doctorale Sciences de la nature et de l'homme;;9;Sciences et technologies de l'information et de la communication;2013;2012-13;2012;2012;0;0;0;1;1;0;0;0;0;;;;;xiDA5
254;École doctorale Sciences de la matière;;4;Chimie;2013;2012-13;2012;2012;45;21;24;162;73;89;48;14;34;;;;;365F2
260;École doctorale pluridisciplinaire;;6;Sciences humaines et humanités;2013;2012-13;2012;2012;35;20;15;71;48;23;1;1;0;;;;;sCk1f
260;École doctorale pluridisciplinaire;;7;Sciences de la société;2013;2012-13;2012;2012;38;17;21;123;74;49;5;3;2;;;;;sCk1f
261;École doctorale Cognition, comportements, conduites humaines;3CH;6;Sciences humaines et humanités;2013;2012-13;2012;2012;44;37;7;138;105;33;20;16;4;;;;;KOLCy
270;École doctorale Théologie et sciences religieuses;;6;Sciences humaines et humanités;2013;2012-13;2012;2012;32;5;27;148;33;115;18;2;16;;;;;BRKC1
283;École doctorale Droit international et européen;;7;Sciences de la société;2013;2012-13;2012;2012;36;18;18;153;80;73;23;17;6;;;;;uIq4K
284;École doctorale Droit et Science Politique;DSP;6;Sciences humaines et humanités;2013;2012-13;2012;2012;33;21;12;175;105;70;12;5;7;;;;;ahH92
285;École doctorale Sciences pratiques;;1;Mathématiques et leurs interactions;2013;2012-13;2012;2012;4;2;2;25;7;18;12;0;12;;;;;Jd3t2
287;École doctorale Sciences pour l'ingénieur;;4;Chimie;2013;2012-13;2012;2012;6;4;2;15;7;8;2;0;2;;;;;48Q1j
304;École doctorale Sciences et environnements;;5;Biologie, médecine et santé;2013;2012-13;2012;2012;7;2;5;23;10;13;7;3;4;;;;;2ywZn
304;École doctorale Sciences et environnements;;6;Sciences humaines et humanités;2013;2012-13;2012;2012;0;0;0;5;1;4;6;4;2;;;;;2ywZn
305;École doctorale Énergie et environnement;E2;1;Mathématiques et leurs interactions;2013;2012-13;2012;2012;1;1;0;5;1;4;1;0;1;;;;;Kbt8I
305;École doctorale Énergie et environnement;E2;4;Chimie;2013;2012-13;2012;2012;1;1;0;10;4;6;7;1;6;;;;;Kbt8I
309;École doctorale Systèmes;EDSYS;8;Sciences pour l'ingénieur;2013;2012-13;2012;2012;31;5;26;97;17;80;21;5;16;;;;;8TT4b
323;École doctorale Génie électrique, électronique et télécommunications;GEET;5;Biologie, médecine et santé;2013;2012-13;2012;2012;7;5;2;27;15;12;6;2;4;;;;;arcz6
327;École doctorale Temps, espaces, sociétés, cultures;TESC;6;Sciences humaines et humanités;2013;2012-13;2012;2012;54;25;29;249;132;117;42;22;20;;;;;IjgiJ
327;École doctorale Temps, espaces, sociétés, cultures;TESC;7;Sciences de la société;2013;2012-13;2012;2012;25;14;11;172;91;81;30;11;19;;;;;IjgiJ
328;École doctorale Arts, lettres, langues, philosophie et communication;ALLPH@;6;Sciences humaines et humanités;2013;2012-13;2012;2012;75;46;29;295;167;128;40;23;17;;;;;xLxMh
340;École doctorale Biologie moléculaire, intégrative et cellulaire;BMIC;5;Biologie, médecine et santé;2013;2012-13;2012;2012;56;28;28;236;133;103;63;33;30;;;;;db7xq
341;École doctorale Évolution, écosystèmes, microbiologie, modélisation;E2M2;10;Sciences agronomiques et écologiques;2013;2012-13;2012;2012;28;15;13;122;71;51;22;7;15;;;;;J83I0
353;École doctorale Sciences pour l'ingénieur : mécanique, physique, micro et nanoélectronique;;8;Sciences pour l'ingénieur;2013;2012-13;2012;2012;26;5;21;146;31;115;37;9;28;;;;;vk5Kp
361;École doctorale Sciences et Technologies;ED ST;6;Sciences humaines et humanités;2013;2012-13;2012;2012;2;1;1;15;6;9;6;2;4;;;;;cOUmL
361;École doctorale Sciences et Technologies;ED ST;7;Sciences de la société;2013;2012-13;2012;2012;1;0;1;1;0;1;0;0;0;;;;;cOUmL
373;École doctorale Santé, information/communications et mathématiques, matière;SICMA;1;Mathématiques et leurs interactions;2013;2012-13;2012;2012;4;0;4;16;5;11;10;2;8;;;;;hTJF5
373;École doctorale Santé, information/communications et mathématiques, matière;SICMA;2;Physique;2013;2012-13;2012;2012;3;1;2;7;2;5;2;0;2;;;;;hTJF5
373;École doctorale Santé, information/communications et mathématiques, matière;SICMA;8;Sciences pour l'ingénieur;2013;2012-13;2012;2012;16;5;11;59;18;41;17;4;13;;;;;hTJF5
377;École doctorale Environnement et société;;2;Physique;2013;2012-13;2012;2012;2;1;1;9;1;8;3;0;3;;;;;ZMG5u
377;École doctorale Environnement et société;;10;Sciences agronomiques et écologiques;2013;2012-13;2012;2012;2;1;1;2;1;1;0;0;0;;;;;ZMG5u
378;École doctorale Sciences de l'homme et de la société;SHS;7;Sciences de la société;2013;2012-13;2012;2012;27;8;19;98;40;58;13;6;7;;;;;3XKuF
382;École doctorale Économie, espaces, sociétés, civilisations : pensée critique, politique et pratique sociale;EESC;7;Sciences de la société;2013;2012-13;2012;2012;33;14;19;72;40;32;22;10;12;;;;;9NI1W
386;École doctorale Sciences mathématiques de Paris centre;SMPC;1;Mathématiques et leurs interactions;2013;2012-13;2012;2012;120;29;91;481;102;379;93;23;70;;;;;wMj98
393;École doctorale Pierre Louis de Santé Publique : Épidémiologie et Sciences de l'information biomédicale;PLSP;1;Mathématiques et leurs interactions;2013;2012-13;2012;2012;1;0;1;2;0;2;0;0;0;;;;;69445
400;École doctorale Savoirs scientifiques : épistémologie, histoire des sciences, didactique des disciplines;;1;Mathématiques et leurs interactions;2013;2012-13;2012;2012;11;6;5;37;18;19;8;4;4;;;;;nRax3
400;École doctorale Savoirs scientifiques : épistémologie, histoire des sciences, didactique des disciplines;;6;Sciences humaines et humanités;2013;2012-13;2012;2012;0;0;0;16;8;8;1;1;0;;;;;nRax3
400;École doctorale Savoirs scientifiques : épistémologie, histoire des sciences, didactique des disciplines;;7;Sciences de la société;2013;2012-13;2012;2012;0;0;0;9;4;5;1;0;1;;;;;nRax3
401;École doctorale Sciences sociales;;7;Sciences de la société;2013;2012-13;2012;2012;59;33;26;263;148;115;21;6;15;;;;;raQ7K
402;École doctorale Sciences de la vie et de la santé;SVS;5;Biologie, médecine et santé;2013;2012-13;2012;2012;33;18;15;101;54;47;19;10;9;;;;;YKgsU
405;École doctorale Économie, management,mathématiques et physique de Cergy;EM2C;7;Sciences de la société;2013;2012-13;2012;2012;30;14;16;71;35;36;11;6;5;;;;;QbwSB
410;École doctorale Sciences et ingénierie des ressources, procédés, produits, environnement;RP2E;8;Sciences pour l'ingénieur;2013;2012-13;2012;2012;39;17;22;168;58;110;44;21;23;;;;;Q5fxV
411;École doctorale Humanités nouvelles : Fernand Braudel;;7;Sciences de la société;2013;2012-13;2012;2012;19;8;11;55;31;24;12;5;7;;;;;l2rFh
411;École doctorale Humanités nouvelles : Fernand Braudel;;9;Sciences et technologies de l'information et de la communication;2013;2012-13;2012;2012;3;1;2;27;15;12;5;1;4;;;;;l2rFh
413;École doctorale Sciences de la terre et de l'environnement;STE;8;Sciences pour l'ingénieur;2013;2012-13;2012;2012;1;0;1;4;2;2;2;0;2;;;;;u9BA9
414;École doctorale Sciences de la vie et de la santé;;2;Physique;2013;2012-13;2012;2012;0;0;0;2;1;1;0;0;0;;;;;YI4xS
417;École doctorale Sciences et Ingénierie;S&I;3;Sciences de la terre et de l'univers, espace;2013;2012-13;2012;2012;2;2;0;11;4;7;6;0;6;;;;;SSBvE
417;École doctorale Sciences et Ingénierie;S&I;8;Sciences pour l'ingénieur;2013;2012-13;2012;2012;14;4;10;46;11;35;6;1;5;;;;;SSBvE
422;École doctorale Sciences et technologies de l'information, des télécommunications et des systèmes;;8;Sciences pour l'ingénieur;2013;2012-13;2012;2012;6;0;6;43;7;36;15;5;10;;;;;998UM
426;École doctorale Gènes, génomes, cellules;;5;Biologie, médecine et santé;2013;2012-13;2012;2012;32;17;15;125;67;58;30;18;12;;;;;XPaY8
433;École doctorale Concepts et langages;;6;Sciences humaines et humanités;2013;2012-13;2012;2012;111;59;52;481;266;215;87;53;34;;;;;v8q34
435;École doctorale Agriculture, alimentation, biologie, environnement et santé;;5;Biologie, médecine et santé;2013;2012-13;2012;2012;31;20;11;111;68;43;44;29;15;;;;;mC35U
441;École doctorale Histoire de l'art;;6;Sciences humaines et humanités;2013;2012-13;2012;2012;39;30;9;248;182;66;35;29;6;;;;;d5W3U
446;École doctorale Biologie - Santé;EDBSL;5;Biologie, médecine et santé;2013;2012-13;2012;2012;101;52;49;299;148;151;61;36;25;;;;;4iEUF
446;École doctorale Biologie - Santé;EDBSL;10;Sciences agronomiques et écologiques;2013;2012-13;2012;2012;0;0;0;0;0;0;3;2;1;;;;;4iEUF
447;École doctorale de l'école polytechnique;;7;Sciences de la société;2013;2012-13;2012;2012;8;2;6;25;7;18;4;2;2;;;;;zgCCh
458;École doctorale Sciences écologiques, vétérinaires, agronomiques et bioingénieries;SEVAB;10;Sciences agronomiques et écologiques;2013;2012-13;2012;2012;57;34;23;231;123;108;59;31;28;;;;;Yf3TI
465;École doctorale Économie Panthéon Sorbonne;EPS;7;Sciences de la société;2013;2012-13;2012;2012;59;27;32;332;138;194;56;21;35;;;;;MV68S
468;École doctorale Mécanique, énergétique, génie civil, procédés;MEGEP;8;Sciences pour l'ingénieur;2013;2012-13;2012;2012;114;34;80;442;129;313;112;40;72;;;;;4XUTB
469;École doctorale du Pacifique;EDP;9;Sciences et technologies de l'information et de la communication;2013;2012-13;2012;2012;3;1;2;5;1;4;0;0;0;;;;;t9Z2n
469;École doctorale du Pacifique;EDP;10;Sciences agronomiques et écologiques;2013;2012-13;2012;2012;2;2;0;11;6;5;2;0;2;;;;;t9Z2n
472;École doctorale de l'EPHE;;5;Biologie, médecine et santé;2013;2012-13;2012;2012;21;14;7;91;57;34;17;8;9;;;;;27zK4
474;École doctorale Interdisciplinaire européenne frontières du vivant;FDV;5;Biologie, médecine et santé;2013;2012-13;2012;2012;26;10;16;64;32;32;17;6;11;;;;;E727j
476;École doctorale Neurosciences et cognition;NSCO;5;Biologie, médecine et santé;2013;2012-13;2012;2012;29;20;9;111;65;46;18;14;4;;;;;B1H0x
476;École doctorale Neurosciences et cognition;NSCO;6;Sciences humaines et humanités;2013;2012-13;2012;2012;3;3;0;22;16;6;6;2;4;;;;;B1H0x
477;École doctorale Systèmes intégrés en biologie, agronomie, géosciences, hydrosciences, environnement;SIBAGHE;10;Sciences agronomiques et écologiques;2013;2012-13;2012;2012;91;51;40;296;162;134;58;32;26;;;;;zfN3N
481;École doctorale Sciences sociales et humanités;SSH;7;Sciences de la société;2013;2012-13;2012;2012;40;19;21;157;72;85;24;14;10;;;;;E3z5j
487;École doctorale Philosophie;PHCR;6;Sciences humaines et humanités;2013;2012-13;2012;2012;38;11;27;196;81;115;15;7;8;;;;;3BRzJ
488;École doctorale Sciences, ingénierie, santé;SIS;1;Mathématiques et leurs interactions;2013;2012-13;2012;2012;5;4;1;11;6;5;3;2;1;;;;;Fy2lK
489;École doctorale Sciences et ingénierie des systèmes, de l'environnement et des organisations;SISEO;8;Sciences pour l'ingénieur;2013;2012-13;2012;2012;11;2;9;52;11;41;14;3;11;;;;;6pT77
489;École doctorale Sciences et ingénierie des systèmes, de l'environnement et des organisations;SISEO;10;Sciences agronomiques et écologiques;2013;2012-13;2012;2012;0;0;0;9;2;7;4;1;3;;;;;6pT77
493;École doctorale Erasme;;7;Sciences de la société;2013;2012-13;2012;2012;59;30;29;189;114;75;25;15;10;;;;;FPW4T
494;École doctorale Jean-Henri Lambert;;1;Mathématiques et leurs interactions;2013;2012-13;2012;2012;2;1;1;5;1;4;1;0;1;;;;;A3m51
494;École doctorale Jean-Henri Lambert;;2;Physique;2013;2012-13;2012;2012;3;0;3;12;2;10;1;1;0;;;;;A3m51
495;École doctorale Végétal, environnement, nutrition, agroalimentaire, mer;VENAM;10;Sciences agronomiques et écologiques;2013;2012-13;2012;2012;16;13;3;75;41;34;32;17;15;;;;;HL495
496;École doctorale Sociétés, cultures, échanges;SCE;6;Sciences humaines et humanités;2013;2012-13;2012;2012;74;52;22;316;198;118;42;25;17;;;;;633tC
498;École doctorale Sciences pour l'ingénieur, géosciences, architecture;SPIGA;3;Sciences de la terre et de l'univers, espace;2013;2012-13;2012;2012;11;7;4;24;12;12;7;4;3;;;;;0vlKH
498;École doctorale Sciences pour l'ingénieur, géosciences, architecture;SPIGA;6;Sciences humaines et humanités;2013;2012-13;2012;2012;1;1;0;9;5;4;1;1;0;;;;;0vlKH
503;École doctorale Sciences et technologies de l'information et de mathématiques;STIM;2;Physique;2013;2012-13;2012;2012;1;0;1;2;0;2;0;0;0;;;;;JQevP
503;École doctorale Sciences et technologies de l'information et de mathématiques;STIM;6;Sciences humaines et humanités;2013;2012-13;2012;2012;2;1;1;6;2;4;0;0;0;;;;;JQevP
503;École doctorale Sciences et technologies de l'information et de mathématiques;STIM;9;Sciences et technologies de l'information et de la communication;2013;2012-13;2012;2012;62;10;52;240;50;190;57;15;42;;;;;JQevP
504;École doctorale Cognition, éducation, interactions;CEI;10;Sciences agronomiques et écologiques;2013;2012-13;2012;2012;1;1;0;1;1;0;0;0;0;;;;;39naT
505;École doctorale Sciences de l'homme, des organisations et de la société;SHOS;7;Sciences de la société;2013;2012-13;2012;2012;89;42;47;345;158;187;62;26;36;;;;;qts78
511;École doctorale Sciences et ingénierie;S&I;4;Chimie;2013;2012-13;2012;2012;6;3;3;18;12;6;11;7;4;;;;;7aXuB
511;École doctorale Sciences et ingénierie;S&I;9;Sciences et technologies de l'information et de la communication;2013;2012-13;2012;2012;26;9;17;76;21;55;22;5;17;;;;;7aXuB
517;École doctorale Particules, noyaux, cosmologie;;3;Sciences de la terre et de l'univers, espace;2013;2012-13;2012;2012;15;5;10;46;14;32;6;6;0;;;;;9kK48
521;École doctorale Sciences et ingénierie pour l'information, mathématiques;S2I;8;Sciences pour l'ingénieur;2013;2012-13;2012;2012;1;0;1;4;0;4;2;1;1;;;;;V6i83
525;"École doctorale Lettres, pensée, arts et histoire, ""Civilisation de l'antiquité à nos jours""";LPAH;6;Sciences humaines et humanités;2013;2012-13;2012;2012;60;32;28;298;163;135;39;20;19;;;;;19Rpr
527;École doctorale Cognition, comportement, langage(s);CCL;6;Sciences humaines et humanités;2013;2012-13;2012;2012;27;18;9;95;61;34;16;6;10;;;;;MvpY8
528;École doctorale Ville, transports et territoires;VTT;3;Sciences de la terre et de l'univers, espace;2013;2012-13;2012;2012;0;0;0;2;2;0;1;0;1;;;;;68zCc
528;École doctorale Ville, transports et territoires;VTT;7;Sciences de la société;2013;2012-13;2012;2012;13;3;10;33;16;17;5;3;2;;;;;68zCc
530;École doctorale Organisations, marchés, institutions;OMI;7;Sciences de la société;2013;2012-13;2012;2012;37;20;17;192;100;92;14;8;6;;;;;4htv7
531;École doctorale Sciences, ingénierie et environnement;SIE;2;Physique;2013;2012-13;2012;2012;11;2;9;25;6;19;7;2;5;;;;;b5BYq
531;École doctorale Sciences, ingénierie et environnement;SIE;3;Sciences de la terre et de l'univers, espace;2013;2012-13;2012;2012;10;7;3;44;27;17;15;2;13;;;;;b5BYq
531;École doctorale Sciences, ingénierie et environnement;SIE;10;Sciences agronomiques et écologiques;2013;2012-13;2012;2012;4;2;2;10;6;4;1;0;1;;;;;b5BYq
533;École doctorale Sciences du management : Gestion, organisation, décision, information;GODI;7;Sciences de la société;2013;2012-13;2012;2012;42;18;24;136;60;76;17;9;8;;;;;ld7FG
534;École doctorale Modélisation et instrumentation en physique, énergie, géosciences et environnement;MIPEGE;1;Mathématiques et leurs interactions;2013;2012-13;2012;2012;1;0;1;1;0;1;0;0;0;;;;;K93eR
534;École doctorale Modélisation et instrumentation en physique, énergie, géosciences et environnement;MIPEGE;8;Sciences pour l'ingénieur;2013;2012-13;2012;2012;1;0;1;1;0;1;0;0;0;;;;;K93eR
536;École doctorale Sciences et agrosciences;;4;Chimie;2013;2012-13;2012;2012;1;1;0;12;5;7;3;3;0;;;;;pHfqe
536;École doctorale Sciences et agrosciences;;10;Sciences agronomiques et écologiques;2013;2012-13;2012;2012;9;4;5;44;24;20;11;4;7;;;;;pHfqe
537;École doctorale Culture et patrimoine;C&P;6;Sciences humaines et humanités;2013;2012-13;2012;2012;12;5;7;44;21;23;5;3;2;;;;;GxI4a
537;École doctorale Culture et patrimoine;C&P;7;Sciences de la société;2013;2012-13;2012;2012;9;4;5;36;22;14;0;0;0;;;;;GxI4a
537;École doctorale Culture et patrimoine;C&P;9;Sciences et technologies de l'information et de la communication;2013;2012-13;2012;2012;9;5;4;38;24;14;4;4;0;;;;;GxI4a
539;École doctorale Sciences et technologies de Versailles;;2;Physique;2013;2012-13;2012;2012;8;2;6;18;4;14;2;1;1;;;;;nv3h8
540;"École doctorale École transdisciplinaire ""lettres/sciences""";;6;Sciences humaines et humanités;2013;2012-13;2012;2012;14;9;5;22;13;9;0;0;0;;;;;tWWw7
541;École doctorale de sciences humaines et sociales de La Réunion;SHS;6;Sciences humaines et humanités;2013;2012-13;2012;2012;34;20;14;136;83;53;21;11;10;;;;;21SpE
544;École doctorale Inter-Med : Espaces, temps, cultures;INTER-MED;6;Sciences humaines et humanités;2013;2012-13;2012;2012;81;42;39;300;130;170;40;12;28;;;;;7VjtD
545;École doctorale Sociétés, politique et santé publique;SP2;5;Biologie, médecine et santé;2013;2012-13;2012;2012;9;6;3;42;26;16;14;6;8;;;;;IAKR4
545;École doctorale Sociétés, politique et santé publique;SP2;6;Sciences humaines et humanités;2013;2012-13;2012;2012;25;16;9;94;53;41;26;14;12;;;;;IAKR4
546;École doctorale Abbé Grégoire;;3;Sciences de la terre et de l'univers, espace;2013;2012-13;2012;2012;2;2;0;7;3;4;2;0;2;;;;;ZSn7q
546;École doctorale Abbé Grégoire;;6;Sciences humaines et humanités;2013;2012-13;2012;2012;26;14;12;144;92;52;12;5;7;;;;;ZSn7q
547;École doctorale Sciences, Technologie, Santé;EDSTS;2;Physique;2013;2012-13;2012;2012;7;1;6;33;9;24;8;3;5;;;;;wEdn2
548;École doctorale Mer et Sciences;;3;Sciences de la terre et de l'univers, espace;2013;2012-13;2012;2012;4;1;3;15;5;10;0;0;0;;;;;QX0fS
548;École doctorale Mer et Sciences;;8;Sciences pour l'ingénieur;2013;2012-13;2012;2012;1;0;1;2;1;1;0;0;0;;;;;QX0fS
548;École doctorale Mer et Sciences;;9;Sciences et technologies de l'information et de la communication;2013;2012-13;2012;2012;7;1;6;18;2;16;0;0;0;;;;;QX0fS
549;École doctorale Santé, Sciences Biologiques et Chimie du Vivant;SSBCV;2;Physique;2013;2012-13;2012;2012;1;0;1;2;0;2;0;0;0;;;;;B9ggO
549;École doctorale Santé, Sciences Biologiques et Chimie du Vivant;SSBCV;5;Biologie, médecine et santé;2013;2012-13;2012;2012;46;26;20;204;124;80;42;22;20;;;;;B9ggO
549;École doctorale Santé, Sciences Biologiques et Chimie du Vivant;SSBCV;9;Sciences et technologies de l'information et de la communication;2013;2012-13;2012;2012;0;0;0;0;0;0;1;1;0;;;;;B9ggO
556;École doctorale Homme, Sociétés, Risques, Territoire;HSRT;6;Sciences humaines et humanités;2013;2012-13;2012;2012;61;25;36;239;113;126;39;23;16;;;;;5QEaX
556;École doctorale Homme, Sociétés, Risques, Territoire;HSRT;7;Sciences de la société;2013;2012-13;2012;2012;17;8;9;80;39;41;14;5;9;;;;;5QEaX
558;École doctorale Histoire, Mémoire, Patrimoine, Langage;HMPL;7;Sciences de la société;2013;2012-13;2012;2012;3;0;3;7;2;5;0;0;0;;;;;uX3jT
558;École doctorale Histoire, Mémoire, Patrimoine, Langage;HMPL;9;Sciences et technologies de l'information et de la communication;2013;2012-13;2012;2012;2;2;0;5;5;0;1;1;0;;;;;uX3jT
559;École doctorale Management Panthéon-Sorbonne;;1;Mathématiques et leurs interactions;2013;2012-13;2012;2012;41;22;19;98;55;43;8;6;2;;;;;4SP7k
6;École doctorale Droit privé;;7;Sciences de la société;2016;2015-16;2015;2015;43;18;25;299;146;153;24;6;18;;;;;UMnW1
37;École doctorale Sciences physiques pour l'ingénieur et microtechniques;SPIM;9;Sciences et technologies de l'information et de la communication;2016;2015-16;2015;2015;56;12;44;225;53;172;60;11;49;;;;;F7G1B
38;École doctorale Langages, espaces, temps, sociétés;;6;Sciences humaines et humanités;2016;2015-16;2015;2015;47;27;20;247;132;115;36;17;19;;;;;pGgDX
39;École doctorale Mathématiques et Informatique;EDMIB;1;Mathématiques et leurs interactions;2016;2015-16;2015;2015;18;5;13;92;21;71;25;6;19;;;;;TBj2X
52;École doctorale Physique et astrophysique de Lyon;PHAST;3;Sciences de la terre et de l'univers, espace;2016;2015-16;2015;2015;7;4;3;18;9;9;2;2;0;;;;;61XPb
58;École doctorale Langues, littératures, cultures, civilisations;LLCC;7;Sciences de la société;2016;2015-16;2015;2015;13;8;5;35;21;14;7;3;4;;;;;I9ATR
65;École doctorale Sciences de la Vie, Santé, Agronomie, Environnement;;5;Biologie, médecine et santé;2016;2015-16;2015;2015;58;35;23;172;101;71;32;21;11;;;;;MAOG4
70;École doctorale Sciences pour l'ingénieur;EDSPI;8;Sciences pour l'ingénieur;2016;2015-16;2015;2015;8;1;7;37;10;27;17;3;14;;;;;G413P
71;École doctorale Sciences pour l'ingénieur;;1;Mathématiques et leurs interactions;2016;2015-16;2015;2015;1;1;0;8;6;2;2;1;1;;;;;H6UYp
72;École doctorale Sciences pour l'ingénieur;SPI;8;Sciences pour l'ingénieur;2016;2015-16;2015;2015;70;20;50;258;65;193;70;22;48;;;;;47QPx
85;École doctorale Sciences de la vie et de la santé;SVS;5;Biologie, médecine et santé;2016;2015-16;2015;2015;76;46;30;207;124;83;29;18;11;;;;;YdiMF
86;École doctorale Sociétés, humanités, arts, lettres;LSHS;6;Sciences humaines et humanités;2016;2015-16;2015;2015;58;31;27;254;155;99;34;16;18;;;;;O8E6y
104;École doctorale Sciences de la matière, du rayonnement et de l'environnement;SMRE;6;Sciences humaines et humanités;2016;2015-16;2015;2015;1;0;1;14;4;10;2;0;2;;;;;Q5iFz
130;École doctorale Informatique, télécommunications et électronique de Paris;EDITE;9;Sciences et technologies de l'information et de la communication;2016;2015-16;2015;2015;97;24;73;714;189;525;205;62;143;;;;;O5ysj
145;École doctorale Sciences du végétal : du gène à l'écosystème;;5;Biologie, médecine et santé;2016;2015-16;2015;2015;0;0;0;0;0;0;10;7;3;;;;;ubDmM
146;École doctorale Galilée;GALILEE;1;Mathématiques et leurs interactions;2016;2015-16;2015;2015;10;0;10;31;4;27;8;0;8;;;;;71hqm
156;École doctorale Sciences de la mer;;6;Sciences humaines et humanités;2016;2015-16;2015;2015;3;2;1;11;8;3;0;0;0;;;;;EGY9P
156;École doctorale Sciences de la mer;;8;Sciences pour l'ingénieur;2016;2015-16;2015;2015;12;6;6;61;13;48;12;3;9;;;;;EGY9P
158;École doctorale Cerveau, cognition, comportement;3C;5;Biologie, médecine et santé;2016;2015-16;2015;2015;93;53;40;387;228;159;94;50;44;;;;;Il62F
160;École doctorale Électronique, électrotechnique, automatique;EEA;5;Biologie, médecine et santé;2016;2015-16;2015;2015;2;1;1;12;5;7;3;2;1;;;;;EgfMQ
160;École doctorale Électronique, électrotechnique, automatique;EEA;8;Sciences pour l'ingénieur;2016;2015-16;2015;2015;27;6;21;96;21;75;19;7;12;;;;;EgfMQ
166;École doctorale Information, structures et systèmes;I2S;8;Sciences pour l'ingénieur;2016;2015-16;2015;2015;22;5;17;82;21;61;27;6;21;;;;;2uO68
180;École doctorale Sciences humaines et sociales : cultures, individus, sociétés;SHS;6;Sciences humaines et humanités;2016;2015-16;2015;2015;17;9;8;118;79;39;12;8;4;;;;;D2BT3
181;École doctorale Structure, informations, matière et matériaux;Simem;2;Physique;2016;2015-16;2015;2015;12;2;10;47;7;40;14;4;10;;;;;c1D6f
181;École doctorale Structure, informations, matière et matériaux;Simem;9;Sciences et technologies de l'information et de la communication;2016;2015-16;2015;2015;13;2;11;55;11;44;13;1;12;;;;;c1D6f
182;École doctorale Physique et chimie-physique;;2;Physique;2016;2015-16;2015;2015;26;10;16;130;31;99;34;10;24;;;;;3My6I
184;École doctorale Mathématiques et informatique de Marseille;;2;Physique;2016;2015-16;2015;2015;0;0;0;1;1;0;0;0;0;;;;;DDObG
205;École doctorale Interdisciplinaire Sciences-Santé;EDISS;6;Sciences humaines et humanités;2016;2015-16;2015;2015;3;2;1;14;8;6;0;0;0;;;;;69W38
205;École doctorale Interdisciplinaire Sciences-Santé;EDISS;7;Sciences de la société;2016;2015-16;2015;2015;0;0;0;4;0;4;4;1;3;;;;;69W38
211;École doctorale Sciences exactes et leurs applications;ED SEA;1;Mathématiques et leurs interactions;2016;2015-16;2015;2015;6;4;2;25;8;17;9;2;7;;;;;1G1iC
216;École doctorale Ingénierie pour la santé, la cognition, l'environnement;EDISCE;1;Mathématiques et leurs interactions;2016;2015-16;2015;2015;1;1;0;5;3;2;0;0;0;;;;;fPs1t
216;École doctorale Ingénierie pour la santé, la cognition, l'environnement;EDISCE;4;Chimie;2016;2015-16;2015;2015;0;0;0;1;1;0;0;0;0;;;;;fPs1t
216;École doctorale Ingénierie pour la santé, la cognition, l'environnement;EDISCE;8;Sciences pour l'ingénieur;2016;2015-16;2015;2015;2;0;2;16;6;10;4;0;4;;;;;fPs1t
218;École doctorale Chimie et sciences du vivant;EDCSV;10;Sciences agronomiques et écologiques;2016;2015-16;2015;2015;7;1;6;21;8;13;3;1;2;;;;;8bcJh
220;École doctorale Électronique, électrotechnique, automatique, traitement du signal;EEATS;3;Sciences de la terre et de l'univers, espace;2016;2015-16;2015;2015;1;0;1;1;0;1;0;0;0;;;;;IxEaw
220;École doctorale Électronique, électrotechnique, automatique, traitement du signal;EEATS;9;Sciences et technologies de l'information et de la communication;2016;2015-16;2015;2015;35;7;28;306;73;233;101;26;75;;;;;IxEaw
222;École doctorale Sciences chimiques;EDSC;4;Chimie;2016;2015-16;2015;2015;70;23;47;275;108;167;76;36;40;;;;;AdU8Q
224;École doctorale Cognition, langage, interaction;;9;Sciences et technologies de l'information et de la communication;2016;2015-16;2015;2015;1;0;1;9;3;6;3;1;2;;;;;7v43e
227;École doctorale Sciences de la nature et de l'homme;;3;Sciences de la terre et de l'univers, espace;2016;2015-16;2015;2015;0;0;0;5;2;3;1;0;1;;;;;xiDA5
240;École doctorale Sciences de l'homme et de la société;SHS;7;Sciences de la société;2016;2015-16;2015;2015;19;9;10;90;39;51;12;3;9;;;;;j345k
254;École doctorale Sciences de la matière;;8;Sciences pour l'ingénieur;2016;2015-16;2015;2015;13;1;12;48;7;41;11;0;11;;;;;365F2
260;École doctorale pluridisciplinaire;;6;Sciences humaines et humanités;2016;2015-16;2015;2015;0;0;0;0;0;0;14;6;8;;;;;sCk1f
262;École doctorale Sciences juridiques, politiques, économiques et de gestion;DEG;7;Sciences de la société;2016;2015-16;2015;2015;43;19;24;209;94;115;23;14;9;;;;;H7GyL
263;École doctorale Sciences juridiques, économiques et de gestion;;7;Sciences de la société;2016;2015-16;2015;2015;0;0;0;0;0;0;6;2;4;;;;;1nUr6
269;École doctorale Mathématiques, sciences de l'information et de l'ingénieur;MSII;2;Physique;2016;2015-16;2015;2015;1;0;1;4;1;3;1;0;1;;;;;5E625
269;École doctorale Mathématiques, sciences de l'information et de l'ingénieur;MSII;9;Sciences et technologies de l'information et de la communication;2016;2015-16;2015;2015;17;1;16;73;12;61;16;5;11;;;;;5E625
284;École doctorale Droit et Science Politique;DSP;6;Sciences humaines et humanités;2016;2015-16;2015;2015;50;24;26;189;111;78;24;17;7;;;;;ahH92
285;École doctorale Sciences pratiques;;6;Sciences humaines et humanités;2016;2015-16;2015;2015;0;0;0;0;0;0;4;3;1;;;;;Jd3t2
285;École doctorale Sciences pratiques;;8;Sciences pour l'ingénieur;2016;2015-16;2015;2015;0;0;0;0;0;0;20;2;18;;;;;Jd3t2
286;École doctorale de l'Ehess;;6;Sciences humaines et humanités;2016;2015-16;2015;2015;99;48;51;544;288;256;77;43;34;;;;;2S146
286;École doctorale de l'Ehess;;7;Sciences de la société;2016;2015-16;2015;2015;157;86;71;1043;612;431;137;73;64;;;;;2S146
300;École doctorale Sciences Économiques;ED SE;7;Sciences de la société;2016;2015-16;2015;2015;8;3;5;57;18;39;11;5;6;;;;;5x3fM
304;École doctorale Sciences et environnements;;7;Sciences de la société;2016;2015-16;2015;2015;2;2;0;10;9;1;4;3;1;;;;;2ywZn
305;École doctorale Énergie et environnement;E2;8;Sciences pour l'ingénieur;2016;2015-16;2015;2015;8;2;6;40;12;28;13;5;8;;;;;Kbt8I
306;École doctorale Sciences des procédés, sciences des aliments;;5;Biologie, médecine et santé;2016;2015-16;2015;2015;0;0;0;0;0;0;4;3;1;;;;;adF7W
326;École doctorale Comportement, langage, éducation, socialisation, cognition;CLESCO;6;Sciences humaines et humanités;2016;2015-16;2015;2015;67;39;28;294;204;90;47;27;20;;;;;nWIlG
341;École doctorale Évolution, écosystèmes, microbiologie, modélisation;E2M2;10;Sciences agronomiques et écologiques;2016;2015-16;2015;2015;15;8;7;52;23;29;16;11;5;;;;;J83I0
351;École doctorale Sciences physiques, mathématiques et de l'information pour l'ingénieur;SPMII;4;Chimie;2016;2015-16;2015;2015;1;0;1;7;3;4;4;2;2;;;;;rY4EP
351;École doctorale Sciences physiques, mathématiques et de l'information pour l'ingénieur;SPMII;9;Sciences et technologies de l'information et de la communication;2016;2015-16;2015;2015;22;6;16;105;39;66;24;10;14;;;;;rY4EP
353;École doctorale Sciences pour l'ingénieur : mécanique, physique, micro et nanoélectronique;;9;Sciences et technologies de l'information et de la communication;2016;2015-16;2015;2015;1;0;1;38;2;36;11;5;6;;;;;vk5Kp
355;École doctorale Espaces, cultures, sociétés;;6;Sciences humaines et humanités;2016;2015-16;2015;2015;39;19;20;326;199;127;66;43;23;;;;;2kMf5
361;École doctorale Sciences et Technologies;ED ST;7;Sciences de la société;2016;2015-16;2015;2015;2;0;2;5;0;5;1;0;1;;;;;cOUmL
373;École doctorale Santé, information/communications et mathématiques, matière;SICMA;2;Physique;2016;2015-16;2015;2015;2;2;0;7;5;2;0;0;0;;;;;hTJF5
373;École doctorale Santé, information/communications et mathématiques, matière;SICMA;9;Sciences et technologies de l'information et de la communication;2016;2015-16;2015;2015;73;15;58;255;54;201;59;10;49;;;;;hTJF5
377;École doctorale Environnement et société;;9;Sciences et technologies de l'information et de la communication;2016;2015-16;2015;2015;2;0;2;7;1;6;3;0;3;;;;;ZMG5u
378;École doctorale Sciences de l'homme et de la société;SHS;6;Sciences humaines et humanités;2016;2015-16;2015;2015;18;12;6;66;42;24;9;7;2;;;;;3XKuF
378;École doctorale Sciences de l'homme et de la société;SHS;7;Sciences de la société;2016;2015-16;2015;2015;22;6;16;90;32;58;17;9;8;;;;;3XKuF
382;École doctorale Économie, espaces, sociétés, civilisations : pensée critique, politique et pratique sociale;EESC;7;Sciences de la société;2016;2015-16;2015;2015;49;33;16;129;76;53;15;7;8;;;;;9NI1W
393;École doctorale Pierre Louis de Santé Publique : Épidémiologie et Sciences de l'information biomédicale;PLSP;5;Biologie, médecine et santé;2016;2015-16;2015;2015;51;22;29;173;93;80;28;14;14;;;;;69445
396;École doctorale Économie, organisations, société;EOS;1;Mathématiques et leurs interactions;2016;2015-16;2015;2015;1;1;0;3;2;1;0;0;0;;;;;Es5e7
396;École doctorale Économie, organisations, société;EOS;6;Sciences humaines et humanités;2016;2015-16;2015;2015;8;5;3;31;12;19;8;3;5;;;;;Es5e7
398;École doctorale Géosciences, ressources naturelles et environnement;GRNE;3;Sciences de la terre et de l'univers, espace;2016;2015-16;2015;2015;42;17;25;157;65;92;30;14;16;;;;;Zi4Zf
400;École doctorale Savoirs scientifiques : épistémologie, histoire des sciences, didactique des disciplines;;2;Physique;2016;2015-16;2015;2015;5;3;2;19;9;10;2;0;2;;;;;nRax3
405;École doctorale Économie, management,mathématiques et physique de Cergy;EM2C;1;Mathématiques et leurs interactions;2016;2015-16;2015;2015;5;0;5;19;2;17;5;2;3;;;;;QbwSB
405;École doctorale Économie, management,mathématiques et physique de Cergy;EM2C;6;Sciences humaines et humanités;2016;2015-16;2015;2015;17;9;8;44;23;21;8;5;3;;;;;QbwSB
409;École doctorale Énergie, mécanique, matériaux;EMMA;8;Sciences pour l'ingénieur;2016;2015-16;2015;2015;23;6;17;110;23;87;26;1;25;;;;;KXlbK
412;École doctorale Lorraine de chimie et physique moléculaires : synthèses, expériences, simulations, applications : de la molécule aux édifices supramoléculaires;SESAMES;4;Chimie;2016;2015-16;2015;2015;17;10;7;59;29;30;17;8;9;;;;;mvHX2
413;École doctorale Sciences de la terre et de l'environnement;STE;3;Sciences de la terre et de l'univers, espace;2016;2015-16;2015;2015;7;2;5;22;8;14;11;6;5;;;;;u9BA9
413;École doctorale Sciences de la terre et de l'environnement;STE;10;Sciences agronomiques et écologiques;2016;2015-16;2015;2015;0;0;0;2;2;0;0;0;0;;;;;u9BA9
414;École doctorale Sciences de la vie et de la santé;;1;Mathématiques et leurs interactions;2016;2015-16;2015;2015;0;0;0;0;0;0;1;0;1;;;;;YI4xS
417;École doctorale Sciences et Ingénierie;S&I;2;Physique;2016;2015-16;2015;2015;1;0;1;3;0;3;1;0;1;;;;;SSBvE
417;École doctorale Sciences et Ingénierie;S&I;3;Sciences de la terre et de l'univers, espace;2016;2015-16;2015;2015;2;1;1;7;4;3;0;0;0;;;;;SSBvE
420;École doctorale Santé publique Paris 11 - Paris 5;;5;Biologie, médecine et santé;2016;2015-16;2015;2015;0;0;0;8;4;4;26;19;7;;;;;3BNdi
423;École doctorale Des génomes aux organismes;;5;Biologie, médecine et santé;2016;2015-16;2015;2015;0;0;0;0;0;0;20;11;9;;;;;VguHK
427;École doctorale Informatique Paris-sud;;9;Sciences et technologies de l'information et de la communication;2016;2015-16;2015;2015;0;0;0;0;0;0;26;7;19;;;;;u0T33
434;École doctorale Géographie de Paris - Espaces, sociétés, aménagement;EDGP;6;Sciences humaines et humanités;2016;2015-16;2015;2015;59;35;24;254;136;118;35;21;14;;;;;1FmLX
446;École doctorale Biologie - Santé;EDBSL;4;Chimie;2016;2015-16;2015;2015;2;2;0;3;2;1;8;4;4;;;;;4iEUF
446;École doctorale Biologie - Santé;EDBSL;6;Sciences humaines et humanités;2016;2015-16;2015;2015;5;2;3;5;2;3;3;1;2;;;;;4iEUF
447;École doctorale de l'école polytechnique;;1;Mathématiques et leurs interactions;2016;2015-16;2015;2015;0;0;0;0;0;0;25;7;18;;;;;zgCCh
447;École doctorale de l'école polytechnique;;4;Chimie;2016;2015-16;2015;2015;0;0;0;0;0;0;16;6;10;;;;;zgCCh
447;École doctorale de l'école polytechnique;;6;Sciences humaines et humanités;2016;2015-16;2015;2015;0;0;0;0;0;0;7;1;6;;;;;zgCCh
447;École doctorale de l'école polytechnique;;7;Sciences de la société;2016;2015-16;2015;2015;0;0;0;0;0;0;7;0;7;;;;;zgCCh
447;École doctorale de l'école polytechnique;;8;Sciences pour l'ingénieur;2016;2015-16;2015;2015;0;0;0;0;0;0;24;7;17;;;;;zgCCh
450;École doctorale Recherches en psychanalyse et psychopathologie;PSY²;6;Sciences humaines et humanités;2016;2015-16;2015;2015;48;31;17;229;149;80;45;27;18;;;;;8jI3f
455;École doctorale Économie, Gestion, Information et Communication;EGIC;6;Sciences humaines et humanités;2016;2015-16;2015;2015;11;8;3;47;30;17;14;11;3;;;;;qCOg3
458;École doctorale Sciences écologiques, vétérinaires, agronomiques et bioingénieries;SEVAB;10;Sciences agronomiques et écologiques;2016;2015-16;2015;2015;55;28;27;228;117;111;61;38;23;;;;;Yf3TI
467;École doctorale Aéronautique, astronautique;AA;5;Biologie, médecine et santé;2016;2015-16;2015;2015;2;2;0;4;3;1;1;1;0;;;;;U7l45
477;École doctorale Systèmes intégrés en biologie, agronomie, géosciences, hydrosciences, environnement;SIBAGHE;5;Biologie, médecine et santé;2016;2015-16;2015;2015;0;0;0;0;0;0;25;14;11;;;;;zfN3N
477;École doctorale Systèmes intégrés en biologie, agronomie, géosciences, hydrosciences, environnement;SIBAGHE;10;Sciences agronomiques et écologiques;2016;2015-16;2015;2015;0;0;0;0;0;0;77;40;37;;;;;zfN3N
479;École doctorale Sciences juridiques et politiques;;7;Sciences de la société;2016;2015-16;2015;2015;79;42;37;412;204;208;41;19;22;;;;;34mid
480;École doctorale Montaigne-humanités;;3;Sciences de la terre et de l'univers, espace;2016;2015-16;2015;2015;8;3;5;29;12;17;3;0;3;;;;;f3SeZ
488;École doctorale Sciences, ingénierie, santé;SIS;1;Mathématiques et leurs interactions;2016;2015-16;2015;2015;5;0;5;12;2;10;5;2;3;;;;;Fy2lK
488;École doctorale Sciences, ingénierie, santé;SIS;4;Chimie;2016;2015-16;2015;2015;6;1;5;18;8;10;3;2;1;;;;;Fy2lK
488;École doctorale Sciences, ingénierie, santé;SIS;5;Biologie, médecine et santé;2016;2015-16;2015;2015;17;5;12;72;22;50;17;7;10;;;;;Fy2lK
491;École doctorale Langages, idées, sociétés, institutions, territoires;LISIT;6;Sciences humaines et humanités;2016;2015-16;2015;2015;67;32;35;356;186;170;45;25;20;;;;;iB25j
491;École doctorale Langages, idées, sociétés, institutions, territoires;LISIT;7;Sciences de la société;2016;2015-16;2015;2015;34;19;15;173;81;92;12;5;7;;;;;iB25j
498;École doctorale Sciences pour l'ingénieur, géosciences, architecture;SPIGA;8;Sciences pour l'ingénieur;2016;2015-16;2015;2015;91;33;58;384;116;268;85;23;62;;;;;0vlKH
500;École doctorale Matière, molécules, matériaux en Pays de Loire;3MPL;10;Sciences agronomiques et écologiques;2016;2015-16;2015;2015;0;0;0;1;0;1;0;0;0;;;;;822tM
501;École doctorale Droit, économie-gestion, sociétés, territoires;;10;Sciences agronomiques et écologiques;2016;2015-16;2015;2015;4;3;1;5;3;2;0;0;0;;;;;wE7WM
503;École doctorale Sciences et technologies de l'information et de mathématiques;STIM;2;Physique;2016;2015-16;2015;2015;0;0;0;1;0;1;1;0;1;;;;;JQevP
503;École doctorale Sciences et technologies de l'information et de mathématiques;STIM;4;Chimie;2016;2015-16;2015;2015;1;0;1;1;0;1;0;0;0;;;;;JQevP
507;École doctorale Sciences humaines et sociales;;6;Sciences humaines et humanités;2016;2015-16;2015;2015;92;48;44;443;237;206;48;27;21;;;;;3e7VM
510;École doctorale Ingénierie - Matériaux, mécanique, environnement, énergétique, procédés, production;IMEP2;3;Sciences de la terre et de l'univers, espace;2016;2015-16;2015;2015;0;0;0;1;0;1;0;0;0;;;;;Ce7NF
511;École doctorale Sciences et ingénierie;S&I;8;Sciences pour l'ingénieur;2016;2015-16;2015;2015;0;0;0;0;0;0;1;0;1;;;;;7aXuB
520;École doctorale Humanités;;6;Sciences humaines et humanités;2016;2015-16;2015;2015;76;48;28;356;214;142;33;23;10;;;;;rI175
523;École doctorale Sciences pour l'environnement - Gay Lussac;;5;Biologie, médecine et santé;2016;2015-16;2015;2015;10;7;3;32;24;8;12;8;4;;;;;6xD69
523;École doctorale Sciences pour l'environnement - Gay Lussac;;10;Sciences agronomiques et écologiques;2016;2015-16;2015;2015;17;3;14;52;23;29;9;4;5;;;;;6xD69
527;École doctorale Cognition, comportement, langage(s);CCL;6;Sciences humaines et humanités;2016;2015-16;2015;2015;26;13;13;94;59;35;17;11;6;;;;;MvpY8
530;École doctorale Organisations, marchés, institutions;OMI;5;Biologie, médecine et santé;2016;2015-16;2015;2015;2;1;1;4;3;1;0;0;0;;;;;4htv7
531;École doctorale Sciences, ingénierie et environnement;SIE;3;Sciences de la terre et de l'univers, espace;2016;2015-16;2015;2015;7;3;4;36;15;21;11;6;5;;;;;b5BYq
534;École doctorale Modélisation et instrumentation en physique, énergie, géosciences et environnement;MIPEGE;4;Chimie;2016;2015-16;2015;2015;0;0;0;0;0;0;2;2;0;;;;;K93eR
535;École doctorale Sciences de la société;SDS;6;Sciences humaines et humanités;2016;2015-16;2015;2015;0;0;0;0;0;0;2;1;1;;;;;iEUOV
536;École doctorale Sciences et agrosciences;;10;Sciences agronomiques et écologiques;2016;2015-16;2015;2015;12;5;7;40;21;19;8;5;3;;;;;pHfqe
539;École doctorale Sciences et technologies de Versailles;;1;Mathématiques et leurs interactions;2016;2015-16;2015;2015;0;0;0;0;0;0;3;1;2;;;;;nv3h8
539;École doctorale Sciences et technologies de Versailles;;9;Sciences et technologies de l'information et de la communication;2016;2015-16;2015;2015;0;0;0;0;0;0;13;1;12;;;;;nv3h8
540;"École doctorale École transdisciplinaire ""lettres/sciences""";;1;Mathématiques et leurs interactions;2016;2015-16;2015;2015;0;0;0;0;0;0;1;0;1;;;;;tWWw7
541;École doctorale de sciences humaines et sociales de La Réunion;SHS;6;Sciences humaines et humanités;2016;2015-16;2015;2015;29;16;13;161;84;77;12;8;4;;;;;21SpE
542;École doctorale de sciences de La Réunion;STS;2;Physique;2016;2015-16;2015;2015;9;4;5;20;9;11;0;0;0;;;;;2pAql
542;École doctorale de sciences de La Réunion;STS;10;Sciences agronomiques et écologiques;2016;2015-16;2015;2015;2;2;0;17;10;7;0;0;0;;;;;2pAql
545;École doctorale Sociétés, politique et santé publique;SP2;7;Sciences de la société;2016;2015-16;2015;2015;21;8;13;94;50;44;29;17;12;;;;;IAKR4
546;École doctorale Abbé Grégoire;;1;Mathématiques et leurs interactions;2016;2015-16;2015;2015;0;0;0;1;1;0;0;0;0;;;;;ZSn7q
546;École doctorale Abbé Grégoire;;5;Biologie, médecine et santé;2016;2015-16;2015;2015;0;0;0;2;0;2;0;0;0;;;;;ZSn7q
547;École doctorale Sciences, Technologie, Santé;EDSTS;1;Mathématiques et leurs interactions;2016;2015-16;2015;2015;1;1;0;8;3;5;0;0;0;;;;;wEdn2
547;École doctorale Sciences, Technologie, Santé;EDSTS;10;Sciences agronomiques et écologiques;2016;2015-16;2015;2015;8;3;5;32;12;20;6;3;3;;;;;wEdn2
548;École doctorale Mer et Sciences;;3;Sciences de la terre et de l'univers, espace;2016;2015-16;2015;2015;4;4;0;7;7;0;1;1;0;;;;;QX0fS
548;École doctorale Mer et Sciences;;9;Sciences et technologies de l'information et de la communication;2016;2015-16;2015;2015;2;2;0;17;7;10;4;0;4;;;;;QX0fS
549;École doctorale Santé, Sciences Biologiques et Chimie du Vivant;SSBCV;4;Chimie;2016;2015-16;2015;2015;13;3;10;46;19;27;7;4;3;;;;;B9ggO
553;École doctorale Carnot - Pasteur;;2;Physique;2016;2015-16;2015;2015;12;2;10;46;9;37;11;3;8;;;;;6h4Z7
553;École doctorale Carnot - Pasteur;;7;Sciences de la société;2016;2015-16;2015;2015;1;0;1;10;4;6;1;0;1;;;;;6h4Z7
555;École doctorale Sciences de l'Homme et de la Société;SHS;7;Sciences de la société;2016;2015-16;2015;2015;21;6;15;117;41;76;19;8;11;;;;;44G6m
556;École doctorale Homme, Sociétés, Risques, Territoire;HSRT;7;Sciences de la société;2016;2015-16;2015;2015;7;3;4;75;35;40;11;6;5;;;;;5QEaX
558;École doctorale Histoire, Mémoire, Patrimoine, Langage;HMPL;7;Sciences de la société;2016;2015-16;2015;2015;0;0;0;1;0;1;0;0;0;;;;;uX3jT
563;École doctorale Médicament - Toxicologie - Chimie - Imageries;MTCI;5;Biologie, médecine et santé;2016;2015-16;2015;2015;49;25;24;157;86;71;32;19;13;;;;;j8uk1
566;École doctorale Sciences du Sport, de la Motricité et du Mouvement Humain;SMMH;5;Biologie, médecine et santé;2016;2015-16;2015;2015;22;11;11;52;24;28;4;1;3;;;;;3iv8y
568;École doctorale Signalisations et Réseaux Intégratifs en Biologie;BIOSIGNE;5;Biologie, médecine et santé;2016;2015-16;2015;2015;34;20;14;146;91;55;17;11;6;;;;;CGttG
571;École doctorale Sciences Chimiques : Molécules, Matériaux, Instrumentation et Biosystemes;2MIB;4;Chimie;2016;2015-16;2015;2015;61;30;31;284;135;149;50;18;32;;;;;zbi37
575;École doctorale Electrical, Optical, Bio : Physics and Engineering;EOBE;2;Physique;2016;2015-16;2015;2015;37;15;22;143;44;99;13;5;8;;;;;dfhyn
575;École doctorale Electrical, Optical, Bio : Physics and Engineering;EOBE;8;Sciences pour l'ingénieur;2016;2015-16;2015;2015;31;10;21;122;36;86;10;1;9;;;;;dfhyn
577;École doctorale Structure et dynamique des systèmes vivants;SDSV;1;Mathématiques et leurs interactions;2016;2015-16;2015;2015;1;0;1;4;2;2;1;1;0;;;;;4bsxJ
577;École doctorale Structure et dynamique des systèmes vivants;SDSV;5;Biologie, médecine et santé;2016;2015-16;2015;2015;55;39;16;235;139;96;20;13;7;;;;;4bsxJ
577;École doctorale Structure et dynamique des systèmes vivants;SDSV;7;Sciences de la société;2016;2015-16;2015;2015;0;0;0;1;1;0;0;0;0;;;;;4bsxJ
578;École doctorale Sciences de l'Homme et de la Société;ED SHS;6;Sciences humaines et humanités;2016;2015-16;2015;2015;30;16;14;173;100;73;14;6;8;;;;;Ud43O
578;École doctorale Sciences de l'Homme et de la Société;ED SHS;7;Sciences de la société;2016;2015-16;2015;2015;108;49;59;581;271;310;24;11;13;;;;;Ud43O
581;École doctorale Agriculture, alimentation, biologie, environnement, santé;ABIES;1;Mathématiques et leurs interactions;2016;2015-16;2015;2015;4;1;3;12;3;9;1;0;1;;;;;c1x56
581;École doctorale Agriculture, alimentation, biologie, environnement, santé;ABIES;3;Sciences de la terre et de l'univers, espace;2016;2015-16;2015;2015;1;1;0;3;2;1;0;0;0;;;;;c1x56
581;École doctorale Agriculture, alimentation, biologie, environnement, santé;ABIES;6;Sciences humaines et humanités;2016;2015-16;2015;2015;5;3;2;27;13;14;1;0;1;;;;;c1x56
583;École doctorale Risques et Société;;7;Sciences de la société;2016;2015-16;2015;2015;1;1;0;2;1;1;1;0;1;;;;;wUBi9
584;École doctorale Biodiversité, Agriculture, Alimentation, Environnement, Terre, Eau;GAIA;3;Sciences de la terre et de l'univers, espace;2016;2015-16;2015;2015;18;4;14;62;21;41;0;0;0;;;;;F1h5f
585;École doctorale Sciences, Technologie,  Sante;EDSTS;10;Sciences agronomiques et écologiques;2016;2015-16;2015;2015;12;7;5;40;18;22;6;4;2;;;;;NM3Dl
587;École doctorale Diversites, santé et développement en Amazonie;;4;Chimie;2016;2015-16;2015;2015;0;0;0;3;2;1;1;0;1;;;;;V14tj
589;École doctorale Milieu insulaire tropical à risques : protection, valorisation , santé et développement;;3;Sciences de la terre et de l'univers, espace;2016;2015-16;2015;2015;1;1;0;4;4;0;0;0;0;;;;;2cqi3
19;École doctorale Littératures françaises et comparée;;6;Sciences humaines et humanités;2014;2013-14;2013;2013;67;51;16;315;214;101;48;33;15;;;;;13M43
20;École doctorale Civilisations, cultures, littératures et sociétés;;6;Sciences humaines et humanités;2014;2013-14;2013;2013;55;35;20;238;161;77;34;23;11;;;;;agjNi
34;École doctorale Matériaux;;4;Chimie;2014;2013-14;2013;2013;10;4;6;58;31;27;17;7;10;;;;;1Iufh
39;École doctorale Mathématiques et Informatique;EDMIB;1;Mathématiques et leurs interactions;2014;2013-14;2013;2013;28;6;22;90;18;72;27;3;24;;;;;TBj2X
40;École doctorale Sciences chimiques;EDSC;4;Chimie;2014;2013-14;2013;2013;98;38;60;264;104;160;91;43;48;;;;;wde3D
42;École doctorale Entreprise, économie, société;EES;7;Sciences de la société;2014;2013-14;2013;2013;35;12;23;147;58;89;23;10;13;;;;;uO01d
50;École doctorale Langues, littératures et sciences humaines;LLSH;6;Sciences humaines et humanités;2014;2013-14;2013;2013;53;30;23;288;188;100;26;17;9;;;;;8THzQ
52;École doctorale Physique et astrophysique de Lyon;PHAST;3;Sciences de la terre et de l'univers, espace;2014;2013-14;2013;2013;4;3;1;16;9;7;2;0;2;;;;;61XPb
70;École doctorale Sciences pour l'ingénieur;EDSPI;8;Sciences pour l'ingénieur;2014;2013-14;2013;2013;9;3;6;56;14;42;9;3;6;;;;;G413P
73;École doctorale Sciences économiques, sociales, de l'aménagement et du management;SESAM;1;Mathématiques et leurs interactions;2014;2013-14;2013;2013;2;0;2;8;2;6;0;0;0;;;;;IQ0Hk
73;École doctorale Sciences économiques, sociales, de l'aménagement et du management;SESAM;6;Sciences humaines et humanités;2014;2013-14;2013;2013;1;0;1;15;5;10;6;1;5;;;;;IQ0Hk
77;École doctorale Informatique, automatique, électronique, électrotechnique, mathématiques;IAEM;6;Sciences humaines et humanités;2014;2013-14;2013;2013;1;0;1;3;0;3;3;0;3;;;;;TCHTA
77;École doctorale Informatique, automatique, électronique, électrotechnique, mathématiques;IAEM;8;Sciences pour l'ingénieur;2014;2013-14;2013;2013;8;1;7;22;5;17;5;1;4;;;;;TCHTA
77;École doctorale Informatique, automatique, électronique, électrotechnique, mathématiques;IAEM;9;Sciences et technologies de l'information et de la communication;2014;2013-14;2013;2013;59;16;43;218;50;168;61;19;42;;;;;TCHTA
78;École doctorale Sociétés, langages, temps, connaissances;STLC;6;Sciences humaines et humanités;2014;2013-14;2013;2013;56;37;19;212;134;78;30;14;16;;;;;vLU3i
86;École doctorale Sociétés, humanités, arts, lettres;LSHS;6;Sciences humaines et humanités;2014;2013-14;2013;2013;67;44;23;315;201;114;38;24;14;;;;;O8E6y
88;École doctorale Droit et science politique;DSP;7;Sciences de la société;2014;2013-14;2013;2013;79;30;49;334;147;187;35;16;19;;;;;elnAJ
92;École doctorale Vie -  Agro - Santé;;2;Physique;2014;2013-14;2013;2013;0;0;0;1;1;0;1;1;0;;;;;RjvXY
92;École doctorale Vie -  Agro - Santé;;3;Sciences de la terre et de l'univers, espace;2014;2013-14;2013;2013;0;0;0;2;1;1;0;0;0;;;;;RjvXY
109;École doctorale Sciences de la terre;;3;Sciences de la terre et de l'univers, espace;2014;2013-14;2013;2013;34;16;18;139;65;74;33;13;20;;;;;BQNt6
113;École doctorale Histoire;;6;Sciences humaines et humanités;2014;2013-14;2013;2013;77;39;38;361;177;184;66;30;36;;;;;G5wHs
122;École doctorale Europe latine - Amérique latine;;6;Sciences humaines et humanités;2014;2013-14;2013;2013;25;13;12;160;104;56;14;9;5;;;;;z9lZY
122;École doctorale Europe latine - Amérique latine;;7;Sciences de la société;2014;2013-14;2013;2013;10;6;4;76;45;31;10;5;5;;;;;z9lZY
139;École doctorale Connaissance, langage, modélisation;CLM;6;Sciences humaines et humanités;2014;2013-14;2013;2013;62;45;17;308;186;122;44;26;18;;;;;1lxGH
139;École doctorale Connaissance, langage, modélisation;CLM;8;Sciences pour l'ingénieur;2014;2013-14;2013;2013;3;1;2;15;3;12;9;2;7;;;;;1lxGH
156;École doctorale Sciences de la mer;;6;Sciences humaines et humanités;2014;2013-14;2013;2013;3;3;0;9;7;2;2;1;1;;;;;EGY9P
156;École doctorale Sciences de la mer;;8;Sciences pour l'ingénieur;2014;2013-14;2013;2013;17;3;14;53;12;41;4;1;3;;;;;EGY9P
162;École doctorale Mécanique, énergétique, génie civil, acoustique;MEGA;1;Mathématiques et leurs interactions;2014;2013-14;2013;2013;1;0;1;1;0;1;0;0;0;;;;;7wCke
162;École doctorale Mécanique, énergétique, génie civil, acoustique;MEGA;2;Physique;2014;2013-14;2013;2013;35;10;25;114;30;84;32;6;26;;;;;7wCke
162;École doctorale Mécanique, énergétique, génie civil, acoustique;MEGA;8;Sciences pour l'ingénieur;2014;2013-14;2013;2013;82;18;64;316;72;244;46;17;29;;;;;7wCke
166;École doctorale Information, structures et systèmes;I2S;9;Sciences et technologies de l'information et de la communication;2014;2013-14;2013;2013;44;9;35;145;25;120;48;11;37;;;;;2uO68
168;École doctorale Sciences chimiques et biologiques pour la santé;SCBS;4;Chimie;2014;2013-14;2013;2013;1;1;0;4;3;1;1;0;1;;;;;8cEME
171;École doctorale Toulouse sciences économiques;TSE;7;Sciences de la société;2014;2013-14;2013;2013;22;8;14;98;35;63;14;5;9;;;;;Q5nNQ
178;École doctorale Sciences fondamentales;;1;Mathématiques et leurs interactions;2014;2013-14;2013;2013;5;0;5;19;5;14;3;0;3;;;;;1AiR7
181;École doctorale Structure, informations, matière et matériaux;Simem;4;Chimie;2014;2013-14;2013;2013;9;6;3;38;18;20;11;5;6;;;;;c1D6f
182;École doctorale Physique et chimie-physique;;2;Physique;2014;2013-14;2013;2013;39;10;29;129;29;100;37;9;28;;;;;3My6I
182;École doctorale Physique et chimie-physique;;5;Biologie, médecine et santé;2014;2013-14;2013;2013;1;1;0;4;3;1;1;0;1;;;;;3My6I
206;École doctorale Chimie : chimie, procédés, environnement;;2;Physique;2014;2013-14;2013;2013;4;0;4;13;1;12;3;1;2;;;;;m0UhD
211;École doctorale Sciences exactes et leurs applications;ED SEA;4;Chimie;2014;2013-14;2013;2013;18;12;6;81;49;32;23;9;14;;;;;1G1iC
216;École doctorale Ingénierie pour la santé, la cognition, l'environnement;EDISCE;1;Mathématiques et leurs interactions;2014;2013-14;2013;2013;0;0;0;1;0;1;0;0;0;;;;;fPs1t
218;École doctorale Chimie et sciences du vivant;EDCSV;5;Biologie, médecine et santé;2014;2013-14;2013;2013;60;41;19;231;139;92;55;41;14;;;;;8bcJh
224;École doctorale Cognition, langage, interaction;;6;Sciences humaines et humanités;2014;2013-14;2013;2013;37;21;16;181;120;61;22;18;4;;;;;7v43e
227;École doctorale Sciences de la nature et de l'homme;;5;Biologie, médecine et santé;2014;2013-14;2013;2013;24;14;10;89;54;35;15;8;7;;;;;xiDA5
242;École doctorale Économie - Gestion - Normandie;;7;Sciences de la société;2014;2013-14;2013;2013;15;9;6;108;53;55;12;3;9;;;;;z35ku
245;École doctorale Sciences économiques, juridiques, politiques et de gestion;;7;Sciences de la société;2014;2013-14;2013;2013;26;8;18;196;80;116;26;7;19;;;;;ShLUg
260;École doctorale pluridisciplinaire;;6;Sciences humaines et humanités;2014;2013-14;2013;2013;29;20;9;92;71;21;7;3;4;;;;;sCk1f
269;École doctorale Mathématiques, sciences de l'information et de l'ingénieur;MSII;5;Biologie, médecine et santé;2014;2013-14;2013;2013;1;0;1;3;1;2;1;1;0;;;;;5E625
269;École doctorale Mathématiques, sciences de l'information et de l'ingénieur;MSII;8;Sciences pour l'ingénieur;2014;2013-14;2013;2013;43;15;28;156;46;110;35;5;30;;;;;5E625
275;École doctorale Sciences de gestion;EDSG;7;Sciences de la société;2014;2013-14;2013;2013;14;6;8;90;37;53;14;6;8;;;;;6QC4I
284;École doctorale Droit et Science Politique;DSP;7;Sciences de la société;2014;2013-14;2013;2013;11;7;4;44;29;15;7;3;4;;;;;ahH92
300;École doctorale Sciences Économiques;ED SE;7;Sciences de la société;2014;2013-14;2013;2013;13;4;9;63;21;42;17;7;10;;;;;5x3fM
304;École doctorale Sciences et environnements;;3;Sciences de la terre et de l'univers, espace;2014;2013-14;2013;2013;10;7;3;32;22;10;8;6;2;;;;;2ywZn
304;École doctorale Sciences et environnements;;10;Sciences agronomiques et écologiques;2014;2013-14;2013;2013;11;5;6;35;18;17;7;3;4;;;;;2ywZn
305;École doctorale Énergie et environnement;E2;3;Sciences de la terre et de l'univers, espace;2014;2013-14;2013;2013;5;0;5;22;12;10;7;4;3;;;;;Kbt8I
305;École doctorale Énergie et environnement;E2;4;Chimie;2014;2013-14;2013;2013;1;1;0;4;2;2;2;1;1;;;;;Kbt8I
309;École doctorale Systèmes;EDSYS;9;Sciences et technologies de l'information et de la communication;2014;2013-14;2013;2013;23;4;19;92;15;77;25;5;20;;;;;8TT4b
340;École doctorale Biologie moléculaire, intégrative et cellulaire;BMIC;5;Biologie, médecine et santé;2014;2013-14;2013;2013;58;37;21;250;141;109;56;32;24;;;;;db7xq
353;École doctorale Sciences pour l'ingénieur : mécanique, physique, micro et nanoélectronique;;1;Mathématiques et leurs interactions;2014;2013-14;2013;2013;0;0;0;1;0;1;1;0;1;;;;;vk5Kp
353;École doctorale Sciences pour l'ingénieur : mécanique, physique, micro et nanoélectronique;;8;Sciences pour l'ingénieur;2014;2013-14;2013;2013;27;5;22;134;24;110;34;11;23;;;;;vk5Kp
353;École doctorale Sciences pour l'ingénieur : mécanique, physique, micro et nanoélectronique;;9;Sciences et technologies de l'information et de la communication;2014;2013-14;2013;2013;6;2;4;13;4;9;13;3;10;;;;;vk5Kp
354;École doctorale Langues, lettres et arts;LLA;6;Sciences humaines et humanités;2014;2013-14;2013;2013;40;28;12;182;121;61;21;14;7;;;;;RwcSv
364;École doctorale Sciences fondamentales et appliquées;EDSFA;1;Mathématiques et leurs interactions;2014;2013-14;2013;2013;19;6;13;60;14;46;10;1;9;;;;;E483q
364;École doctorale Sciences fondamentales et appliquées;EDSFA;3;Sciences de la terre et de l'univers, espace;2014;2013-14;2013;2013;8;2;6;78;31;47;10;7;3;;;;;E483q
364;École doctorale Sciences fondamentales et appliquées;EDSFA;5;Biologie, médecine et santé;2014;2013-14;2013;2013;1;1;0;1;1;0;2;1;1;;;;;E483q
370;École doctorale Lettres, sciences humaines et sociales;LSHS;7;Sciences de la société;2014;2013-14;2013;2013;0;0;0;4;3;1;1;1;0;;;;;xAXXx
373;École doctorale Santé, information/communications et mathématiques, matière;SICMA;4;Chimie;2014;2013-14;2013;2013;5;2;3;17;8;9;5;4;1;;;;;hTJF5
373;École doctorale Santé, information/communications et mathématiques, matière;SICMA;5;Biologie, médecine et santé;2014;2013-14;2013;2013;23;10;13;78;35;43;9;4;5;;;;;hTJF5
377;École doctorale Environnement et société;;1;Mathématiques et leurs interactions;2014;2013-14;2013;2013;1;0;1;5;1;4;0;0;0;;;;;ZMG5u
377;École doctorale Environnement et société;;5;Biologie, médecine et santé;2014;2013-14;2013;2013;2;0;2;3;0;3;1;0;1;;;;;ZMG5u
382;École doctorale Économie, espaces, sociétés, civilisations : pensée critique, politique et pratique sociale;EESC;6;Sciences humaines et humanités;2014;2013-14;2013;2013;26;16;10;105;64;41;15;8;7;;;;;9NI1W
392;École doctorale Diversité du vivant;;5;Biologie, médecine et santé;2014;2013-14;2013;2013;5;1;4;40;17;23;17;9;8;;;;;537J0
396;École doctorale Économie, organisations, société;EOS;6;Sciences humaines et humanités;2014;2013-14;2013;2013;4;0;4;31;8;23;6;2;4;;;;;Es5e7
397;École doctorale Physique et chimie des matériaux;;4;Chimie;2014;2013-14;2013;2013;50;19;31;153;60;93;38;17;21;;;;;WxSt9
400;École doctorale Savoirs scientifiques : épistémologie, histoire des sciences, didactique des disciplines;;1;Mathématiques et leurs interactions;2014;2013-14;2013;2013;7;5;2;36;18;18;6;1;5;;;;;nRax3
400;École doctorale Savoirs scientifiques : épistémologie, histoire des sciences, didactique des disciplines;;3;Sciences de la terre et de l'univers, espace;2014;2013-14;2013;2013;0;0;0;1;0;1;0;0;0;;;;;nRax3
400;École doctorale Savoirs scientifiques : épistémologie, histoire des sciences, didactique des disciplines;;6;Sciences humaines et humanités;2014;2013-14;2013;2013;1;1;0;5;5;0;2;0;2;;;;;nRax3
400;École doctorale Savoirs scientifiques : épistémologie, histoire des sciences, didactique des disciplines;;7;Sciences de la société;2014;2013-14;2013;2013;3;1;2;9;5;4;0;0;0;;;;;nRax3
401;École doctorale Sciences sociales;;6;Sciences humaines et humanités;2014;2013-14;2013;2013;21;13;8;167;79;88;17;9;8;;;;;raQ7K
410;École doctorale Sciences et ingénierie des ressources, procédés, produits, environnement;RP2E;10;Sciences agronomiques et écologiques;2014;2013-14;2013;2013;32;17;15;116;60;56;36;23;13;;;;;Q5fxV
413;École doctorale Sciences de la terre et de l'environnement;STE;3;Sciences de la terre et de l'univers, espace;2014;2013-14;2013;2013;16;5;11;68;31;37;22;7;15;;;;;u9BA9
413;École doctorale Sciences de la terre et de l'environnement;STE;6;Sciences humaines et humanités;2014;2013-14;2013;2013;4;2;2;13;7;6;3;0;3;;;;;u9BA9
414;École doctorale Sciences de la vie et de la santé;;4;Chimie;2014;2013-14;2013;2013;1;1;0;3;2;1;0;0;0;;;;;YI4xS
414;École doctorale Sciences de la vie et de la santé;;5;Biologie, médecine et santé;2014;2013-14;2013;2013;127;70;57;497;275;222;129;66;63;;;;;YI4xS
417;École doctorale Sciences et Ingénierie;S&I;8;Sciences pour l'ingénieur;2014;2013-14;2013;2013;10;1;9;42;8;34;9;2;7;;;;;SSBvE
417;École doctorale Sciences et Ingénierie;S&I;9;Sciences et technologies de l'information et de la communication;2014;2013-14;2013;2013;6;2;4;46;15;31;8;1;7;;;;;SSBvE
419;École doctorale Signalisations et réseaux intégratifs en biologie;BIO-SIGNE;5;Biologie, médecine et santé;2014;2013-14;2013;2013;32;23;9;141;101;40;29;18;11;;;;;rDuFq
420;École doctorale Santé publique Paris 11 - Paris 5;;7;Sciences de la société;2014;2013-14;2013;2013;9;7;2;20;15;5;1;1;0;;;;;3BNdi
422;École doctorale Sciences et technologies de l'information, des télécommunications et des systèmes;;8;Sciences pour l'ingénieur;2014;2013-14;2013;2013;18;5;13;70;12;58;11;3;8;;;;;998UM
422;École doctorale Sciences et technologies de l'information, des télécommunications et des systèmes;;9;Sciences et technologies de l'information et de la communication;2014;2013-14;2013;2013;73;23;50;279;76;203;63;19;44;;;;;998UM
423;École doctorale Des génomes aux organismes;;1;Mathématiques et leurs interactions;2014;2013-14;2013;2013;3;1;2;7;4;3;0;0;0;;;;;VguHK
423;École doctorale Des génomes aux organismes;;4;Chimie;2014;2013-14;2013;2013;1;1;0;3;2;1;3;1;2;;;;;VguHK
427;École doctorale Informatique Paris-sud;;9;Sciences et technologies de l'information et de la communication;2014;2013-14;2013;2013;41;11;30;164;41;123;41;11;30;;;;;u0T33
433;École doctorale Concepts et langages;;9;Sciences et technologies de l'information et de la communication;2014;2013-14;2013;2013;10;5;5;42;26;16;2;1;1;;;;;v8q34
434;École doctorale Géographie de Paris - Espaces, sociétés, aménagement;EDGP;6;Sciences humaines et humanités;2014;2013-14;2013;2013;55;23;32;269;128;141;51;25;26;;;;;1FmLX
435;École doctorale Agriculture, alimentation, biologie, environnement et santé;;5;Biologie, médecine et santé;2014;2013-14;2013;2013;38;22;16;115;69;46;36;20;16;;;;;mC35U
435;École doctorale Agriculture, alimentation, biologie, environnement et santé;;6;Sciences humaines et humanités;2014;2013-14;2013;2013;13;5;8;52;28;24;13;7;6;;;;;mC35U
446;École doctorale Biologie - Santé;EDBSL;5;Biologie, médecine et santé;2014;2013-14;2013;2013;85;49;36;335;174;161;60;32;28;;;;;4iEUF
447;École doctorale de l'école polytechnique;;2;Physique;2014;2013-14;2013;2013;46;11;35;193;37;156;55;10;45;;;;;zgCCh
447;École doctorale de l'école polytechnique;;6;Sciences humaines et humanités;2014;2013-14;2013;2013;7;3;4;33;10;23;5;1;4;;;;;zgCCh
450;École doctorale Recherches en psychanalyse et psychopathologie;PSY²;6;Sciences humaines et humanités;2014;2013-14;2013;2013;57;39;18;271;190;81;33;23;10;;;;;8jI3f
454;École doctorale Sciences de l'homme, du politique et du territoire;SHPT;9;Sciences et technologies de l'information et de la communication;2014;2013-14;2013;2013;1;0;1;1;0;1;0;0;0;;;;;Opv31
463;École doctorale Sciences du mouvement humain;SMH;6;Sciences humaines et humanités;2014;2013-14;2013;2013;4;2;2;23;12;11;4;1;3;;;;;UbtlY
465;École doctorale Économie Panthéon Sorbonne;EPS;1;Mathématiques et leurs interactions;2014;2013-14;2013;2013;1;1;0;29;10;19;6;3;3;;;;;MV68S
467;École doctorale Aéronautique, astronautique;AA;2;Physique;2014;2013-14;2013;2013;2;1;1;4;1;3;2;0;2;;;;;U7l45
467;École doctorale Aéronautique, astronautique;AA;6;Sciences humaines et humanités;2014;2013-14;2013;2013;0;0;0;4;1;3;0;0;0;;;;;U7l45
467;École doctorale Aéronautique, astronautique;AA;7;Sciences de la société;2014;2013-14;2013;2013;1;0;1;2;1;1;2;2;0;;;;;U7l45
467;École doctorale Aéronautique, astronautique;AA;9;Sciences et technologies de l'information et de la communication;2014;2013-14;2013;2013;1;1;0;4;2;2;2;0;2;;;;;U7l45
469;École doctorale du Pacifique;EDP;1;Mathématiques et leurs interactions;2014;2013-14;2013;2013;0;0;0;1;0;1;0;0;0;;;;;t9Z2n
469;École doctorale du Pacifique;EDP;3;Sciences de la terre et de l'univers, espace;2014;2013-14;2013;2013;3;1;2;8;2;6;1;1;0;;;;;t9Z2n
469;École doctorale du Pacifique;EDP;5;Biologie, médecine et santé;2014;2013-14;2013;2013;2;1;1;9;5;4;1;1;0;;;;;t9Z2n
469;École doctorale du Pacifique;EDP;7;Sciences de la société;2014;2013-14;2013;2013;8;4;4;16;6;10;3;2;1;;;;;t9Z2n
469;École doctorale du Pacifique;EDP;9;Sciences et technologies de l'information et de la communication;2014;2013-14;2013;2013;0;0;0;4;0;4;0;0;0;;;;;t9Z2n
469;École doctorale du Pacifique;EDP;10;Sciences agronomiques et écologiques;2014;2013-14;2013;2013;5;3;2;19;11;8;2;0;2;;;;;t9Z2n
470;École doctorale Chimie de Paris-Sud;;4;Chimie;2014;2013-14;2013;2013;52;27;25;237;106;131;58;23;35;;;;;aExpW
472;École doctorale de l'EPHE;;6;Sciences humaines et humanités;2014;2013-14;2013;2013;81;42;39;527;266;261;68;37;31;;;;;27zK4
474;École doctorale Interdisciplinaire européenne frontières du vivant;FDV;5;Biologie, médecine et santé;2014;2013-14;2013;2013;25;11;14;78;31;47;20;9;11;;;;;E727j
480;École doctorale Montaigne-humanités;;7;Sciences de la société;2014;2013-14;2013;2013;2;1;1;4;2;2;1;1;0;;;;;f3SeZ
482;École doctorale Sciences de la matière;SDM;8;Sciences pour l'ingénieur;2014;2013-14;2013;2013;0;0;0;7;3;4;1;0;1;;;;;kmeZ4
489;École doctorale Sciences et ingénierie des systèmes, de l'environnement et des organisations;SISEO;3;Sciences de la terre et de l'univers, espace;2014;2013-14;2013;2013;0;0;0;20;12;8;5;2;3;;;;;6pT77
489;École doctorale Sciences et ingénierie des systèmes, de l'environnement et des organisations;SISEO;4;Chimie;2014;2013-14;2013;2013;2;2;0;7;4;3;2;2;0;;;;;6pT77
491;École doctorale Langages, idées, sociétés, institutions, territoires;LISIT;7;Sciences de la société;2014;2013-14;2013;2013;46;20;26;228;113;115;30;14;16;;;;;iB25j
493;École doctorale Erasme;;6;Sciences humaines et humanités;2014;2013-14;2013;2013;23;20;3;130;89;41;14;6;8;;;;;FPW4T
493;École doctorale Erasme;;9;Sciences et technologies de l'information et de la communication;2014;2013-14;2013;2013;11;5;6;36;15;21;1;1;0;;;;;FPW4T
498;École doctorale Sciences pour l'ingénieur, géosciences, architecture;SPIGA;6;Sciences humaines et humanités;2014;2013-14;2013;2013;6;2;4;11;6;5;1;0;1;;;;;0vlKH
501;École doctorale Droit, économie-gestion, sociétés, territoires;;7;Sciences de la société;2014;2013-14;2013;2013;108;48;60;399;186;213;44;21;23;;;;;wE7WM
503;École doctorale Sciences et technologies de l'information et de mathématiques;STIM;9;Sciences et technologies de l'information et de la communication;2014;2013-14;2013;2013;72;19;53;246;53;193;59;15;44;;;;;JQevP
508;École doctorale Normande de chimie;EDNC;4;Chimie;2014;2013-14;2013;2013;35;13;22;146;64;82;44;25;19;;;;;E52OO
509;École doctorale Civilisations et sociétés euro-méditerranéennes et comparées;;7;Sciences de la société;2014;2013-14;2013;2013;23;11;12;102;40;62;13;7;6;;;;;9tbyG
511;École doctorale Sciences et ingénierie;S&I;4;Chimie;2014;2013-14;2013;2013;2;2;0;16;11;5;4;4;0;;;;;7aXuB
518;École doctorale Matière condensée et interfaces;;2;Physique;2014;2013-14;2013;2013;34;9;25;108;35;73;28;6;22;;;;;Sg04R
519;École doctorale Sciences humaines et sociales - Perspectives européennes;SHS-PE;5;Biologie, médecine et santé;2014;2013-14;2013;2013;0;0;0;1;0;1;0;0;0;;;;;2f5qs
519;École doctorale Sciences humaines et sociales - Perspectives européennes;SHS-PE;6;Sciences humaines et humanités;2014;2013-14;2013;2013;63;43;20;328;179;149;42;22;20;;;;;2f5qs
521;École doctorale Sciences et ingénierie pour l'information, mathématiques;S2I;8;Sciences pour l'ingénieur;2014;2013-14;2013;2013;10;3;7;33;10;23;6;3;3;;;;;V6i83
521;École doctorale Sciences et ingénierie pour l'information, mathématiques;S2I;9;Sciences et technologies de l'information et de la communication;2014;2013-14;2013;2013;53;11;42;192;36;156;39;7;32;;;;;V6i83
522;École doctorale Sciences et ingénierie en matériaux, mécanique, énergétique et aéronautique;SI-MMEA;8;Sciences pour l'ingénieur;2014;2013-14;2013;2013;74;21;53;244;56;188;68;9;59;;;;;82F19
523;École doctorale Sciences pour l'environnement - Gay Lussac;;6;Sciences humaines et humanités;2014;2013-14;2013;2013;1;0;1;6;2;4;0;0;0;;;;;6xD69
525;"École doctorale Lettres, pensée, arts et histoire, ""Civilisation de l'antiquité à nos jours""";LPAH;6;Sciences humaines et humanités;2014;2013-14;2013;2013;65;46;19;263;155;108;44;27;17;;;;;19Rpr
526;École doctorale Sociétés et organisations;SORG;6;Sciences humaines et humanités;2014;2013-14;2013;2013;19;10;9;61;31;30;8;2;6;;;;;5F3Fd
528;École doctorale Ville, transports et territoires;VTT;7;Sciences de la société;2014;2013-14;2013;2013;15;6;9;50;24;26;2;0;2;;;;;68zCc
529;École doctorale Cultures et sociétés;CS;6;Sciences humaines et humanités;2014;2013-14;2013;2013;32;16;16;167;82;85;22;15;7;;;;;XU9tb
530;École doctorale Organisations, marchés, institutions;OMI;1;Mathématiques et leurs interactions;2014;2013-14;2013;2013;0;0;0;1;1;0;0;0;0;;;;;4htv7
530;École doctorale Organisations, marchés, institutions;OMI;5;Biologie, médecine et santé;2014;2013-14;2013;2013;0;0;0;1;1;0;0;0;0;;;;;4htv7
530;École doctorale Organisations, marchés, institutions;OMI;7;Sciences de la société;2014;2013-14;2013;2013;40;21;19;175;86;89;28;12;16;;;;;4htv7
530;École doctorale Organisations, marchés, institutions;OMI;8;Sciences pour l'ingénieur;2014;2013-14;2013;2013;0;0;0;3;2;1;0;0;0;;;;;4htv7
535;École doctorale Sciences de la société;SDS;6;Sciences humaines et humanités;2014;2013-14;2013;2013;5;4;1;25;16;9;3;2;1;;;;;iEUOV
536;École doctorale Sciences et agrosciences;;5;Biologie, médecine et santé;2014;2013-14;2013;2013;3;1;2;8;3;5;1;0;1;;;;;pHfqe
539;École doctorale Sciences et technologies de Versailles;;3;Sciences de la terre et de l'univers, espace;2014;2013-14;2013;2013;3;1;2;6;2;4;1;0;1;;;;;nv3h8
542;École doctorale de sciences de La Réunion;STS;9;Sciences et technologies de l'information et de la communication;2014;2013-14;2013;2013;3;1;2;15;8;7;8;5;3;;;;;2pAql
543;École doctorale de Dauphine;;9;Sciences et technologies de l'information et de la communication;2014;2013-14;2013;2013;10;4;6;29;9;20;10;2;8;;;;;u8w6A
547;École doctorale Sciences, Technologie, Santé;EDSTS;10;Sciences agronomiques et écologiques;2014;2013-14;2013;2013;11;4;7;55;29;26;10;5;5;;;;;wEdn2
548;École doctorale Mer et Sciences;;4;Chimie;2014;2013-14;2013;2013;5;2;3;21;9;12;3;0;3;;;;;QX0fS
548;École doctorale Mer et Sciences;;8;Sciences pour l'ingénieur;2014;2013-14;2013;2013;3;1;2;11;2;9;2;1;1;;;;;QX0fS
549;École doctorale Santé, Sciences Biologiques et Chimie du Vivant;SSBCV;2;Physique;2014;2013-14;2013;2013;1;0;1;2;1;1;1;0;1;;;;;B9ggO
549;École doctorale Santé, Sciences Biologiques et Chimie du Vivant;SSBCV;3;Sciences de la terre et de l'univers, espace;2014;2013-14;2013;2013;0;0;0;1;1;0;0;0;0;;;;;B9ggO
549;École doctorale Santé, Sciences Biologiques et Chimie du Vivant;SSBCV;6;Sciences humaines et humanités;2014;2013-14;2013;2013;3;3;0;9;9;0;0;0;0;;;;;B9ggO
551;École doctorale Mathématiques, Informatique, Physique Théorique et Ingénierie des Systèmes;MIPTIS;2;Physique;2014;2013-14;2013;2013;1;0;1;3;1;2;0;0;0;;;;;Mpudz
551;École doctorale Mathématiques, Informatique, Physique Théorique et Ingénierie des Systèmes;MIPTIS;8;Sciences pour l'ingénieur;2014;2013-14;2013;2013;1;0;1;3;0;3;1;0;1;;;;;Mpudz
552;École doctorale Énergie - Matériaux - Sciences de la Terre et de l'Univers;EMTSU;3;Sciences de la terre et de l'univers, espace;2014;2013-14;2013;2013;13;3;10;49;19;30;10;1;9;;;;;NTZhw
552;École doctorale Énergie - Matériaux - Sciences de la Terre et de l'Univers;EMTSU;9;Sciences et technologies de l'information et de la communication;2014;2013-14;2013;2013;0;0;0;7;2;5;5;0;5;;;;;NTZhw
553;École doctorale Carnot - Pasteur;;1;Mathématiques et leurs interactions;2014;2013-14;2013;2013;10;2;8;42;9;33;11;2;9;;;;;6h4Z7
553;École doctorale Carnot - Pasteur;;4;Chimie;2014;2013-14;2013;2013;21;4;17;101;24;77;21;8;13;;;;;6h4Z7
553;École doctorale Carnot - Pasteur;;7;Sciences de la société;2014;2013-14;2013;2013;3;2;1;9;3;6;1;0;1;;;;;6h4Z7
558;École doctorale Histoire, Mémoire, Patrimoine, Langage;HMPL;6;Sciences humaines et humanités;2014;2013-14;2013;2013;77;43;34;371;218;153;40;25;15;;;;;uX3jT
559;École doctorale Management Panthéon-Sorbonne;;1;Mathématiques et leurs interactions;2014;2013-14;2013;2013;51;20;31;132;63;69;13;10;3;;;;;4SP7k
8;École doctorale Histoire du droit, philosophie du droit et sociologie du droit;;7;Sciences de la société;2019;2018-19;2018;2018;11;3;8;93;38;55;8;3;5;;;;;pGSed
31;École doctorale Pratiques et théories du sens;;6;Sciences humaines et humanités;2019;2018-19;2018;2018;66;38;28;342;193;149;51;25;26;;;;;1S466
37;École doctorale Sciences physiques pour l'ingénieur et microtechniques;SPIM;3;Sciences de la terre et de l'univers, espace;2019;2018-19;2018;2018;0;0;0;1;0;1;1;0;1;;;;;F7G1B
47;École doctorale Physique;;8;Sciences pour l'ingénieur;2019;2018-19;2018;2018;2;1;1;9;3;6;3;1;2;;;;;8kNpd
50;École doctorale Langues, littératures et sciences humaines;LLSH;6;Sciences humaines et humanités;2019;2018-19;2018;2018;46;30;16;208;147;61;25;16;9;;;;;8THzQ
62;École doctorale Sciences de la vie et de la santé;;4;Chimie;2019;2018-19;2018;2018;1;1;0;1;1;0;0;0;0;;;;;vZzE7
62;École doctorale Sciences de la vie et de la santé;;5;Biologie, médecine et santé;2019;2018-19;2018;2018;191;107;84;682;386;296;194;110;84;;;;;vZzE7
62;École doctorale Sciences de la vie et de la santé;;6;Sciences humaines et humanités;2019;2018-19;2018;2018;2;2;0;3;2;1;0;0;0;;;;;vZzE7
65;École doctorale Sciences de la Vie, Santé, Agronomie, Environnement;;5;Biologie, médecine et santé;2019;2018-19;2018;2018;59;34;25;200;119;81;46;27;19;;;;;MAOG4
67;École doctorale Sciences juridiques et politiques;;7;Sciences de la société;2019;2018-19;2018;2018;92;38;54;480;224;256;89;45;44;;;;;qrOj1
71;École doctorale Sciences pour l'ingénieur;;6;Sciences humaines et humanités;2019;2018-19;2018;2018;1;0;1;20;9;11;6;2;4;;;;;H6UYp
77;École doctorale Informatique, automatique, électronique, électrotechnique, mathématiques;IAEM;8;Sciences pour l'ingénieur;2019;2018-19;2018;2018;4;0;4;25;2;23;1;0;1;;;;;TCHTA
79;École doctorale Sciences juridiques, politiques, économiques et de gestion;SJPEG;7;Sciences de la société;2019;2018-19;2018;2018;35;24;11;166;85;81;24;13;11;;;;;ea4x6
85;École doctorale Sciences de la vie et de la santé;SVS;5;Biologie, médecine et santé;2019;2018-19;2018;2018;40;23;17;204;129;75;55;38;17;;;;;YdiMF
104;École doctorale Sciences de la matière, du rayonnement et de l'environnement;SMRE;8;Sciences pour l'ingénieur;2019;2018-19;2018;2018;3;0;3;4;1;3;0;0;0;;;;;Q5iFz
104;École doctorale Sciences de la matière, du rayonnement et de l'environnement;SMRE;9;Sciences et technologies de l'information et de la communication;2019;2018-19;2018;2018;0;0;0;1;0;1;0;0;0;;;;;Q5iFz
112;École doctorale Archéologie;;6;Sciences humaines et humanités;2019;2018-19;2018;2018;23;16;7;196;120;76;34;18;16;;;;;EvU7R
119;École doctorale Science politique;;7;Sciences de la société;2019;2018-19;2018;2018;12;5;7;95;48;47;6;5;1;;;;;eyibb
122;École doctorale Europe latine - Amérique latine;;6;Sciences humaines et humanités;2019;2018-19;2018;2018;9;8;1;101;70;31;15;9;6;;;;;z9lZY
131;École doctorale Langue, littérature, image, civilisations et sciences humaines (domaines francophone et anglophone);LLI;6;Sciences humaines et humanités;2019;2018-19;2018;2018;24;17;7;149;102;47;23;18;5;;;;;a47aW
132;École doctorale Sciences du langage;;6;Sciences humaines et humanités;2019;2018-19;2018;2018;8;4;4;62;41;21;11;4;7;;;;;5AUF1
139;École doctorale Connaissance, langage, modélisation;CLM;8;Sciences pour l'ingénieur;2019;2018-19;2018;2018;8;3;5;21;7;14;9;1;8;;;;;1lxGH
141;École doctorale Droit et science politique;DSP;7;Sciences de la société;2019;2018-19;2018;2018;58;30;28;189;87;102;31;12;19;;;;;CyNBf
160;École doctorale Électronique, électrotechnique, automatique;EEA;8;Sciences pour l'ingénieur;2019;2018-19;2018;2018;19;2;17;81;18;63;25;8;17;;;;;EgfMQ
162;École doctorale Mécanique, énergétique, génie civil, acoustique;MEGA;8;Sciences pour l'ingénieur;2019;2018-19;2018;2018;83;31;52;404;102;302;87;16;71;;;;;7wCke
166;École doctorale Information, structures et systèmes;I2S;2;Physique;2019;2018-19;2018;2018;20;7;13;64;19;45;21;8;13;;;;;2uO68
166;École doctorale Information, structures et systèmes;I2S;4;Chimie;2019;2018-19;2018;2018;1;1;0;2;2;0;3;3;0;;;;;2uO68
166;École doctorale Information, structures et systèmes;I2S;9;Sciences et technologies de l'information et de la communication;2019;2018-19;2018;2018;36;4;32;102;16;86;39;11;28;;;;;2uO68
171;École doctorale Toulouse sciences économiques;TSE;7;Sciences de la société;2019;2018-19;2018;2018;13;5;8;104;38;66;20;9;11;;;;;Q5nNQ
173;École doctorale Sciences de l'univers, de l'environnement et de l'espace;SDU2E;8;Sciences pour l'ingénieur;2019;2018-19;2018;2018;2;0;2;18;4;14;4;1;3;;;;;R0Z9c
178;École doctorale Sciences fondamentales;;5;Biologie, médecine et santé;2019;2018-19;2018;2018;0;0;0;2;2;0;1;1;0;;;;;1AiR7
184;École doctorale Mathématiques et informatique de Marseille;;1;Mathématiques et leurs interactions;2019;2018-19;2018;2018;22;3;19;80;24;56;23;8;15;;;;;DDObG
184;École doctorale Mathématiques et informatique de Marseille;;2;Physique;2019;2018-19;2018;2018;0;0;0;1;0;1;0;0;0;;;;;DDObG
184;École doctorale Mathématiques et informatique de Marseille;;8;Sciences pour l'ingénieur;2019;2018-19;2018;2018;1;0;1;8;0;8;4;0;4;;;;;DDObG
205;École doctorale Interdisciplinaire Sciences-Santé;EDISS;4;Chimie;2019;2018-19;2018;2018;0;0;0;1;1;0;1;1;0;;;;;69W38
206;École doctorale Chimie : chimie, procédés, environnement;;5;Biologie, médecine et santé;2019;2018-19;2018;2018;1;0;1;2;1;1;3;2;1;;;;;m0UhD
211;École doctorale Sciences exactes et leurs applications;ED SEA;2;Physique;2019;2018-19;2018;2018;5;4;1;16;11;5;5;1;4;;;;;1G1iC
211;École doctorale Sciences exactes et leurs applications;ED SEA;4;Chimie;2019;2018-19;2018;2018;33;14;19;91;41;50;9;4;5;;;;;1G1iC
211;École doctorale Sciences exactes et leurs applications;ED SEA;10;Sciences agronomiques et écologiques;2019;2018-19;2018;2018;2;0;2;6;2;4;2;0;2;;;;;1G1iC
216;École doctorale Ingénierie pour la santé, la cognition, l'environnement;EDISCE;3;Sciences de la terre et de l'univers, espace;2019;2018-19;2018;2018;0;0;0;1;0;1;0;0;0;;;;;fPs1t
227;École doctorale Sciences de la nature et de l'homme;;4;Chimie;2019;2018-19;2018;2018;1;0;1;2;0;2;1;0;1;;;;;xiDA5
231;École doctorale Économie et gestion;EDEG;7;Sciences de la société;2019;2018-19;2018;2018;39;18;21;178;86;92;36;21;15;;;;;KT720
251;École doctorale Sciences de l'environnement;;8;Sciences pour l'ingénieur;2019;2018-19;2018;2018;3;2;1;17;10;7;3;0;3;;;;;VR28y
262;École doctorale Sciences juridiques, politiques, économiques et de gestion;DEG;7;Sciences de la société;2019;2018-19;2018;2018;34;20;14;176;87;89;19;7;12;;;;;H7GyL
266;École doctorale Biologie, santé, environnement;BIOSE;5;Biologie, médecine et santé;2019;2018-19;2018;2018;30;15;15;137;82;55;36;26;10;;;;;386V9
268;École doctorale Langage et langues : description, théorisation, transmission;;6;Sciences humaines et humanités;2019;2018-19;2018;2018;38;25;13;207;143;64;33;25;8;;;;;wAIDE
269;École doctorale Mathématiques, sciences de l'information et de l'ingénieur;MSII;8;Sciences pour l'ingénieur;2019;2018-19;2018;2018;21;3;18;118;30;88;21;6;15;;;;;5E625
279;École doctorale Arts plastiques, esthétique et sciences de l'art;APESA;6;Sciences humaines et humanités;2019;2018-19;2018;2018;22;15;7;183;124;59;26;17;9;;;;;BpW1j
300;École doctorale Sciences Économiques;ED SE;6;Sciences humaines et humanités;2019;2018-19;2018;2018;3;0;3;5;0;5;0;0;0;;;;;5x3fM
305;École doctorale Énergie et environnement;E2;1;Mathématiques et leurs interactions;2019;2018-19;2018;2018;1;0;1;8;4;4;2;2;0;;;;;Kbt8I
305;École doctorale Énergie et environnement;E2;3;Sciences de la terre et de l'univers, espace;2019;2018-19;2018;2018;3;2;1;11;7;4;3;2;1;;;;;Kbt8I
305;École doctorale Énergie et environnement;E2;5;Biologie, médecine et santé;2019;2018-19;2018;2018;4;2;2;25;17;8;4;2;2;;;;;Kbt8I
305;École doctorale Énergie et environnement;E2;9;Sciences et technologies de l'information et de la communication;2019;2018-19;2018;2018;3;2;1;4;2;2;1;0;1;;;;;Kbt8I
309;École doctorale Systèmes;EDSYS;9;Sciences et technologies de l'information et de la communication;2019;2018-19;2018;2018;23;4;19;101;23;78;24;5;19;;;;;8TT4b
323;École doctorale Génie électrique, électronique et télécommunications;GEET;1;Mathématiques et leurs interactions;2019;2018-19;2018;2018;1;0;1;2;0;2;0;0;0;;;;;arcz6
326;École doctorale Comportement, langage, éducation, socialisation, cognition;CLESCO;9;Sciences et technologies de l'information et de la communication;2019;2018-19;2018;2018;3;2;1;3;2;1;0;0;0;;;;;nWIlG
327;École doctorale Temps, espaces, sociétés, cultures;TESC;6;Sciences humaines et humanités;2019;2018-19;2018;2018;39;22;17;243;134;109;31;16;15;;;;;IjgiJ
328;École doctorale Arts, lettres, langues, philosophie et communication;ALLPH@;9;Sciences et technologies de l'information et de la communication;2019;2018-19;2018;2018;7;6;1;31;21;10;7;5;2;;;;;xLxMh
341;École doctorale Évolution, écosystèmes, microbiologie, modélisation;E2M2;10;Sciences agronomiques et écologiques;2019;2018-19;2018;2018;15;6;9;62;36;26;16;11;5;;;;;J83I0
352;École doctorale Physique et sciences de la matière;;2;Physique;2019;2018-19;2018;2018;67;19;48;259;74;185;77;21;56;;;;;fb5YC
356;École doctorale Cognition, langage, éducation;;6;Sciences humaines et humanités;2019;2018-19;2018;2018;49;34;15;223;133;90;57;28;29;;;;;55Cpz
361;École doctorale Sciences et Technologies;ED ST;9;Sciences et technologies de l'information et de la communication;2019;2018-19;2018;2018;27;12;15;126;47;79;33;8;25;;;;;cOUmL
370;École doctorale Lettres, sciences humaines et sociales;LSHS;9;Sciences et technologies de l'information et de la communication;2019;2018-19;2018;2018;2;2;0;6;3;3;0;0;0;;;;;xAXXx
377;École doctorale Environnement et société;;1;Mathématiques et leurs interactions;2019;2018-19;2018;2018;0;0;0;1;0;1;0;0;0;;;;;ZMG5u
382;École doctorale Économie, espaces, sociétés, civilisations : pensée critique, politique et pratique sociale;EESC;6;Sciences humaines et humanités;2019;2018-19;2018;2018;25;14;11;124;74;50;15;9;6;;;;;9NI1W
391;École doctorale Sciences mécaniques, acoustique et électronique et robotique de Paris;SMAER;8;Sciences pour l'ingénieur;2019;2018-19;2018;2018;59;14;45;197;50;147;52;10;42;;;;;k0eue
395;École doctorale Milieux, cultures et sociétés du passé et du présent;MCSPP;6;Sciences humaines et humanités;2019;2018-19;2018;2018;47;31;16;234;150;84;32;24;8;;;;;2quEb
396;École doctorale Économie, organisations, société;EOS;6;Sciences humaines et humanités;2019;2018-19;2018;2018;2;1;1;19;8;11;5;1;4;;;;;Es5e7
397;École doctorale Physique et chimie des matériaux;;2;Physique;2019;2018-19;2018;2018;34;5;29;103;23;80;34;13;21;;;;;WxSt9
405;École doctorale Économie, management,mathématiques et physique de Cergy;EM2C;1;Mathématiques et leurs interactions;2019;2018-19;2018;2018;3;1;2;15;5;10;5;1;4;;;;;QbwSB
405;École doctorale Économie, management,mathématiques et physique de Cergy;EM2C;2;Physique;2019;2018-19;2018;2018;3;0;3;11;2;9;2;0;2;;;;;QbwSB
413;École doctorale Sciences de la terre et de l'environnement;STE;3;Sciences de la terre et de l'univers, espace;2019;2018-19;2018;2018;13;6;7;68;26;42;15;6;9;;;;;u9BA9
413;École doctorale Sciences de la terre et de l'environnement;STE;6;Sciences humaines et humanités;2019;2018-19;2018;2018;3;2;1;16;6;10;1;1;0;;;;;u9BA9
417;École doctorale Sciences et Ingénierie;S&I;5;Biologie, médecine et santé;2019;2018-19;2018;2018;4;3;1;12;7;5;1;0;1;;;;;SSBvE
417;École doctorale Sciences et Ingénierie;S&I;9;Sciences et technologies de l'information et de la communication;2019;2018-19;2018;2018;3;2;1;5;2;3;0;0;0;;;;;SSBvE
432;École doctorale Sciences des métiers de l'ingénieur;SMI;8;Sciences pour l'ingénieur;2019;2018-19;2018;2018;78;26;52;310;77;233;77;14;63;;;;;nSsHB
441;École doctorale Histoire de l'art;;6;Sciences humaines et humanités;2019;2018-19;2018;2018;34;25;9;193;143;50;24;14;10;;;;;d5W3U
446;École doctorale Biologie - Santé;EDBSL;1;Mathématiques et leurs interactions;2019;2018-19;2018;2018;0;0;0;1;1;0;0;0;0;;;;;4iEUF
446;École doctorale Biologie - Santé;EDBSL;2;Physique;2019;2018-19;2018;2018;1;1;0;1;1;0;0;0;0;;;;;4iEUF
446;École doctorale Biologie - Santé;EDBSL;4;Chimie;2019;2018-19;2018;2018;4;1;3;12;6;6;1;1;0;;;;;4iEUF
460;École doctorale Sciences juridiques;SJ;6;Sciences humaines et humanités;2019;2018-19;2018;2018;13;5;8;27;12;15;0;0;0;;;;;ZB5I5
467;École doctorale Aéronautique, astronautique;AA;2;Physique;2019;2018-19;2018;2018;1;0;1;4;1;3;3;1;2;;;;;U7l45
469;École doctorale du Pacifique;EDP;6;Sciences humaines et humanités;2019;2018-19;2018;2018;7;2;5;12;7;5;1;0;1;;;;;t9Z2n
472;École doctorale de l'EPHE;;9;Sciences et technologies de l'information et de la communication;2019;2018-19;2018;2018;1;0;1;5;1;4;0;0;0;;;;;27zK4
473;École doctorale Sciences de l'homme et de la société;SHS;7;Sciences de la société;2019;2018-19;2018;2018;0;0;0;0;0;0;1;0;1;;;;;8qKD9
475;École doctorale Mathématiques, informatique, télécommunications de Toulouse;MITT;1;Mathématiques et leurs interactions;2019;2018-19;2018;2018;32;9;23;130;42;88;28;8;20;;;;;xcp2r
475;École doctorale Mathématiques, informatique, télécommunications de Toulouse;MITT;9;Sciences et technologies de l'information et de la communication;2019;2018-19;2018;2018;69;21;48;288;77;211;71;13;58;;;;;xcp2r
476;École doctorale Neurosciences et cognition;NSCO;6;Sciences humaines et humanités;2019;2018-19;2018;2018;5;4;1;23;14;9;3;2;1;;;;;B1H0x
481;École doctorale Sciences sociales et humanités;SSH;7;Sciences de la société;2019;2018-19;2018;2018;44;18;26;200;90;110;25;12;13;;;;;E3z5j
484;École doctorale Lettres, langues, linguistique, arts;3LA;6;Sciences humaines et humanités;2019;2018-19;2018;2018;53;35;18;435;279;156;61;43;18;;;;;BlCQD
485;École doctorale Éducation, Psychologie, Information et Communication;EPIC;6;Sciences humaines et humanités;2019;2018-19;2018;2018;38;23;15;224;143;81;39;25;14;;;;;O82eL
488;École doctorale Sciences, ingénierie, santé;SIS;3;Sciences de la terre et de l'univers, espace;2019;2018-19;2018;2018;4;1;3;10;4;6;6;2;4;;;;;Fy2lK
489;École doctorale Sciences et ingénierie des systèmes, de l'environnement et des organisations;SISEO;4;Chimie;2019;2018-19;2018;2018;2;0;2;10;4;6;1;0;1;;;;;6pT77
492;École doctorale Droit;;7;Sciences de la société;2019;2018-19;2018;2018;57;28;29;299;148;151;37;22;15;;;;;kOQsX
512;École doctorale Informatique et mathématiques;InfoMaths;1;Mathématiques et leurs interactions;2019;2018-19;2018;2018;24;2;22;100;25;75;22;6;16;;;;;t86bi
512;École doctorale Informatique et mathématiques;InfoMaths;9;Sciences et technologies de l'information et de la communication;2019;2018-19;2018;2018;46;16;30;209;52;157;50;11;39;;;;;t86bi
513;École doctorale Droit et sciences politiques, économiques et de gestion;DESPEG;7;Sciences de la société;2019;2018-19;2018;2018;65;32;33;285;138;147;36;18;18;;;;;aVHGU
520;École doctorale Humanités;;7;Sciences de la société;2019;2018-19;2018;2018;1;0;1;2;0;2;0;0;0;;;;;rI175
523;École doctorale Sciences pour l'environnement - Gay Lussac;;5;Biologie, médecine et santé;2019;2018-19;2018;2018;0;0;0;0;0;0;3;1;2;;;;;6xD69
528;École doctorale Ville, transports et territoires;VTT;6;Sciences humaines et humanités;2019;2018-19;2018;2018;15;10;5;130;85;45;25;12;13;;;;;68zCc
528;École doctorale Ville, transports et territoires;VTT;8;Sciences pour l'ingénieur;2019;2018-19;2018;2018;8;2;6;24;5;19;4;1;3;;;;;68zCc
531;École doctorale Sciences, ingénierie et environnement;SIE;2;Physique;2019;2018-19;2018;2018;4;0;4;20;3;17;6;1;5;;;;;b5BYq
531;École doctorale Sciences, ingénierie et environnement;SIE;4;Chimie;2019;2018-19;2018;2018;20;13;7;51;31;20;11;6;5;;;;;b5BYq
532;École doctorale Mathématiques et sciences et technologies de l'information et de la communication;MSTIC;9;Sciences et technologies de l'information et de la communication;2019;2018-19;2018;2018;44;13;31;139;36;103;37;10;27;;;;;t43KM
536;École doctorale Sciences et agrosciences;;9;Sciences et technologies de l'information et de la communication;2019;2018-19;2018;2018;9;3;6;25;8;17;9;2;7;;;;;pHfqe
540;"École doctorale École transdisciplinaire ""lettres/sciences""";;2;Physique;2019;2018-19;2018;2018;1;1;0;2;1;1;0;0;0;;;;;tWWw7
542;École doctorale de sciences de La Réunion;STS;3;Sciences de la terre et de l'univers, espace;2019;2018-19;2018;2018;0;0;0;4;3;1;1;0;1;;;;;2pAql
542;École doctorale de sciences de La Réunion;STS;4;Chimie;2019;2018-19;2018;2018;1;1;0;5;3;2;1;1;0;;;;;2pAql
542;École doctorale de sciences de La Réunion;STS;10;Sciences agronomiques et écologiques;2019;2018-19;2018;2018;13;5;8;27;10;17;8;4;4;;;;;2pAql
544;École doctorale Inter-Med : Espaces, temps, cultures;INTER-MED;7;Sciences de la société;2019;2018-19;2018;2018;32;18;14;141;66;75;17;10;7;;;;;7VjtD
549;École doctorale Santé, Sciences Biologiques et Chimie du Vivant;SSBCV;2;Physique;2019;2018-19;2018;2018;1;0;1;3;1;2;0;0;0;;;;;B9ggO
551;École doctorale Mathématiques, Informatique, Physique Théorique et Ingénierie des Systèmes;MIPTIS;1;Mathématiques et leurs interactions;2019;2018-19;2018;2018;8;3;5;30;8;22;6;2;4;;;;;Mpudz
551;École doctorale Mathématiques, Informatique, Physique Théorique et Ingénierie des Systèmes;MIPTIS;8;Sciences pour l'ingénieur;2019;2018-19;2018;2018;2;1;1;22;8;14;0;0;0;;;;;Mpudz
552;École doctorale Énergie - Matériaux - Sciences de la Terre et de l'Univers;EMTSU;5;Biologie, médecine et santé;2019;2018-19;2018;2018;0;0;0;1;0;1;1;0;1;;;;;NTZhw
553;École doctorale Carnot - Pasteur;;1;Mathématiques et leurs interactions;2019;2018-19;2018;2018;9;2;7;35;7;28;12;5;7;;;;;6h4Z7
553;École doctorale Carnot - Pasteur;;9;Sciences et technologies de l'information et de la communication;2019;2018-19;2018;2018;0;0;0;1;0;1;1;0;1;;;;;6h4Z7
567;École doctorale Sciences du Végétal : du gène à l'écosystème;;5;Biologie, médecine et santé;2019;2018-19;2018;2018;16;9;7;77;35;42;19;8;11;;;;;tuDkA
567;École doctorale Sciences du Végétal : du gène à l'écosystème;;10;Sciences agronomiques et écologiques;2019;2018-19;2018;2018;11;6;5;39;21;18;5;2;3;;;;;tuDkA
570;École doctorale Santé Publique;EDSP;1;Mathématiques et leurs interactions;2019;2018-19;2018;2018;1;0;1;4;2;2;1;1;0;;;;;9lgE4
571;École doctorale Sciences Chimiques : Molécules, Matériaux, Instrumentation et Biosystemes;2MIB;4;Chimie;2019;2018-19;2018;2018;89;34;55;302;136;166;61;26;35;;;;;zbi37
573;École doctorale Interfaces : Approches Interdisciplinaires, Fondements, Applications et Innovation;ED INTERFACES;8;Sciences pour l'ingénieur;2019;2018-19;2018;2018;7;4;3;63;28;35;16;3;13;;;;;gG820
575;École doctorale Electrical, Optical, Bio : Physics and Engineering;EOBE;9;Sciences et technologies de l'information et de la communication;2019;2018-19;2018;2018;9;5;4;36;13;23;11;5;6;;;;;dfhyn
577;École doctorale Structure et dynamique des systèmes vivants;SDSV;10;Sciences agronomiques et écologiques;2019;2018-19;2018;2018;3;1;2;4;2;2;0;0;0;;;;;4bsxJ
578;École doctorale Sciences de l'Homme et de la Société;ED SHS;7;Sciences de la société;2019;2018-19;2018;2018;68;28;40;514;225;289;74;36;38;;;;;Ud43O
581;École doctorale Agriculture, alimentation, biologie, environnement, santé;ABIES;4;Chimie;2019;2018-19;2018;2018;2;1;1;7;3;4;5;2;3;;;;;c1x56
581;École doctorale Agriculture, alimentation, biologie, environnement, santé;ABIES;8;Sciences pour l'ingénieur;2019;2018-19;2018;2018;14;7;7;78;45;33;9;5;4;;;;;c1x56
584;École doctorale Biodiversité, Agriculture, Alimentation, Environnement, Terre, Eau;GAIA;3;Sciences de la terre et de l'univers, espace;2019;2018-19;2018;2018;17;5;12;66;22;44;19;7;12;;;;;F1h5f
584;École doctorale Biodiversité, Agriculture, Alimentation, Environnement, Terre, Eau;GAIA;8;Sciences pour l'ingénieur;2019;2018-19;2018;2018;4;3;1;35;19;16;21;8;13;;;;;F1h5f
587;École doctorale Diversites, santé et développement en Amazonie;;1;Mathématiques et leurs interactions;2019;2018-19;2018;2018;0;0;0;3;0;3;1;1;0;;;;;V14tj
587;École doctorale Diversites, santé et développement en Amazonie;;5;Biologie, médecine et santé;2019;2018-19;2018;2018;1;0;1;24;18;6;4;3;1;;;;;V14tj
587;École doctorale Diversites, santé et développement en Amazonie;;8;Sciences pour l'ingénieur;2019;2018-19;2018;2018;0;0;0;2;1;1;0;0;0;;;;;V14tj
587;École doctorale Diversites, santé et développement en Amazonie;;10;Sciences agronomiques et écologiques;2019;2018-19;2018;2018;0;0;0;3;3;0;2;2;0;;;;;V14tj
588;École doctorale Milieu insulaire tropical : dynamiques de développement, sociétés, patrimoine et culture dans l'espace Caraïbes-Amériques;;7;Sciences de la société;2019;2018-19;2018;2018;15;12;3;68;41;27;4;2;2;;;;;4W5IO
589;École doctorale Milieu insulaire tropical à risques : protection, valorisation , santé et développement;;3;Sciences de la terre et de l'univers, espace;2019;2018-19;2018;2018;1;1;0;4;2;2;1;1;0;;;;;2cqi3
589;École doctorale Milieu insulaire tropical à risques : protection, valorisation , santé et développement;;10;Sciences agronomiques et écologiques;2019;2018-19;2018;2018;2;1;1;3;1;2;1;0;1;;;;;2cqi3
594;École doctorale Sociétés, Espaces, Pratiques, Temps;ED SEPT;6;Sciences humaines et humanités;2019;2018-19;2018;2018;52;24;28;305;145;160;44;26;18;;;;;N85H3
595;École doctorale Arts, Lettres, Langues;ED ALL;6;Sciences humaines et humanités;2019;2018-19;2018;2018;63;43;20;403;263;140;58;36;22;;;;;a8f9b
598;École doctorale Sciences de La Mer et du Littoral;SML;5;Biologie, médecine et santé;2019;2018-19;2018;2018;19;16;3;41;28;13;6;5;1;;;;;Smen6
604;École doctorale Sociétés, Temps, Territoires;STT;6;Sciences humaines et humanités;2019;2018-19;2018;2018;61;25;36;334;158;176;68;31;37;;;;;SZI5T
605;École doctorale Biologie Santé;ED BS;10;Sciences agronomiques et écologiques;2019;2018-19;2018;2018;0;0;0;1;0;1;2;1;1;;;;;w8CxU
608;École doctorale Sciences et Ingénierie des Molécules, des Produits, des Procédés et de l'Énergie;SIMPPÉ;4;Chimie;2019;2018-19;2018;2018;2;0;2;5;3;2;1;1;0;;;;;TyNjM
608;École doctorale Sciences et Ingénierie des Molécules, des Produits, des Procédés et de l'Énergie;SIMPPÉ;10;Sciences agronomiques et écologiques;2019;2018-19;2018;2018;3;2;1;11;8;3;2;2;0;;;;;TyNjM
609;École doctorale Sciences et Ingénierie des Matériaux, Mécanique, Énergétique -;SIMME;4;Chimie;2019;2018-19;2018;2018;6;5;1;30;12;18;0;0;0;;;;;N4Rjy
615;École doctorale Sciences Biologiques et Santé;SBS;5;Biologie, médecine et santé;2019;2018-19;2018;2018;42;25;17;142;84;58;0;0;0;;;;;TNa15
616;École doctorale Humanités et Langues;H&L;5;Biologie, médecine et santé;2019;2018-19;2018;2018;2;1;1;20;7;13;6;2;4;;;;;FYOlf
617;École doctorale Sciences de la Société : Territoires, Economie et Droit;SSTED;5;Biologie, médecine et santé;2019;2018-19;2018;2018;0;0;0;1;0;1;0;0;0;;;;;Kl9ZX
617;École doctorale Sciences de la Société : Territoires, Economie et Droit;SSTED;7;Sciences de la société;2019;2018-19;2018;2018;35;14;21;179;75;104;14;5;9;;;;;Kl9ZX
618;École doctorale EUCLIDE;;3;Sciences de la terre et de l'univers, espace;2019;2018-19;2018;2018;6;3;3;11;4;7;0;0;0;;;;;qveTN
618;École doctorale EUCLIDE;;5;Biologie, médecine et santé;2019;2018-19;2018;2018;3;1;2;10;5;5;2;2;0;;;;;qveTN
618;École doctorale EUCLIDE;;10;Sciences agronomiques et écologiques;2019;2018-19;2018;2018;12;5;7;43;19;24;10;3;7;;;;;qveTN
619;École doctorale Sciences Fondamentales et Santé;SFS;5;Biologie, médecine et santé;2019;2018-19;2018;2018;17;8;9;75;43;32;20;13;7;;;;;JiZVW
619;École doctorale Sciences Fondamentales et Santé;SFS;9;Sciences et technologies de l'information et de la communication;2019;2018-19;2018;2018;0;0;0;1;0;1;0;0;0;;;;;JiZVW
620;École doctorale Sciences du Numérique et de l'Ingénieur;SNI;1;Mathématiques et leurs interactions;2019;2018-19;2018;2018;0;0;0;2;2;0;0;0;0;;;;;Dr40w
620;École doctorale Sciences du Numérique et de l'Ingénieur;SNI;4;Chimie;2019;2018-19;2018;2018;0;0;0;1;1;0;0;0;0;;;;;Dr40w
621;École doctorale Ingénierie des Systèmes, Matériaux, Mécanique, Énergétique;ISMME;5;Biologie, médecine et santé;2019;2018-19;2018;2018;0;0;0;1;0;1;0;0;0;;;;;B2549
20;École doctorale Civilisations, cultures, littératures et sociétés;;6;Sciences humaines et humanités;2017;2016-17;2016;2016;58;37;21;245;165;80;23;16;7;;;;;agjNi
22;École doctorale Mondes anciens et médiévaux;;6;Sciences humaines et humanités;2017;2016-17;2016;2016;39;20;19;172;95;77;31;18;13;;;;;fqCbl
31;École doctorale Pratiques et théories du sens;;6;Sciences humaines et humanités;2017;2016-17;2016;2016;85;45;40;325;171;154;44;27;17;;;;;1S466
31;École doctorale Pratiques et théories du sens;;7;Sciences de la société;2017;2016-17;2016;2016;26;18;8;124;75;49;8;5;3;;;;;1S466
34;École doctorale Matériaux;;3;Sciences de la terre et de l'univers, espace;2017;2016-17;2016;2016;0;0;0;3;1;2;1;1;0;;;;;1Iufh
38;École doctorale Langages, espaces, temps, sociétés;;6;Sciences humaines et humanités;2017;2016-17;2016;2016;0;0;0;0;0;0;27;13;14;;;;;pGgDX
38;École doctorale Langages, espaces, temps, sociétés;;7;Sciences de la société;2017;2016-17;2016;2016;0;0;0;0;0;0;4;0;4;;;;;pGgDX
38;École doctorale Langages, espaces, temps, sociétés;;9;Sciences et technologies de l'information et de la communication;2017;2016-17;2016;2016;0;0;0;0;0;0;2;2;0;;;;;pGgDX
39;École doctorale Mathématiques et Informatique;EDMIB;9;Sciences et technologies de l'information et de la communication;2017;2016-17;2016;2016;19;6;13;100;20;80;24;4;20;;;;;TBj2X
47;École doctorale Physique;;5;Biologie, médecine et santé;2017;2016-17;2016;2016;2;1;1;5;3;2;2;1;1;;;;;8kNpd
60;École doctorale Territoires, temps, sociétés et développement;TTSD;7;Sciences de la société;2017;2016-17;2016;2016;21;14;7;64;35;29;6;4;2;;;;;fkIh6
67;École doctorale Sciences juridiques et politiques;;7;Sciences de la société;2017;2016-17;2016;2016;54;24;30;399;199;200;54;34;20;;;;;qrOj1
70;École doctorale Sciences pour l'ingénieur;EDSPI;8;Sciences pour l'ingénieur;2017;2016-17;2016;2016;17;9;8;45;15;30;10;3;7;;;;;G413P
71;École doctorale Sciences pour l'ingénieur;;1;Mathématiques et leurs interactions;2017;2016-17;2016;2016;4;2;2;8;5;3;2;2;0;;;;;H6UYp
72;École doctorale Sciences pour l'ingénieur;SPI;1;Mathématiques et leurs interactions;2017;2016-17;2016;2016;18;7;11;61;24;37;23;7;16;;;;;47QPx
72;École doctorale Sciences pour l'ingénieur;SPI;8;Sciences pour l'ingénieur;2017;2016-17;2016;2016;56;16;40;255;63;192;69;13;56;;;;;47QPx
73;École doctorale Sciences économiques, sociales, de l'aménagement et du management;SESAM;7;Sciences de la société;2017;2016-17;2016;2016;37;19;18;192;88;104;25;13;12;;;;;IQ0Hk
74;École doctorale Sciences juridiques, politique et de gestion;SJPG;6;Sciences humaines et humanités;2017;2016-17;2016;2016;42;26;16;259;137;122;31;14;17;;;;;3A2RY
77;École doctorale Informatique, automatique, électronique, électrotechnique, mathématiques;IAEM;5;Biologie, médecine et santé;2017;2016-17;2016;2016;2;1;1;2;1;1;0;0;0;;;;;TCHTA
77;École doctorale Informatique, automatique, électronique, électrotechnique, mathématiques;IAEM;8;Sciences pour l'ingénieur;2017;2016-17;2016;2016;29;4;25;49;7;42;4;1;3;;;;;TCHTA
84;École doctorale Sciences et technologies de l'information et de la communication;STIC;9;Sciences et technologies de l'information et de la communication;2017;2016-17;2016;2016;54;16;38;224;60;164;42;9;33;;;;;9wS2W
92;École doctorale Vie -  Agro - Santé;;10;Sciences agronomiques et écologiques;2017;2016-17;2016;2016;26;18;8;86;56;30;28;16;12;;;;;RjvXY
101;École doctorale de Sciences juridiques;;7;Sciences de la société;2017;2016-17;2016;2016;46;23;23;225;112;113;20;13;7;;;;;569G2
104;École doctorale Sciences de la matière, du rayonnement et de l'environnement;SMRE;2;Physique;2017;2016-17;2016;2016;19;5;14;73;23;50;12;3;9;;;;;Q5iFz
104;École doctorale Sciences de la matière, du rayonnement et de l'environnement;SMRE;3;Sciences de la terre et de l'univers, espace;2017;2016-17;2016;2016;9;4;5;37;13;24;12;6;6;;;;;Q5iFz
124;École doctorale Histoire de l'art et archéologie;;6;Sciences humaines et humanités;2017;2016-17;2016;2016;32;21;11;174;116;58;25;17;8;;;;;MBN4L
139;École doctorale Connaissance, langage, modélisation;CLM;6;Sciences humaines et humanités;2017;2016-17;2016;2016;60;42;18;265;181;84;44;31;13;;;;;1lxGH
146;École doctorale Galilée;GALILEE;9;Sciences et technologies de l'information et de la communication;2017;2016-17;2016;2016;9;0;9;41;9;32;14;3;11;;;;;71hqm
158;École doctorale Cerveau, cognition, comportement;3C;5;Biologie, médecine et santé;2017;2016-17;2016;2016;88;45;43;348;204;144;93;52;41;;;;;Il62F
171;École doctorale Toulouse sciences économiques;TSE;7;Sciences de la société;2017;2016-17;2016;2016;18;4;14;109;31;78;17;3;14;;;;;Q5nNQ
173;École doctorale Sciences de l'univers, de l'environnement et de l'espace;SDU2E;3;Sciences de la terre et de l'univers, espace;2017;2016-17;2016;2016;59;23;36;283;105;178;72;24;48;;;;;R0Z9c
178;École doctorale Sciences fondamentales;;2;Physique;2017;2016-17;2016;2016;10;1;9;31;5;26;12;3;9;;;;;1AiR7
180;École doctorale Sciences humaines et sociales : cultures, individus, sociétés;SHS;7;Sciences de la société;2017;2016-17;2016;2016;24;13;11;106;62;44;24;14;10;;;;;D2BT3
181;École doctorale Structure, informations, matière et matériaux;Simem;8;Sciences pour l'ingénieur;2017;2016-17;2016;2016;0;0;0;0;0;0;4;0;4;;;;;c1D6f
182;École doctorale Physique et chimie-physique;;3;Sciences de la terre et de l'univers, espace;2017;2016-17;2016;2016;0;0;0;6;0;6;4;1;3;;;;;3My6I
182;École doctorale Physique et chimie-physique;;6;Sciences humaines et humanités;2017;2016-17;2016;2016;0;0;0;0;0;0;1;0;1;;;;;3My6I
184;École doctorale Mathématiques et informatique de Marseille;;5;Biologie, médecine et santé;2017;2016-17;2016;2016;0;0;0;1;0;1;0;0;0;;;;;DDObG
216;École doctorale Ingénierie pour la santé, la cognition, l'environnement;EDISCE;8;Sciences pour l'ingénieur;2017;2016-17;2016;2016;1;0;1;12;4;8;4;2;2;;;;;fPs1t
220;École doctorale Électronique, électrotechnique, automatique, traitement du signal;EEATS;1;Mathématiques et leurs interactions;2017;2016-17;2016;2016;5;2;3;7;3;4;0;0;0;;;;;IxEaw
220;École doctorale Électronique, électrotechnique, automatique, traitement du signal;EEATS;4;Chimie;2017;2016-17;2016;2016;2;1;1;2;1;1;0;0;0;;;;;IxEaw
227;École doctorale Sciences de la nature et de l'homme;;6;Sciences humaines et humanités;2017;2016-17;2016;2016;13;4;9;55;31;24;5;4;1;;;;;xiDA5
227;École doctorale Sciences de la nature et de l'homme;;10;Sciences agronomiques et écologiques;2017;2016-17;2016;2016;36;17;19;113;59;54;25;18;7;;;;;xiDA5
231;École doctorale Économie et gestion;EDEG;7;Sciences de la société;2017;2016-17;2016;2016;42;17;25;191;92;99;44;22;22;;;;;KT720
240;École doctorale Sciences de l'homme et de la société;SHS;6;Sciences humaines et humanités;2017;2016-17;2016;2016;82;41;41;307;171;136;26;14;12;;;;;j345k
245;École doctorale Sciences économiques, juridiques, politiques et de gestion;;7;Sciences de la société;2017;2016-17;2016;2016;41;13;28;188;79;109;19;5;14;;;;;ShLUg
251;École doctorale Sciences de l'environnement;;10;Sciences agronomiques et écologiques;2017;2016-17;2016;2016;11;6;5;36;22;14;10;8;2;;;;;VR28y
254;École doctorale Sciences de la matière;;3;Sciences de la terre et de l'univers, espace;2017;2016-17;2016;2016;18;5;13;60;20;40;9;3;6;;;;;365F2
269;École doctorale Mathématiques, sciences de l'information et de l'ingénieur;MSII;7;Sciences de la société;2017;2016-17;2016;2016;0;0;0;0;0;0;1;1;0;;;;;5E625
269;École doctorale Mathématiques, sciences de l'information et de l'ingénieur;MSII;10;Sciences agronomiques et écologiques;2017;2016-17;2016;2016;0;0;0;0;0;0;1;0;1;;;;;5E625
280;École doctorale Philosophie;;6;Sciences humaines et humanités;2017;2016-17;2016;2016;34;10;24;245;92;153;29;12;17;;;;;kJxnm
304;École doctorale Sciences et environnements;;6;Sciences humaines et humanités;2017;2016-17;2016;2016;2;1;1;14;7;7;5;0;5;;;;;2ywZn
304;École doctorale Sciences et environnements;;10;Sciences agronomiques et écologiques;2017;2016-17;2016;2016;25;11;14;63;32;31;19;9;10;;;;;2ywZn
305;École doctorale Énergie et environnement;E2;9;Sciences et technologies de l'information et de la communication;2017;2016-17;2016;2016;0;0;0;7;3;4;4;3;1;;;;;Kbt8I
340;École doctorale Biologie moléculaire, intégrative et cellulaire;BMIC;5;Biologie, médecine et santé;2017;2016-17;2016;2016;78;44;34;294;184;110;54;26;28;;;;;db7xq
351;École doctorale Sciences physiques, mathématiques et de l'information pour l'ingénieur;SPMII;8;Sciences pour l'ingénieur;2017;2016-17;2016;2016;0;0;0;0;0;0;41;11;30;;;;;rY4EP
355;École doctorale Espaces, cultures, sociétés;;6;Sciences humaines et humanités;2017;2016-17;2016;2016;56;27;29;275;159;116;54;33;21;;;;;2kMf5
356;École doctorale Cognition, langage, éducation;;6;Sciences humaines et humanités;2017;2016-17;2016;2016;75;36;39;314;175;139;47;26;21;;;;;55Cpz
359;École doctorale Mathématiques, télécommunications, informatique, signal, systèmes, électronique;MATISSE;9;Sciences et technologies de l'information et de la communication;2017;2016-17;2016;2016;131;23;108;449;95;354;115;23;92;;;;;Y0r76
361;École doctorale Sciences et Technologies;ED ST;7;Sciences de la société;2017;2016-17;2016;2016;0;0;0;4;0;4;1;0;1;;;;;cOUmL
364;École doctorale Sciences fondamentales et appliquées;EDSFA;2;Physique;2017;2016-17;2016;2016;15;3;12;43;12;31;13;2;11;;;;;E483q
364;École doctorale Sciences fondamentales et appliquées;EDSFA;3;Sciences de la terre et de l'univers, espace;2017;2016-17;2016;2016;9;1;8;60;18;42;23;10;13;;;;;E483q
364;École doctorale Sciences fondamentales et appliquées;EDSFA;10;Sciences agronomiques et écologiques;2017;2016-17;2016;2016;2;2;0;9;6;3;4;3;1;;;;;E483q
370;École doctorale Lettres, sciences humaines et sociales;LSHS;7;Sciences de la société;2017;2016-17;2016;2016;0;0;0;4;3;1;0;0;0;;;;;xAXXx
377;École doctorale Environnement et société;;1;Mathématiques et leurs interactions;2017;2016-17;2016;2016;1;1;0;3;2;1;0;0;0;;;;;ZMG5u
377;École doctorale Environnement et société;;2;Physique;2017;2016-17;2016;2016;0;0;0;0;0;0;2;0;2;;;;;ZMG5u
377;École doctorale Environnement et société;;3;Sciences de la terre et de l'univers, espace;2017;2016-17;2016;2016;1;0;1;1;0;1;1;0;1;;;;;ZMG5u
377;École doctorale Environnement et société;;5;Biologie, médecine et santé;2017;2016-17;2016;2016;0;0;0;0;0;0;1;1;0;;;;;ZMG5u
388;École doctorale Chimie physique et chimie analytique de Paris centre;CPCA;4;Chimie;2017;2016-17;2016;2016;58;22;36;274;123;151;74;35;39;;;;;M0Hnd
391;École doctorale Sciences mécaniques, acoustique et électronique et robotique de Paris;SMAER;8;Sciences pour l'ingénieur;2017;2016-17;2016;2016;53;9;44;182;45;137;60;9;51;;;;;k0eue
396;École doctorale Économie, organisations, société;EOS;7;Sciences de la société;2017;2016-17;2016;2016;47;17;30;217;92;125;42;25;17;;;;;Es5e7
405;École doctorale Économie, management,mathématiques et physique de Cergy;EM2C;2;Physique;2017;2016-17;2016;2016;3;2;1;6;2;4;1;0;1;;;;;QbwSB
406;École doctorale Chimie moléculaire de Paris centre;;4;Chimie;2017;2016-17;2016;2016;38;16;22;113;44;69;24;2;22;;;;;a5dKy
409;École doctorale Énergie, mécanique, matériaux;EMMA;4;Chimie;2017;2016-17;2016;2016;43;11;32;129;36;93;21;8;13;;;;;KXlbK
410;École doctorale Sciences et ingénierie des ressources, procédés, produits, environnement;RP2E;4;Chimie;2017;2016-17;2016;2016;2;2;0;6;4;2;6;5;1;;;;;Q5fxV
410;École doctorale Sciences et ingénierie des ressources, procédés, produits, environnement;RP2E;10;Sciences agronomiques et écologiques;2017;2016-17;2016;2016;25;13;12;116;66;50;22;15;7;;;;;Q5fxV
413;École doctorale Sciences de la terre et de l'environnement;STE;7;Sciences de la société;2017;2016-17;2016;2016;3;0;3;16;7;9;2;1;1;;;;;u9BA9
417;École doctorale Sciences et Ingénierie;S&I;5;Biologie, médecine et santé;2017;2016-17;2016;2016;0;0;0;9;3;6;4;3;1;;;;;SSBvE
441;École doctorale Histoire de l'art;;6;Sciences humaines et humanités;2017;2016-17;2016;2016;32;24;8;198;137;61;18;15;3;;;;;d5W3U
450;École doctorale Recherches en psychanalyse et psychopathologie;PSY²;6;Sciences humaines et humanités;2017;2016-17;2016;2016;50;32;18;220;141;79;33;20;13;;;;;8jI3f
454;École doctorale Sciences de l'homme, du politique et du territoire;SHPT;6;Sciences humaines et humanités;2017;2016-17;2016;2016;40;19;21;211;106;105;29;18;11;;;;;Opv31
463;École doctorale Sciences du mouvement humain;SMH;6;Sciences humaines et humanités;2017;2016-17;2016;2016;2;1;1;24;12;12;9;5;4;;;;;UbtlY
467;École doctorale Aéronautique, astronautique;AA;5;Biologie, médecine et santé;2017;2016-17;2016;2016;3;2;1;7;5;2;0;0;0;;;;;U7l45
467;École doctorale Aéronautique, astronautique;AA;8;Sciences pour l'ingénieur;2017;2016-17;2016;2016;4;0;4;18;3;15;1;0;1;;;;;U7l45
474;École doctorale Interdisciplinaire européenne frontières du vivant;FDV;5;Biologie, médecine et santé;2017;2016-17;2016;2016;20;11;9;90;39;51;21;11;10;;;;;E727j
475;École doctorale Mathématiques, informatique, télécommunications de Toulouse;MITT;9;Sciences et technologies de l'information et de la communication;2017;2016-17;2016;2016;65;15;50;293;77;216;65;23;42;;;;;xcp2r
476;École doctorale Neurosciences et cognition;NSCO;6;Sciences humaines et humanités;2017;2016-17;2016;2016;6;1;5;33;19;14;6;3;3;;;;;B1H0x
480;École doctorale Montaigne-humanités;;3;Sciences de la terre et de l'univers, espace;2017;2016-17;2016;2016;3;1;2;28;9;19;8;5;3;;;;;f3SeZ
481;École doctorale Sciences sociales et humanités;SSH;7;Sciences de la société;2017;2016-17;2016;2016;41;19;22;177;85;92;19;9;10;;;;;E3z5j
482;École doctorale Sciences de la matière;SDM;2;Physique;2017;2016-17;2016;2016;18;6;12;89;27;62;36;10;26;;;;;kmeZ4
485;École doctorale Éducation, Psychologie, Information et Communication;EPIC;9;Sciences et technologies de l'information et de la communication;2017;2016-17;2016;2016;5;4;1;31;18;13;4;2;2;;;;;O82eL
486;École doctorale Sciences économiques et de gestion;SEG;1;Mathématiques et leurs interactions;2017;2016-17;2016;2016;0;0;0;0;0;0;1;0;1;;;;;h1GZ3
488;École doctorale Sciences, ingénierie, santé;SIS;3;Sciences de la terre et de l'univers, espace;2017;2016-17;2016;2016;2;0;2;23;9;14;6;4;2;;;;;Fy2lK
489;École doctorale Sciences et ingénierie des systèmes, de l'environnement et des organisations;SISEO;3;Sciences de la terre et de l'univers, espace;2017;2016-17;2016;2016;8;4;4;20;12;8;7;5;2;;;;;6pT77
489;École doctorale Sciences et ingénierie des systèmes, de l'environnement et des organisations;SISEO;5;Biologie, médecine et santé;2017;2016-17;2016;2016;1;0;1;5;0;5;1;0;1;;;;;6pT77
489;École doctorale Sciences et ingénierie des systèmes, de l'environnement et des organisations;SISEO;9;Sciences et technologies de l'information et de la communication;2017;2016-17;2016;2016;2;1;1;19;10;9;2;0;2;;;;;6pT77
496;École doctorale Sociétés, cultures, échanges;SCE;6;Sciences humaines et humanités;2017;2016-17;2016;2016;56;36;20;295;176;119;35;20;15;;;;;633tC
497;École doctorale Normande de Biologie Intégrative, Santé, Environnement;Ed NBISE;5;Biologie, médecine et santé;2017;2016-17;2016;2016;70;43;27;258;133;125;66;32;34;;;;;0D9Je
498;École doctorale Sciences pour l'ingénieur, géosciences, architecture;SPIGA;3;Sciences de la terre et de l'univers, espace;2017;2016-17;2016;2016;5;3;2;17;10;7;8;3;5;;;;;0vlKH
498;École doctorale Sciences pour l'ingénieur, géosciences, architecture;SPIGA;8;Sciences pour l'ingénieur;2017;2016-17;2016;2016;82;19;63;376;105;271;84;21;63;;;;;0vlKH
502;École doctorale Biologie - Santé;;10;Sciences agronomiques et écologiques;2017;2016-17;2016;2016;0;0;0;1;0;1;0;0;0;;;;;JCFV7
503;École doctorale Sciences et technologies de l'information et de mathématiques;STIM;9;Sciences et technologies de l'information et de la communication;2017;2016-17;2016;2016;54;12;42;219;57;162;63;8;55;;;;;JQevP
508;École doctorale Normande de chimie;EDNC;10;Sciences agronomiques et écologiques;2017;2016-17;2016;2016;0;0;0;1;1;0;0;0;0;;;;;E52OO
509;École doctorale Civilisations et sociétés euro-méditerranéennes et comparées;;6;Sciences humaines et humanités;2017;2016-17;2016;2016;9;6;3;54;32;22;3;1;2;;;;;9tbyG
510;École doctorale Ingénierie - Matériaux, mécanique, environnement, énergétique, procédés, production;IMEP2;3;Sciences de la terre et de l'univers, espace;2017;2016-17;2016;2016;0;0;0;1;0;1;1;0;1;;;;;Ce7NF
510;École doctorale Ingénierie - Matériaux, mécanique, environnement, énergétique, procédés, production;IMEP2;4;Chimie;2017;2016-17;2016;2016;7;4;3;55;22;33;15;9;6;;;;;Ce7NF
513;École doctorale Droit et sciences politiques, économiques et de gestion;DESPEG;7;Sciences de la société;2017;2016-17;2016;2016;52;29;23;289;149;140;36;17;19;;;;;aVHGU
521;École doctorale Sciences et ingénierie pour l'information, mathématiques;S2I;1;Mathématiques et leurs interactions;2017;2016-17;2016;2016;11;4;7;47;15;32;7;4;3;;;;;V6i83
521;École doctorale Sciences et ingénierie pour l'information, mathématiques;S2I;9;Sciences et technologies de l'information et de la communication;2017;2016-17;2016;2016;32;6;26;103;21;82;38;6;32;;;;;V6i83
523;École doctorale Sciences pour l'environnement - Gay Lussac;;8;Sciences pour l'ingénieur;2017;2016-17;2016;2016;0;0;0;1;1;0;1;0;1;;;;;6xD69
523;École doctorale Sciences pour l'environnement - Gay Lussac;;10;Sciences agronomiques et écologiques;2017;2016-17;2016;2016;16;10;6;60;27;33;12;9;3;;;;;6xD69
527;École doctorale Cognition, comportement, langage(s);CCL;6;Sciences humaines et humanités;2017;2016-17;2016;2016;18;10;8;74;41;33;23;12;11;;;;;MvpY8
527;École doctorale Cognition, comportement, langage(s);CCL;7;Sciences de la société;2017;2016-17;2016;2016;0;0;0;1;1;0;0;0;0;;;;;MvpY8
527;École doctorale Cognition, comportement, langage(s);CCL;9;Sciences et technologies de l'information et de la communication;2017;2016-17;2016;2016;0;0;0;10;7;3;0;0;0;;;;;MvpY8
531;École doctorale Sciences, ingénierie et environnement;SIE;2;Physique;2017;2016-17;2016;2016;8;1;7;25;5;20;11;5;6;;;;;b5BYq
531;École doctorale Sciences, ingénierie et environnement;SIE;3;Sciences de la terre et de l'univers, espace;2017;2016-17;2016;2016;9;6;3;31;17;14;15;6;9;;;;;b5BYq
531;École doctorale Sciences, ingénierie et environnement;SIE;8;Sciences pour l'ingénieur;2017;2016-17;2016;2016;54;19;35;205;71;134;45;12;33;;;;;b5BYq
531;École doctorale Sciences, ingénierie et environnement;SIE;10;Sciences agronomiques et écologiques;2017;2016-17;2016;2016;1;0;1;5;3;2;1;1;0;;;;;b5BYq
537;École doctorale Culture et patrimoine;C&P;6;Sciences humaines et humanités;2017;2016-17;2016;2016;13;7;6;81;47;34;13;9;4;;;;;GxI4a
542;École doctorale de sciences de La Réunion;STS;2;Physique;2017;2016-17;2016;2016;6;3;3;22;8;14;4;2;2;;;;;2pAql
542;École doctorale de sciences de La Réunion;STS;3;Sciences de la terre et de l'univers, espace;2017;2016-17;2016;2016;6;3;3;40;19;21;19;7;12;;;;;2pAql
543;École doctorale de Dauphine;;1;Mathématiques et leurs interactions;2017;2016-17;2016;2016;14;0;14;52;8;44;10;4;6;;;;;u8w6A
543;École doctorale de Dauphine;;9;Sciences et technologies de l'information et de la communication;2017;2016-17;2016;2016;7;2;5;39;12;27;4;2;2;;;;;u8w6A
544;École doctorale Inter-Med : Espaces, temps, cultures;INTER-MED;6;Sciences humaines et humanités;2017;2016-17;2016;2016;19;14;5;97;55;42;7;5;2;;;;;7VjtD
544;École doctorale Inter-Med : Espaces, temps, cultures;INTER-MED;7;Sciences de la société;2017;2016-17;2016;2016;27;7;20;138;65;73;19;8;11;;;;;7VjtD
548;École doctorale Mer et Sciences;;1;Mathématiques et leurs interactions;2017;2016-17;2016;2016;5;0;5;19;5;14;5;1;4;;;;;QX0fS
548;École doctorale Mer et Sciences;;9;Sciences et technologies de l'information et de la communication;2017;2016-17;2016;2016;7;3;4;21;10;11;4;3;1;;;;;QX0fS
552;École doctorale Énergie - Matériaux - Sciences de la Terre et de l'Univers;EMTSU;3;Sciences de la terre et de l'univers, espace;2017;2016-17;2016;2016;10;5;5;49;15;34;15;6;9;;;;;NTZhw
553;École doctorale Carnot - Pasteur;;2;Physique;2017;2016-17;2016;2016;12;3;9;45;8;37;13;4;9;;;;;6h4Z7
554;École doctorale Environnements - Santé;E-S;3;Sciences de la terre et de l'univers, espace;2017;2016-17;2016;2016;8;2;6;14;3;11;8;1;7;;;;;ElyFU
554;École doctorale Environnements - Santé;E-S;6;Sciences humaines et humanités;2017;2016-17;2016;2016;4;2;2;16;7;9;4;0;4;;;;;ElyFU
555;École doctorale Sciences de l'Homme et de la Société;SHS;7;Sciences de la société;2017;2016-17;2016;2016;19;5;14;104;37;67;8;3;5;;;;;44G6m
558;École doctorale Histoire, Mémoire, Patrimoine, Langage;HMPL;7;Sciences de la société;2017;2016-17;2016;2016;1;1;0;2;2;0;0;0;0;;;;;uX3jT
559;École doctorale Management Panthéon-Sorbonne;;7;Sciences de la société;2017;2016-17;2016;2016;40;25;15;200;95;105;32;14;18;;;;;4SP7k
560;École doctorale Sciences de la terre et de l'environnement et Physique de l'univers, Paris;STEP'UP;3;Sciences de la terre et de l'univers, espace;2017;2016-17;2016;2016;52;16;36;175;67;108;48;22;26;;;;;Z2VI9
565;École doctorale Droit de la Sorbonne;DS;7;Sciences de la société;2017;2016-17;2016;2016;141;76;65;795;377;418;82;39;43;;;;;aXJ7L
566;École doctorale Sciences du Sport, de la Motricité et du Mouvement Humain;SMMH;7;Sciences de la société;2017;2016-17;2016;2016;1;0;1;1;0;1;1;1;0;;;;;3iv8y
571;École doctorale Sciences Chimiques : Molécules, Matériaux, Instrumentation et Biosystemes;2MIB;2;Physique;2017;2016-17;2016;2016;0;0;0;8;4;4;1;0;1;;;;;zbi37
572;École doctorale Ondes et matière;EDOM;3;Sciences de la terre et de l'univers, espace;2017;2016-17;2016;2016;1;1;0;1;1;0;0;0;0;;;;;etSIi
573;École doctorale Interfaces : Approches Interdisciplinaires, Fondements, Applications et Innovation;ED INTERFACES;1;Mathématiques et leurs interactions;2017;2016-17;2016;2016;4;0;4;29;6;23;9;3;6;;;;;gG820
573;École doctorale Interfaces : Approches Interdisciplinaires, Fondements, Applications et Innovation;ED INTERFACES;9;Sciences et technologies de l'information et de la communication;2017;2016-17;2016;2016;2;0;2;30;8;22;5;1;4;;;;;gG820
575;École doctorale Electrical, Optical, Bio : Physics and Engineering;EOBE;4;Chimie;2017;2016-17;2016;2016;1;0;1;1;0;1;0;0;0;;;;;dfhyn
575;École doctorale Electrical, Optical, Bio : Physics and Engineering;EOBE;9;Sciences et technologies de l'information et de la communication;2017;2016-17;2016;2016;9;1;8;41;9;32;6;0;6;;;;;dfhyn
576;École doctorale Particules, Hadrons, Énergie, Noyau, Instrumentation, Imagerie, Cosmos et Simulation;PHENIICS;5;Biologie, médecine et santé;2017;2016-17;2016;2016;0;0;0;5;3;2;0;0;0;;;;;qC4rf
577;École doctorale Structure et dynamique des systèmes vivants;SDSV;1;Mathématiques et leurs interactions;2017;2016-17;2016;2016;0;0;0;4;2;2;2;1;1;;;;;4bsxJ
578;École doctorale Sciences de l'Homme et de la Société;ED SHS;6;Sciences humaines et humanités;2017;2016-17;2016;2016;39;19;20;185;102;83;41;21;20;;;;;Ud43O
579;École doctorale Sciences mécaniques et energétiques, matériaux et géosciences;SMEMaG;3;Sciences de la terre et de l'univers, espace;2017;2016-17;2016;2016;15;5;10;55;23;32;16;6;10;;;;;atMj7
581;École doctorale Agriculture, alimentation, biologie, environnement, santé;ABIES;6;Sciences humaines et humanités;2017;2016-17;2016;2016;4;3;1;24;12;12;12;5;7;;;;;c1x56
584;École doctorale Biodiversité, Agriculture, Alimentation, Environnement, Terre, Eau;GAIA;5;Biologie, médecine et santé;2017;2016-17;2016;2016;25;12;13;69;36;33;24;14;10;;;;;F1h5f
584;École doctorale Biodiversité, Agriculture, Alimentation, Environnement, Terre, Eau;GAIA;10;Sciences agronomiques et écologiques;2017;2016-17;2016;2016;91;44;47;309;157;152;84;48;36;;;;;F1h5f
586;École doctorale Sciences Humaines et Sociales;EDSHS;7;Sciences de la société;2017;2016-17;2016;2016;17;8;9;93;42;51;13;8;5;;;;;0RKVX
587;École doctorale Diversites, santé et développement en Amazonie;;5;Biologie, médecine et santé;2017;2016-17;2016;2016;8;4;4;37;24;13;4;2;2;;;;;V14tj
591;École doctorale Physique, Sciences de l'Ingenieur, Materiaux, Énergie;PSIME;8;Sciences pour l'ingénieur;2017;2016-17;2016;2016;39;8;31;162;34;128;0;0;0;;;;;Hn5Om
592;École doctorale Lettres, Communication, Langues, Arts;LECLA;9;Sciences et technologies de l'information et de la communication;2017;2016-17;2016;2016;6;1;5;32;13;19;0;0;0;;;;;sY7f3
6;École doctorale Droit privé;;7;Sciences de la société;2015;2014-15;2014;2014;64;24;40;316;155;161;28;9;19;;;;;UMnW1
9;École doctorale Droit international, droit européen, relations internationales et droit comparé;;7;Sciences de la société;2015;2014-15;2014;2014;34;21;13;241;141;100;21;16;5;;;;;v1emR
31;École doctorale Pratiques et théories du sens;;6;Sciences humaines et humanités;2015;2014-15;2014;2014;62;31;31;400;231;169;58;36;22;;;;;1S466
34;École doctorale Matériaux;;2;Physique;2015;2014-15;2014;2014;10;3;7;53;28;25;5;2;3;;;;;1Iufh
39;École doctorale Mathématiques et Informatique;EDMIB;9;Sciences et technologies de l'information et de la communication;2015;2014-15;2014;2014;39;9;30;107;21;86;37;9;28;;;;;TBj2X
40;École doctorale Sciences chimiques;EDSC;4;Chimie;2015;2014-15;2014;2014;84;41;43;273;120;153;77;30;47;;;;;wde3D
47;École doctorale Physique;;2;Physique;2015;2014-15;2014;2014;88;25;63;363;97;266;84;23;61;;;;;8kNpd
47;École doctorale Physique;;3;Sciences de la terre et de l'univers, espace;2015;2014-15;2014;2014;3;0;3;9;2;7;0;0;0;;;;;8kNpd
47;École doctorale Physique;;4;Chimie;2015;2014-15;2014;2014;1;0;1;1;0;1;0;0;0;;;;;8kNpd
50;École doctorale Langues, littératures et sciences humaines;LLSH;9;Sciences et technologies de l'information et de la communication;2015;2014-15;2014;2014;5;3;2;52;32;20;3;2;1;;;;;8THzQ
52;École doctorale Physique et astrophysique de Lyon;PHAST;3;Sciences de la terre et de l'univers, espace;2015;2014-15;2014;2014;4;1;3;17;9;8;4;1;3;;;;;61XPb
58;École doctorale Langues, littératures, cultures, civilisations;LLCC;6;Sciences humaines et humanités;2015;2014-15;2014;2014;94;65;29;442;263;179;62;34;28;;;;;I9ATR
60;École doctorale Territoires, temps, sociétés et développement;TTSD;9;Sciences et technologies de l'information et de la communication;2015;2014-15;2014;2014;3;2;1;19;13;6;0;0;0;;;;;fkIh6
65;École doctorale Sciences de la Vie, Santé, Agronomie, Environnement;;5;Biologie, médecine et santé;2015;2014-15;2014;2014;44;23;21;150;90;60;38;27;11;;;;;MAOG4
77;École doctorale Informatique, automatique, électronique, électrotechnique, mathématiques;IAEM;7;Sciences de la société;2015;2014-15;2014;2014;0;0;0;0;0;0;1;0;1;;;;;TCHTA
86;École doctorale Sociétés, humanités, arts, lettres;LSHS;7;Sciences de la société;2015;2014-15;2014;2014;10;5;5;33;23;10;7;5;2;;;;;O8E6y
88;École doctorale Droit et science politique;DSP;7;Sciences de la société;2015;2014-15;2014;2014;62;38;24;348;166;182;38;15;23;;;;;elnAJ
92;École doctorale Vie -  Agro - Santé;;4;Chimie;2015;2014-15;2014;2014;0;0;0;0;0;0;1;1;0;;;;;RjvXY
104;École doctorale Sciences de la matière, du rayonnement et de l'environnement;SMRE;2;Physique;2015;2014-15;2014;2014;23;8;15;58;17;41;9;5;4;;;;;Q5iFz
105;École doctorale Terre, univers, environnement;;3;Sciences de la terre et de l'univers, espace;2015;2014-15;2014;2014;40;16;24;187;78;109;60;21;39;;;;;lcWAf
124;École doctorale Histoire de l'art et archéologie;;6;Sciences humaines et humanités;2015;2014-15;2014;2014;32;22;10;243;157;86;27;21;6;;;;;MBN4L
131;École doctorale Langue, littérature, image, civilisations et sciences humaines (domaines francophone et anglophone);LLI;6;Sciences humaines et humanités;2015;2014-15;2014;2014;31;20;11;241;152;89;32;21;11;;;;;a47aW
138;École doctorale Lettres, langues, spectacles;LLS;6;Sciences humaines et humanités;2015;2014-15;2014;2014;50;35;15;262;172;90;35;20;15;;;;;y9O3k
146;École doctorale Galilée;GALILEE;1;Mathématiques et leurs interactions;2015;2014-15;2014;2014;8;1;7;31;4;27;14;5;9;;;;;71hqm
146;École doctorale Galilée;GALILEE;4;Chimie;2015;2014-15;2014;2014;5;2;3;18;6;12;6;3;3;;;;;71hqm
146;École doctorale Galilée;GALILEE;9;Sciences et technologies de l'information et de la communication;2015;2014-15;2014;2014;12;4;8;43;14;29;17;7;10;;;;;71hqm
146;École doctorale Galilée;GALILEE;10;Sciences agronomiques et écologiques;2015;2014-15;2014;2014;0;0;0;0;0;0;1;0;1;;;;;71hqm
157;École doctorale Génétique, cellulaire, immunologie, infectiologie et développement;GC2ID;5;Biologie, médecine et santé;2015;2014-15;2014;2014;0;0;0;0;0;0;63;41;22;;;;;Sl3l2
166;École doctorale Information, structures et systèmes;I2S;3;Sciences de la terre et de l'univers, espace;2015;2014-15;2014;2014;1;0;1;3;1;2;1;0;1;;;;;2uO68
166;École doctorale Information, structures et systèmes;I2S;8;Sciences pour l'ingénieur;2015;2014-15;2014;2014;27;7;20;90;22;68;20;9;11;;;;;2uO68
171;École doctorale Toulouse sciences économiques;TSE;7;Sciences de la société;2015;2014-15;2014;2014;24;8;16;112;38;74;17;8;9;;;;;Q5nNQ
173;École doctorale Sciences de l'univers, de l'environnement et de l'espace;SDU2E;3;Sciences de la terre et de l'univers, espace;2015;2014-15;2014;2014;72;31;41;284;104;180;53;14;39;;;;;R0Z9c
181;École doctorale Structure, informations, matière et matériaux;Simem;1;Mathématiques et leurs interactions;2015;2014-15;2014;2014;5;1;4;15;5;10;1;0;1;;;;;c1D6f
181;École doctorale Structure, informations, matière et matériaux;Simem;8;Sciences pour l'ingénieur;2015;2014-15;2014;2014;5;0;5;21;4;17;8;2;6;;;;;c1D6f
182;École doctorale Physique et chimie-physique;;4;Chimie;2015;2014-15;2014;2014;19;12;7;71;32;39;8;1;7;;;;;3My6I
205;École doctorale Interdisciplinaire Sciences-Santé;EDISS;4;Chimie;2015;2014-15;2014;2014;1;1;0;2;1;1;0;0;0;;;;;69W38
205;École doctorale Interdisciplinaire Sciences-Santé;EDISS;5;Biologie, médecine et santé;2015;2014-15;2014;2014;73;47;26;257;146;111;45;20;25;;;;;69W38
205;École doctorale Interdisciplinaire Sciences-Santé;EDISS;8;Sciences pour l'ingénieur;2015;2014-15;2014;2014;0;0;0;4;1;3;0;0;0;;;;;69W38
209;École doctorale Sciences physiques et de L'ingénieur;SPI;9;Sciences et technologies de l'information et de la communication;2015;2014-15;2014;2014;40;7;33;130;25;105;33;5;28;;;;;tZcIZ
211;École doctorale Sciences exactes et leurs applications;ED SEA;2;Physique;2015;2014-15;2014;2014;4;1;3;14;3;11;3;1;2;;;;;1G1iC
211;École doctorale Sciences exactes et leurs applications;ED SEA;6;Sciences humaines et humanités;2015;2014-15;2014;2014;0;0;0;2;1;1;0;0;0;;;;;1G1iC
211;École doctorale Sciences exactes et leurs applications;ED SEA;9;Sciences et technologies de l'information et de la communication;2015;2014-15;2014;2014;5;2;3;17;7;10;4;1;3;;;;;1G1iC
216;École doctorale Ingénierie pour la santé, la cognition, l'environnement;EDISCE;1;Mathématiques et leurs interactions;2015;2014-15;2014;2014;4;2;2;4;2;2;0;0;0;;;;;fPs1t
216;École doctorale Ingénierie pour la santé, la cognition, l'environnement;EDISCE;8;Sciences pour l'ingénieur;2015;2014-15;2014;2014;0;0;0;16;7;9;3;2;1;;;;;fPs1t
222;École doctorale Sciences chimiques;EDSC;4;Chimie;2015;2014-15;2014;2014;64;26;38;238;104;134;70;32;38;;;;;AdU8Q
251;École doctorale Sciences de l'environnement;;5;Biologie, médecine et santé;2015;2014-15;2014;2014;3;2;1;10;4;6;4;4;0;;;;;VR28y
254;École doctorale Sciences de la matière;;4;Chimie;2015;2014-15;2014;2014;44;19;25;148;75;73;49;24;25;;;;;365F2
254;École doctorale Sciences de la matière;;8;Sciences pour l'ingénieur;2015;2014-15;2014;2014;12;1;11;45;6;39;12;4;8;;;;;365F2
260;École doctorale pluridisciplinaire;;4;Chimie;2015;2014-15;2014;2014;2;1;1;13;6;7;4;2;2;;;;;sCk1f
260;École doctorale pluridisciplinaire;;6;Sciences humaines et humanités;2015;2014-15;2014;2014;33;24;9;147;103;44;7;5;2;;;;;sCk1f
260;École doctorale pluridisciplinaire;;7;Sciences de la société;2015;2014-15;2014;2014;14;8;6;99;56;43;7;5;2;;;;;sCk1f
261;École doctorale Cognition, comportements, conduites humaines;3CH;6;Sciences humaines et humanités;2015;2014-15;2014;2014;36;26;10;143;114;29;28;20;8;;;;;KOLCy
267;École doctorale Arts et médias;;6;Sciences humaines et humanités;2015;2014-15;2014;2014;60;45;15;348;228;120;44;35;9;;;;;eCF5C
269;École doctorale Mathématiques, sciences de l'information et de l'ingénieur;MSII;8;Sciences pour l'ingénieur;2015;2014-15;2014;2014;41;11;30;179;52;127;39;10;29;;;;;5E625
285;École doctorale Sciences pratiques;;5;Biologie, médecine et santé;2015;2014-15;2014;2014;2;2;0;12;8;4;1;0;1;;;;;Jd3t2
285;École doctorale Sciences pratiques;;8;Sciences pour l'ingénieur;2015;2014-15;2014;2014;34;10;24;132;40;92;29;7;22;;;;;Jd3t2
285;École doctorale Sciences pratiques;;9;Sciences et technologies de l'information et de la communication;2015;2014-15;2014;2014;4;0;4;25;2;23;7;2;5;;;;;Jd3t2
287;École doctorale Sciences pour l'ingénieur;;1;Mathématiques et leurs interactions;2015;2014-15;2014;2014;10;1;9;42;6;36;11;4;7;;;;;48Q1j
287;École doctorale Sciences pour l'ingénieur;;4;Chimie;2015;2014-15;2014;2014;4;2;2;18;8;10;3;0;3;;;;;48Q1j
287;École doctorale Sciences pour l'ingénieur;;9;Sciences et technologies de l'information et de la communication;2015;2014-15;2014;2014;12;3;9;52;24;28;11;8;3;;;;;48Q1j
288;École doctorale Ondes et matière;EDOM;2;Physique;2015;2014-15;2014;2014;37;10;27;141;38;103;52;14;38;;;;;kJrcx
300;École doctorale Sciences Économiques;ED SE;7;Sciences de la société;2015;2014-15;2014;2014;11;3;8;64;21;43;7;2;5;;;;;5x3fM
304;École doctorale Sciences et environnements;;3;Sciences de la terre et de l'univers, espace;2015;2014-15;2014;2014;5;3;2;29;20;9;7;4;3;;;;;2ywZn
304;École doctorale Sciences et environnements;;10;Sciences agronomiques et écologiques;2015;2014-15;2014;2014;18;11;7;64;33;31;15;7;8;;;;;2ywZn
305;École doctorale Énergie et environnement;E2;1;Mathématiques et leurs interactions;2015;2014-15;2014;2014;1;0;1;5;0;5;1;0;1;;;;;Kbt8I
305;École doctorale Énergie et environnement;E2;4;Chimie;2015;2014-15;2014;2014;5;3;2;7;5;2;2;1;1;;;;;Kbt8I
305;École doctorale Énergie et environnement;E2;8;Sciences pour l'ingénieur;2015;2014-15;2014;2014;10;2;8;41;12;29;11;4;7;;;;;Kbt8I
323;École doctorale Génie électrique, électronique et télécommunications;GEET;5;Biologie, médecine et santé;2015;2014-15;2014;2014;2;0;2;14;7;7;3;3;0;;;;;arcz6
351;École doctorale Sciences physiques, mathématiques et de l'information pour l'ingénieur;SPMII;9;Sciences et technologies de l'information et de la communication;2015;2014-15;2014;2014;22;6;16;101;36;65;24;6;18;;;;;rY4EP
353;École doctorale Sciences pour l'ingénieur : mécanique, physique, micro et nanoélectronique;;3;Sciences de la terre et de l'univers, espace;2015;2014-15;2014;2014;0;0;0;6;3;3;2;1;1;;;;;vk5Kp
353;École doctorale Sciences pour l'ingénieur : mécanique, physique, micro et nanoélectronique;;5;Biologie, médecine et santé;2015;2014-15;2014;2014;2;0;2;4;1;3;3;0;3;;;;;vk5Kp
353;École doctorale Sciences pour l'ingénieur : mécanique, physique, micro et nanoélectronique;;8;Sciences pour l'ingénieur;2015;2014-15;2014;2014;16;7;9;124;26;98;25;5;20;;;;;vk5Kp
354;École doctorale Langues, lettres et arts;LLA;6;Sciences humaines et humanités;2015;2014-15;2014;2014;42;27;15;202;134;68;14;8;6;;;;;RwcSv
355;École doctorale Espaces, cultures, sociétés;;6;Sciences humaines et humanités;2015;2014-15;2014;2014;62;39;23;347;214;133;53;35;18;;;;;2kMf5
359;École doctorale Mathématiques, télécommunications, informatique, signal, systèmes, électronique;MATISSE;1;Mathématiques et leurs interactions;2015;2014-15;2014;2014;17;2;15;64;16;48;18;6;12;;;;;Y0r76
359;École doctorale Mathématiques, télécommunications, informatique, signal, systèmes, électronique;MATISSE;9;Sciences et technologies de l'information et de la communication;2015;2014-15;2014;2014;108;18;90;423;97;326;123;28;95;;;;;Y0r76
364;École doctorale Sciences fondamentales et appliquées;EDSFA;3;Sciences de la terre et de l'univers, espace;2015;2014-15;2014;2014;25;7;18;89;28;61;17;5;12;;;;;E483q
373;École doctorale Santé, information/communications et mathématiques, matière;SICMA;2;Physique;2015;2014-15;2014;2014;0;0;0;9;3;6;0;0;0;;;;;hTJF5
377;École doctorale Environnement et société;;6;Sciences humaines et humanités;2015;2014-15;2014;2014;16;9;7;68;46;22;3;2;1;;;;;ZMG5u
377;École doctorale Environnement et société;;9;Sciences et technologies de l'information et de la communication;2015;2014-15;2014;2014;0;0;0;8;1;7;2;0;2;;;;;ZMG5u
377;École doctorale Environnement et société;;10;Sciences agronomiques et écologiques;2015;2014-15;2014;2014;0;0;0;2;1;1;0;0;0;;;;;ZMG5u
378;École doctorale Sciences de l'homme et de la société;SHS;6;Sciences humaines et humanités;2015;2014-15;2014;2014;12;5;7;64;42;22;12;4;8;;;;;3XKuF
382;École doctorale Économie, espaces, sociétés, civilisations : pensée critique, politique et pratique sociale;EESC;6;Sciences humaines et humanités;2015;2014-15;2014;2014;53;31;22;136;83;53;24;16;8;;;;;9NI1W
391;École doctorale Sciences mécaniques, acoustique et électronique et robotique de Paris;SMAER;8;Sciences pour l'ingénieur;2015;2014-15;2014;2014;61;14;47;247;55;192;46;9;37;;;;;k0eue
397;École doctorale Physique et chimie des matériaux;;4;Chimie;2015;2014-15;2014;2014;39;18;21;155;69;86;26;12;14;;;;;WxSt9
400;École doctorale Savoirs scientifiques : épistémologie, histoire des sciences, didactique des disciplines;;1;Mathématiques et leurs interactions;2015;2014-15;2014;2014;8;2;6;36;16;20;6;3;3;;;;;nRax3
402;École doctorale Sciences de la vie et de la santé;SVS;5;Biologie, médecine et santé;2015;2014-15;2014;2014;36;25;11;111;60;51;21;14;7;;;;;YKgsU
412;École doctorale Lorraine de chimie et physique moléculaires : synthèses, expériences, simulations, applications : de la molécule aux édifices supramoléculaires;SESAMES;2;Physique;2015;2014-15;2014;2014;5;2;3;17;8;9;3;1;2;;;;;mvHX2
417;École doctorale Sciences et Ingénierie;S&I;5;Biologie, médecine et santé;2015;2014-15;2014;2014;3;2;1;8;7;1;3;3;0;;;;;SSBvE
435;École doctorale Agriculture, alimentation, biologie, environnement et santé;;10;Sciences agronomiques et écologiques;2015;2014-15;2014;2014;21;14;7;126;71;55;32;16;16;;;;;mC35U
441;École doctorale Histoire de l'art;;6;Sciences humaines et humanités;2015;2014-15;2014;2014;39;31;8;249;181;68;34;27;7;;;;;d5W3U
446;École doctorale Biologie - Santé;EDBSL;5;Biologie, médecine et santé;2015;2014-15;2014;2014;84;42;42;324;169;155;80;41;39;;;;;4iEUF
455;École doctorale Économie, Gestion, Information et Communication;EGIC;7;Sciences de la société;2015;2014-15;2014;2014;28;13;15;89;41;48;10;5;5;;;;;qCOg3
458;École doctorale Sciences écologiques, vétérinaires, agronomiques et bioingénieries;SEVAB;10;Sciences agronomiques et écologiques;2015;2014-15;2014;2014;57;27;30;241;126;115;65;30;35;;;;;Yf3TI
463;École doctorale Sciences du mouvement humain;SMH;5;Biologie, médecine et santé;2015;2014-15;2014;2014;16;9;7;64;24;40;11;3;8;;;;;UbtlY
465;École doctorale Économie Panthéon Sorbonne;EPS;1;Mathématiques et leurs interactions;2015;2014-15;2014;2014;3;2;1;23;10;13;8;1;7;;;;;MV68S
465;École doctorale Économie Panthéon Sorbonne;EPS;7;Sciences de la société;2015;2014-15;2014;2014;68;38;30;340;152;188;71;27;44;;;;;MV68S
467;École doctorale Aéronautique, astronautique;AA;9;Sciences et technologies de l'information et de la communication;2015;2014-15;2014;2014;2;0;2;4;1;3;2;1;1;;;;;U7l45
470;École doctorale Chimie de Paris-Sud;;4;Chimie;2015;2014-15;2014;2014;63;26;37;236;106;130;59;22;37;;;;;aExpW
472;École doctorale de l'EPHE;;6;Sciences humaines et humanités;2015;2014-15;2014;2014;94;54;40;503;264;239;75;36;39;;;;;27zK4
481;École doctorale Sciences sociales et humanités;SSH;7;Sciences de la société;2015;2014-15;2014;2014;28;12;16;159;73;86;15;9;6;;;;;E3z5j
483;École doctorale Histoire, géographie, aménagement, urbanisme, archéologie, science politique, sociologie, anthropologie;SCSO;6;Sciences humaines et humanités;2015;2014-15;2014;2014;75;36;39;485;236;249;39;18;21;;;;;hc6u4
485;École doctorale Éducation, Psychologie, Information et Communication;EPIC;9;Sciences et technologies de l'information et de la communication;2015;2014-15;2014;2014;5;5;0;29;11;18;4;2;2;;;;;O82eL
486;École doctorale Sciences économiques et de gestion;SEG;7;Sciences de la société;2015;2014-15;2014;2014;45;18;27;169;74;95;31;12;19;;;;;h1GZ3
488;École doctorale Sciences, ingénierie, santé;SIS;3;Sciences de la terre et de l'univers, espace;2015;2014-15;2014;2014;9;3;6;27;10;17;7;1;6;;;;;Fy2lK
488;École doctorale Sciences, ingénierie, santé;SIS;4;Chimie;2015;2014-15;2014;2014;1;1;0;15;8;7;3;1;2;;;;;Fy2lK
491;École doctorale Langages, idées, sociétés, institutions, territoires;LISIT;7;Sciences de la société;2015;2014-15;2014;2014;46;20;26;171;77;94;26;12;14;;;;;iB25j
495;École doctorale Végétal, environnement, nutrition, agroalimentaire, mer;VENAM;3;Sciences de la terre et de l'univers, espace;2015;2014-15;2014;2014;2;0;2;7;4;3;1;0;1;;;;;HL495
496;École doctorale Sociétés, cultures, échanges;SCE;6;Sciences humaines et humanités;2015;2014-15;2014;2014;60;35;25;308;188;120;36;24;12;;;;;633tC
497;École doctorale Normande de Biologie Intégrative, Santé, Environnement;Ed NBISE;5;Biologie, médecine et santé;2015;2014-15;2014;2014;79;36;43;256;118;138;56;30;26;;;;;0D9Je
498;École doctorale Sciences pour l'ingénieur, géosciences, architecture;SPIGA;3;Sciences de la terre et de l'univers, espace;2015;2014-15;2014;2014;6;4;2;25;14;11;6;1;5;;;;;0vlKH
498;École doctorale Sciences pour l'ingénieur, géosciences, architecture;SPIGA;6;Sciences humaines et humanités;2015;2014-15;2014;2014;0;0;0;10;6;4;1;1;0;;;;;0vlKH
503;École doctorale Sciences et technologies de l'information et de mathématiques;STIM;6;Sciences humaines et humanités;2015;2014-15;2014;2014;2;1;1;10;5;5;1;0;1;;;;;JQevP
509;École doctorale Civilisations et sociétés euro-méditerranéennes et comparées;;6;Sciences humaines et humanités;2015;2014-15;2014;2014;11;8;3;56;31;25;7;6;1;;;;;9tbyG
510;École doctorale Ingénierie - Matériaux, mécanique, environnement, énergétique, procédés, production;IMEP2;9;Sciences et technologies de l'information et de la communication;2015;2014-15;2014;2014;2;0;2;4;0;4;1;0;1;;;;;Ce7NF
511;École doctorale Sciences et ingénierie;S&I;1;Mathématiques et leurs interactions;2015;2014-15;2014;2014;7;2;5;16;5;11;5;1;4;;;;;7aXuB
512;École doctorale Informatique et mathématiques;InfoMaths;1;Mathématiques et leurs interactions;2015;2014-15;2014;2014;23;5;18;118;31;87;33;12;21;;;;;t86bi
516;École doctorale Biochimie, biothérapies, biologie moléculaire, infectiologie;B3MI;5;Biologie, médecine et santé;2015;2014-15;2014;2014;0;0;0;78;39;39;78;39;39;;;;;aQTO2
519;École doctorale Sciences humaines et sociales - Perspectives européennes;SHS-PE;7;Sciences de la société;2015;2014-15;2014;2014;8;5;3;33;15;18;5;2;3;;;;;2f5qs
520;École doctorale Humanités;;6;Sciences humaines et humanités;2015;2014-15;2014;2014;71;41;30;372;215;157;37;25;12;;;;;rI175
521;École doctorale Sciences et ingénierie pour l'information, mathématiques;S2I;8;Sciences pour l'ingénieur;2015;2014-15;2014;2014;13;4;9;54;12;42;29;4;25;;;;;V6i83
521;École doctorale Sciences et ingénierie pour l'information, mathématiques;S2I;9;Sciences et technologies de l'information et de la communication;2015;2014-15;2014;2014;36;6;30;146;29;117;17;7;10;;;;;V6i83
522;École doctorale Sciences et ingénierie en matériaux, mécanique, énergétique et aéronautique;SI-MMEA;2;Physique;2015;2014-15;2014;2014;8;4;4;27;9;18;7;1;6;;;;;82F19
529;École doctorale Cultures et sociétés;CS;6;Sciences humaines et humanités;2015;2014-15;2014;2014;56;33;23;253;138;115;28;15;13;;;;;XU9tb
531;École doctorale Sciences, ingénierie et environnement;SIE;1;Mathématiques et leurs interactions;2015;2014-15;2014;2014;0;0;0;0;0;0;1;0;1;;;;;b5BYq
531;École doctorale Sciences, ingénierie et environnement;SIE;4;Chimie;2015;2014-15;2014;2014;11;6;5;48;22;26;11;4;7;;;;;b5BYq
531;École doctorale Sciences, ingénierie et environnement;SIE;5;Biologie, médecine et santé;2015;2014-15;2014;2014;1;1;0;3;2;1;1;1;0;;;;;b5BYq
531;École doctorale Sciences, ingénierie et environnement;SIE;10;Sciences agronomiques et écologiques;2015;2014-15;2014;2014;2;2;0;9;5;4;1;1;0;;;;;b5BYq
532;École doctorale Mathématiques et sciences et technologies de l'information et de la communication;MSTIC;1;Mathématiques et leurs interactions;2015;2014-15;2014;2014;18;5;13;79;25;54;14;3;11;;;;;t43KM
534;École doctorale Modélisation et instrumentation en physique, énergie, géosciences et environnement;MIPEGE;2;Physique;2015;2014-15;2014;2014;21;7;14;92;31;61;23;8;15;;;;;K93eR
535;École doctorale Sciences de la société;SDS;7;Sciences de la société;2015;2014-15;2014;2014;41;15;26;120;60;60;14;10;4;;;;;iEUOV
536;École doctorale Sciences et agrosciences;;1;Mathématiques et leurs interactions;2015;2014-15;2014;2014;6;2;4;39;11;28;7;0;7;;;;;pHfqe
536;École doctorale Sciences et agrosciences;;10;Sciences agronomiques et écologiques;2015;2014-15;2014;2014;9;7;2;39;26;13;15;6;9;;;;;pHfqe
537;École doctorale Culture et patrimoine;C&P;7;Sciences de la société;2015;2014-15;2014;2014;13;7;6;79;47;32;10;7;3;;;;;GxI4a
538;École doctorale Culture, régulation, institutions et territoire;CRIT;7;Sciences de la société;2015;2014-15;2014;2014;36;20;16;233;116;117;19;5;14;;;;;8T505
539;École doctorale Sciences et technologies de Versailles;;5;Biologie, médecine et santé;2015;2014-15;2014;2014;0;0;0;1;1;0;1;1;0;;;;;nv3h8
539;École doctorale Sciences et technologies de Versailles;;8;Sciences pour l'ingénieur;2015;2014-15;2014;2014;9;0;9;28;1;27;9;3;6;;;;;nv3h8
541;École doctorale de sciences humaines et sociales de La Réunion;SHS;6;Sciences humaines et humanités;2015;2014-15;2014;2014;30;13;17;163;86;77;11;7;4;;;;;21SpE
541;École doctorale de sciences humaines et sociales de La Réunion;SHS;10;Sciences agronomiques et écologiques;2015;2014-15;2014;2014;0;0;0;0;0;0;1;1;0;;;;;21SpE
542;École doctorale de sciences de La Réunion;STS;5;Biologie, médecine et santé;2015;2014-15;2014;2014;8;4;4;40;18;22;5;3;2;;;;;2pAql
543;École doctorale de Dauphine;;7;Sciences de la société;2015;2014-15;2014;2014;52;24;28;315;158;157;55;28;27;;;;;u8w6A
545;École doctorale Sociétés, politique et santé publique;SP2;6;Sciences humaines et humanités;2015;2014-15;2014;2014;32;18;14;90;54;36;21;10;11;;;;;IAKR4
547;École doctorale Sciences, Technologie, Santé;EDSTS;3;Sciences de la terre et de l'univers, espace;2015;2014-15;2014;2014;1;1;0;5;2;3;2;1;1;;;;;wEdn2
548;École doctorale Mer et Sciences;;6;Sciences humaines et humanités;2015;2014-15;2014;2014;0;0;0;2;0;2;0;0;0;;;;;QX0fS
548;École doctorale Mer et Sciences;;8;Sciences pour l'ingénieur;2015;2014-15;2014;2014;3;0;3;3;0;3;0;0;0;;;;;QX0fS
549;École doctorale Santé, Sciences Biologiques et Chimie du Vivant;SSBCV;5;Biologie, médecine et santé;2015;2014-15;2014;2014;39;24;15;170;105;65;44;22;22;;;;;B9ggO
552;École doctorale Énergie - Matériaux - Sciences de la Terre et de l'Univers;EMTSU;4;Chimie;2015;2014-15;2014;2014;11;6;5;52;20;32;15;4;11;;;;;NTZhw
554;École doctorale Environnements - Santé;E-S;3;Sciences de la terre et de l'univers, espace;2015;2014-15;2014;2014;1;0;1;16;3;13;5;2;3;;;;;ElyFU
559;École doctorale Management Panthéon-Sorbonne;;9;Sciences et technologies de l'information et de la communication;2015;2014-15;2014;2014;4;4;0;15;9;6;7;4;3;;;;;4SP7k
560;École doctorale Sciences de la terre et de l'environnement et Physique de l'univers, Paris;STEP'UP;2;Physique;2015;2014-15;2014;2014;9;0;9;23;2;21;6;0;6;;;;;Z2VI9
560;École doctorale Sciences de la terre et de l'environnement et Physique de l'univers, Paris;STEP'UP;3;Sciences de la terre et de l'univers, espace;2015;2014-15;2014;2014;46;19;27;178;71;107;40;16;24;;;;;Z2VI9
563;École doctorale Médicament - Toxicologie - Chimie - Imageries;MTCI;5;Biologie, médecine et santé;2015;2014-15;2014;2014;45;24;21;147;85;62;35;20;15;;;;;j8uk1
19;École doctorale Littératures françaises et comparée;;6;Sciences humaines et humanités;2020;2019-20;2019;2019;47;28;19;232;134;98;38;26;12;;;;;13M43
37;École doctorale Sciences physiques pour l'ingénieur et microtechniques;SPIM;8;Sciences pour l'ingénieur;2020;2019-20;2019;2019;42;9;33;175;45;130;44;11;33;;;;;F7G1B
47;École doctorale Physique;;4;Chimie;2020;2019-20;2019;2019;1;0;1;5;1;4;0;0;0;;;;;8kNpd
60;École doctorale Territoires, temps, sociétés et développement;TTSD;7;Sciences de la société;2020;2019-20;2019;2019;23;9;14;85;47;38;9;5;4;;;;;fkIh6
62;École doctorale Sciences de la vie et de la santé;;6;Sciences humaines et humanités;2020;2019-20;2019;2019;1;1;0;5;4;1;0;0;0;;;;;vZzE7
65;École doctorale Sciences de la Vie, Santé, Agronomie, Environnement;;10;Sciences agronomiques et écologiques;2020;2019-20;2019;2019;0;0;0;13;6;7;22;11;11;;;;;MAOG4
71;École doctorale Sciences pour l'ingénieur;;1;Mathématiques et leurs interactions;2020;2019-20;2019;2019;2;2;0;14;7;7;2;2;0;;;;;H6UYp
72;École doctorale Sciences pour l'ingénieur;SPI;1;Mathématiques et leurs interactions;2020;2019-20;2019;2019;13;5;8;56;21;35;26;9;17;;;;;47QPx
73;École doctorale Sciences économiques, sociales, de l'aménagement et du management;SESAM;1;Mathématiques et leurs interactions;2020;2019-20;2019;2019;0;0;0;1;1;0;1;0;1;;;;;IQ0Hk
78;École doctorale Sociétés, langages, temps, connaissances;STLC;7;Sciences de la société;2020;2019-20;2019;2019;13;7;6;62;42;20;2;1;1;;;;;vLU3i
86;École doctorale Sociétés, humanités, arts, lettres;LSHS;6;Sciences humaines et humanités;2020;2019-20;2019;2019;61;41;20;233;140;93;34;20;14;;;;;O8E6y
104;École doctorale Sciences de la matière, du rayonnement et de l'environnement;SMRE;2;Physique;2020;2019-20;2019;2019;26;8;18;80;32;48;20;7;13;;;;;Q5iFz
104;École doctorale Sciences de la matière, du rayonnement et de l'environnement;SMRE;3;Sciences de la terre et de l'univers, espace;2020;2019-20;2019;2019;8;6;2;44;23;21;6;2;4;;;;;Q5iFz
119;École doctorale Science politique;;7;Sciences de la société;2020;2019-20;2019;2019;8;3;5;87;44;43;17;6;11;;;;;eyibb
122;École doctorale Europe latine - Amérique latine;;7;Sciences de la société;2020;2019-20;2019;2019;7;5;2;42;28;14;3;0;3;;;;;z9lZY
129;École doctorale Sciences de l'environnement d'Ile de France;SEIF;1;Mathématiques et leurs interactions;2020;2019-20;2019;2019;2;1;1;2;1;1;0;0;0;;;;;TnAPh
138;École doctorale Lettres, langues, spectacles;LLS;6;Sciences humaines et humanités;2020;2019-20;2019;2019;45;31;14;245;159;86;23;13;10;;;;;y9O3k
146;École doctorale Galilée;GALILEE;9;Sciences et technologies de l'information et de la communication;2020;2019-20;2019;2019;18;2;16;55;14;41;16;6;10;;;;;71hqm
151;École doctorale Biologie, santé, biotechnologies;;5;Biologie, médecine et santé;2020;2019-20;2019;2019;88;61;27;389;252;137;71;47;24;;;;;yP8w4
159;École doctorale Esthétique, sciences et technologies des arts;EDESTA;6;Sciences humaines et humanités;2020;2019-20;2019;2019;36;25;11;230;135;95;24;16;8;;;;;zj1Vj
166;École doctorale Information, structures et systèmes;I2S;1;Mathématiques et leurs interactions;2020;2019-20;2019;2019;11;2;9;68;21;47;13;3;10;;;;;2uO68
166;École doctorale Information, structures et systèmes;I2S;5;Biologie, médecine et santé;2020;2019-20;2019;2019;3;1;2;11;3;8;3;3;0;;;;;2uO68
166;École doctorale Information, structures et systèmes;I2S;9;Sciences et technologies de l'information et de la communication;2020;2019-20;2019;2019;26;6;20;98;18;80;29;5;24;;;;;2uO68
171;École doctorale Toulouse sciences économiques;TSE;7;Sciences de la société;2020;2019-20;2019;2019;15;6;9;91;30;61;11;6;5;;;;;Q5nNQ
173;École doctorale Sciences de l'univers, de l'environnement et de l'espace;SDU2E;8;Sciences pour l'ingénieur;2020;2019-20;2019;2019;2;0;2;11;2;9;8;1;7;;;;;R0Z9c
178;École doctorale Sciences fondamentales;;3;Sciences de la terre et de l'univers, espace;2020;2019-20;2019;2019;7;4;3;35;12;23;12;4;8;;;;;1AiR7
188;École doctorale Histoire moderne et contemporaine;;6;Sciences humaines et humanités;2020;2019-20;2019;2019;27;7;20;157;70;87;20;10;10;;;;;RSZ7F
205;École doctorale Interdisciplinaire Sciences-Santé;EDISS;8;Sciences pour l'ingénieur;2020;2019-20;2019;2019;1;1;0;2;1;1;2;0;2;;;;;69W38
206;École doctorale Chimie : chimie, procédés, environnement;;5;Biologie, médecine et santé;2020;2019-20;2019;2019;0;0;0;1;0;1;0;0;0;;;;;m0UhD
211;École doctorale Sciences exactes et leurs applications;ED SEA;5;Biologie, médecine et santé;2020;2019-20;2019;2019;8;4;4;26;17;9;5;4;1;;;;;1G1iC
211;École doctorale Sciences exactes et leurs applications;ED SEA;8;Sciences pour l'ingénieur;2020;2019-20;2019;2019;17;6;11;60;18;42;17;3;14;;;;;1G1iC
216;École doctorale Ingénierie pour la santé, la cognition, l'environnement;EDISCE;1;Mathématiques et leurs interactions;2020;2019-20;2019;2019;3;1;2;7;2;5;0;0;0;;;;;fPs1t
220;École doctorale Électronique, électrotechnique, automatique, traitement du signal;EEATS;1;Mathématiques et leurs interactions;2020;2019-20;2019;2019;1;1;0;8;3;5;3;2;1;;;;;IxEaw
221;École doctorale Augustin Cournot - Sciences économiques et de gestion - Sciences, technologies et sociétés;EDAC;8;Sciences pour l'ingénieur;2020;2019-20;2019;2019;1;1;0;1;1;0;0;0;0;;;;;5z9rW
222;École doctorale Sciences chimiques;EDSC;4;Chimie;2020;2019-20;2019;2019;84;40;44;248;102;146;67;24;43;;;;;AdU8Q
251;École doctorale Sciences de l'environnement;;10;Sciences agronomiques et écologiques;2020;2019-20;2019;2019;16;8;8;45;26;19;6;3;3;;;;;VR28y
269;École doctorale Mathématiques, sciences de l'information et de l'ingénieur;MSII;1;Mathématiques et leurs interactions;2020;2019-20;2019;2019;19;3;16;91;22;69;25;4;21;;;;;5E625
269;École doctorale Mathématiques, sciences de l'information et de l'ingénieur;MSII;2;Physique;2020;2019-20;2019;2019;3;1;2;5;1;4;1;0;1;;;;;5E625
269;École doctorale Mathématiques, sciences de l'information et de l'ingénieur;MSII;6;Sciences humaines et humanités;2020;2019-20;2019;2019;0;0;0;1;1;0;0;0;0;;;;;5E625
269;École doctorale Mathématiques, sciences de l'information et de l'ingénieur;MSII;9;Sciences et technologies de l'information et de la communication;2020;2019-20;2019;2019;18;4;14;56;17;39;15;2;13;;;;;5E625
270;École doctorale Théologie et sciences religieuses;;6;Sciences humaines et humanités;2020;2019-20;2019;2019;25;8;17;114;36;78;18;2;16;;;;;BRKC1
275;École doctorale Sciences de gestion;EDSG;7;Sciences de la société;2020;2019-20;2019;2019;12;8;4;59;32;27;13;11;2;;;;;6QC4I
300;École doctorale Sciences Économiques;ED SE;7;Sciences de la société;2020;2019-20;2019;2019;7;5;2;39;16;23;6;4;2;;;;;5x3fM
304;École doctorale Sciences et environnements;;10;Sciences agronomiques et écologiques;2020;2019-20;2019;2019;14;3;11;47;22;25;18;8;10;;;;;2ywZn
305;École doctorale Énergie et environnement;E2;4;Chimie;2020;2019-20;2019;2019;2;2;0;13;8;5;3;2;1;;;;;Kbt8I
323;École doctorale Génie électrique, électronique et télécommunications;GEET;8;Sciences pour l'ingénieur;2020;2019-20;2019;2019;34;8;26;183;54;129;34;11;23;;;;;arcz6
327;École doctorale Temps, espaces, sociétés, cultures;TESC;6;Sciences humaines et humanités;2020;2019-20;2019;2019;50;30;20;237;132;105;29;17;12;;;;;IjgiJ
328;École doctorale Arts, lettres, langues, philosophie et communication;ALLPH@;6;Sciences humaines et humanités;2020;2019-20;2019;2019;54;35;19;283;182;101;31;17;14;;;;;xLxMh
328;École doctorale Arts, lettres, langues, philosophie et communication;ALLPH@;9;Sciences et technologies de l'information et de la communication;2020;2019-20;2019;2019;12;5;7;34;18;16;4;3;1;;;;;xLxMh
353;École doctorale Sciences pour l'ingénieur : mécanique, physique, micro et nanoélectronique;;2;Physique;2020;2019-20;2019;2019;0;0;0;5;2;3;6;0;6;;;;;vk5Kp
364;École doctorale Sciences fondamentales et appliquées;EDSFA;2;Physique;2020;2019-20;2019;2019;25;4;21;61;12;49;10;3;7;;;;;E483q
370;École doctorale Lettres, sciences humaines et sociales;LSHS;9;Sciences et technologies de l'information et de la communication;2020;2019-20;2019;2019;0;0;0;1;1;0;0;0;0;;;;;xAXXx
396;École doctorale Économie, organisations, société;EOS;6;Sciences humaines et humanités;2020;2019-20;2019;2019;5;4;1;14;6;8;7;1;6;;;;;Es5e7
402;École doctorale Sciences de la vie et de la santé;SVS;8;Sciences pour l'ingénieur;2020;2019-20;2019;2019;1;0;1;1;0;1;0;0;0;;;;;YKgsU
411;École doctorale Humanités nouvelles : Fernand Braudel;;6;Sciences humaines et humanités;2020;2019-20;2019;2019;53;24;29;299;147;152;33;21;12;;;;;l2rFh
417;École doctorale Sciences et Ingénierie;S&I;2;Physique;2020;2019-20;2019;2019;1;1;0;12;5;7;0;0;0;;;;;SSBvE
417;École doctorale Sciences et Ingénierie;S&I;3;Sciences de la terre et de l'univers, espace;2020;2019-20;2019;2019;2;2;0;6;3;3;3;0;3;;;;;SSBvE
417;École doctorale Sciences et Ingénierie;S&I;5;Biologie, médecine et santé;2020;2019-20;2019;2019;4;2;2;14;9;5;1;0;1;;;;;SSBvE
433;École doctorale Concepts et langages;;6;Sciences humaines et humanités;2020;2019-20;2019;2019;9;2;7;216;106;110;16;9;7;;;;;v8q34
446;École doctorale Biologie - Santé;EDBSL;6;Sciences humaines et humanités;2020;2019-20;2019;2019;2;1;1;4;1;3;1;0;1;;;;;4iEUF
455;École doctorale Économie, Gestion, Information et Communication;EGIC;6;Sciences humaines et humanités;2020;2019-20;2019;2019;11;7;4;56;38;18;3;1;2;;;;;qCOg3
459;École doctorale Sciences chimiques Balard;;8;Sciences pour l'ingénieur;2020;2019-20;2019;2019;2;0;2;3;0;3;0;0;0;;;;;YFs2W
460;École doctorale Sciences juridiques;SJ;9;Sciences et technologies de l'information et de la communication;2020;2019-20;2019;2019;0;0;0;2;1;1;0;0;0;;;;;ZB5I5
463;École doctorale Sciences du mouvement humain;SMH;5;Biologie, médecine et santé;2020;2019-20;2019;2019;18;8;10;64;28;36;14;7;7;;;;;UbtlY
467;École doctorale Aéronautique, astronautique;AA;2;Physique;2020;2019-20;2019;2019;0;0;0;2;1;1;2;0;2;;;;;U7l45
467;École doctorale Aéronautique, astronautique;AA;7;Sciences de la société;2020;2019-20;2019;2019;2;1;1;6;3;3;0;0;0;;;;;U7l45
467;École doctorale Aéronautique, astronautique;AA;10;Sciences agronomiques et écologiques;2020;2019-20;2019;2019;0;0;0;0;0;0;1;0;1;;;;;U7l45
469;École doctorale du Pacifique;EDP;4;Chimie;2020;2019-20;2019;2019;0;0;0;9;6;3;0;0;0;;;;;t9Z2n
469;École doctorale du Pacifique;EDP;9;Sciences et technologies de l'information et de la communication;2020;2019-20;2019;2019;0;0;0;3;0;3;1;0;1;;;;;t9Z2n
472;École doctorale de l'EPHE;;3;Sciences de la terre et de l'univers, espace;2020;2019-20;2019;2019;1;1;0;8;4;4;2;2;0;;;;;27zK4
472;École doctorale de l'EPHE;;5;Biologie, médecine et santé;2020;2019-20;2019;2019;14;7;7;38;25;13;12;7;5;;;;;27zK4
473;École doctorale Sciences de l'homme et de la société;SHS;6;Sciences humaines et humanités;2020;2019-20;2019;2019;137;87;50;666;395;271;82;43;39;;;;;8qKD9
475;École doctorale Mathématiques, informatique, télécommunications de Toulouse;MITT;1;Mathématiques et leurs interactions;2020;2019-20;2019;2019;48;8;40;149;40;109;31;8;23;;;;;xcp2r
476;École doctorale Neurosciences et cognition;NSCO;6;Sciences humaines et humanités;2020;2019-20;2019;2019;6;3;3;25;15;10;4;2;2;;;;;B1H0x
480;École doctorale Montaigne-humanités;;2;Physique;2020;2019-20;2019;2019;1;1;0;9;7;2;0;0;0;;;;;f3SeZ
483;École doctorale Histoire, géographie, aménagement, urbanisme, archéologie, science politique, sociologie, anthropologie;SCSO;7;Sciences de la société;2020;2019-20;2019;2019;23;13;10;251;136;115;19;11;8;;;;;hc6u4
485;École doctorale Éducation, Psychologie, Information et Communication;EPIC;9;Sciences et technologies de l'information et de la communication;2020;2019-20;2019;2019;1;0;1;3;2;1;1;1;0;;;;;O82eL
488;École doctorale Sciences, ingénierie, santé;SIS;5;Biologie, médecine et santé;2020;2019-20;2019;2019;20;12;8;72;32;40;16;6;10;;;;;Fy2lK
488;École doctorale Sciences, ingénierie, santé;SIS;9;Sciences et technologies de l'information et de la communication;2020;2019-20;2019;2019;30;11;19;147;44;103;38;10;28;;;;;Fy2lK
489;École doctorale Sciences et ingénierie des systèmes, de l'environnement et des organisations;SISEO;8;Sciences pour l'ingénieur;2020;2019-20;2019;2019;10;5;5;53;22;31;11;1;10;;;;;6pT77
489;École doctorale Sciences et ingénierie des systèmes, de l'environnement et des organisations;SISEO;10;Sciences agronomiques et écologiques;2020;2019-20;2019;2019;2;1;1;10;5;5;2;2;0;;;;;6pT77
497;École doctorale Normande de Biologie Intégrative, Santé, Environnement;Ed NBISE;5;Biologie, médecine et santé;2020;2019-20;2019;2019;73;46;27;302;175;127;79;48;31;;;;;0D9Je
509;École doctorale Civilisations et sociétés euro-méditerranéennes et comparées;;6;Sciences humaines et humanités;2020;2019-20;2019;2019;4;2;2;38;24;14;10;3;7;;;;;9tbyG
510;École doctorale Ingénierie - Matériaux, mécanique, environnement, énergétique, procédés, production;IMEP2;8;Sciences pour l'ingénieur;2020;2019-20;2019;2019;120;31;89;408;137;271;85;29;56;;;;;Ce7NF
513;École doctorale Droit et sciences politiques, économiques et de gestion;DESPEG;7;Sciences de la société;2020;2019-20;2019;2019;46;14;32;277;144;133;37;16;21;;;;;aVHGU
520;École doctorale Humanités;;7;Sciences de la société;2020;2019-20;2019;2019;0;0;0;2;0;2;0;0;0;;;;;rI175
528;École doctorale Ville, transports et territoires;VTT;7;Sciences de la société;2020;2019-20;2019;2019;14;10;4;39;22;17;0;0;0;;;;;68zCc
531;École doctorale Sciences, ingénierie et environnement;SIE;2;Physique;2020;2019-20;2019;2019;6;3;3;16;5;11;9;1;8;;;;;b5BYq
531;École doctorale Sciences, ingénierie et environnement;SIE;4;Chimie;2020;2019-20;2019;2019;10;8;2;45;29;16;14;9;5;;;;;b5BYq
536;École doctorale Sciences et agrosciences;;5;Biologie, médecine et santé;2020;2019-20;2019;2019;2;1;1;19;12;7;4;1;3;;;;;pHfqe
540;"École doctorale École transdisciplinaire ""lettres/sciences""";;8;Sciences pour l'ingénieur;2020;2019-20;2019;2019;0;0;0;1;1;0;1;0;1;;;;;tWWw7
540;"École doctorale École transdisciplinaire ""lettres/sciences""";;1;Mathématiques et leurs interactions;2020;2019-20;2019;2019;0;0;0;1;0;1;0;0;0;;;;;tWWw7
540;"École doctorale École transdisciplinaire ""lettres/sciences""";;3;Sciences de la terre et de l'univers, espace;2020;2019-20;2019;2019;0;0;0;1;0;1;0;0;0;;;;;tWWw7
541;École doctorale de sciences humaines et sociales de La Réunion;SHS;8;Sciences pour l'ingénieur;2020;2019-20;2019;2019;1;1;0;5;3;2;0;0;0;;;;;21SpE
542;École doctorale de sciences de La Réunion;STS;3;Sciences de la terre et de l'univers, espace;2020;2019-20;2019;2019;2;1;1;10;5;5;1;1;0;;;;;2pAql
542;École doctorale de sciences de La Réunion;STS;7;Sciences de la société;2020;2019-20;2019;2019;0;0;0;2;1;1;0;0;0;;;;;2pAql
542;École doctorale de sciences de La Réunion;STS;8;Sciences pour l'ingénieur;2020;2019-20;2019;2019;5;1;4;15;3;12;0;0;0;;;;;2pAql
548;École doctorale Mer et Sciences;;1;Mathématiques et leurs interactions;2020;2019-20;2019;2019;4;1;3;16;5;11;4;0;4;;;;;QX0fS
548;École doctorale Mer et Sciences;;5;Biologie, médecine et santé;2020;2019-20;2019;2019;2;2;0;6;4;2;2;0;2;;;;;QX0fS
549;École doctorale Santé, Sciences Biologiques et Chimie du Vivant;SSBCV;8;Sciences pour l'ingénieur;2020;2019-20;2019;2019;0;0;0;1;1;0;0;0;0;;;;;B9ggO
551;École doctorale Mathématiques, Informatique, Physique Théorique et Ingénierie des Systèmes;MIPTIS;9;Sciences et technologies de l'information et de la communication;2020;2019-20;2019;2019;27;6;21;59;14;45;18;6;12;;;;;Mpudz
551;École doctorale Mathématiques, Informatique, Physique Théorique et Ingénierie des Systèmes;MIPTIS;2;Physique;2020;2019-20;2019;2019;1;0;1;7;0;7;2;0;2;;;;;Mpudz
552;École doctorale Énergie - Matériaux - Sciences de la Terre et de l'Univers;EMTSU;2;Physique;2020;2019-20;2019;2019;14;6;8;47;21;26;7;3;4;;;;;NTZhw
552;École doctorale Énergie - Matériaux - Sciences de la Terre et de l'Univers;EMTSU;3;Sciences de la terre et de l'univers, espace;2020;2019-20;2019;2019;15;6;9;53;21;32;22;5;17;;;;;NTZhw
552;École doctorale Énergie - Matériaux - Sciences de la Terre et de l'Univers;EMTSU;4;Chimie;2020;2019-20;2019;2019;8;7;1;44;26;18;13;5;8;;;;;NTZhw
554;École doctorale Environnements - Santé;E-S;8;Sciences pour l'ingénieur;2020;2019-20;2019;2019;0;0;0;4;3;1;1;1;0;;;;;ElyFU
562;École doctorale Bio Sorbonne Paris Cité;BioSPC;5;Biologie, médecine et santé;2020;2019-20;2019;2019;152;89;63;572;409;163;147;90;57;;;;;4Yju6
569;École doctorale Innovation thérapeutique : du fondamental à l'appliqué;;4;Chimie;2020;2019-20;2019;2019;9;5;4;36;18;18;7;3;4;;;;;jx8ET
570;École doctorale Santé Publique;EDSP;7;Sciences de la société;2020;2019-20;2019;2019;1;0;1;3;1;2;2;1;1;;;;;9lgE4
573;École doctorale Interfaces : Approches Interdisciplinaires, Fondements, Applications et Innovation;ED INTERFACES;5;Biologie, médecine et santé;2020;2019-20;2019;2019;1;0;1;4;2;2;8;5;3;;;;;gG820
576;École doctorale Particules, Hadrons, Énergie, Noyau, Instrumentation, Imagerie, Cosmos et Simulation;PHENIICS;2;Physique;2020;2019-20;2019;2019;47;17;30;155;47;108;54;17;37;;;;;qC4rf
576;École doctorale Particules, Hadrons, Énergie, Noyau, Instrumentation, Imagerie, Cosmos et Simulation;PHENIICS;3;Sciences de la terre et de l'univers, espace;2020;2019-20;2019;2019;1;1;0;4;2;2;1;0;1;;;;;qC4rf
577;École doctorale Structure et dynamique des systèmes vivants;SDSV;1;Mathématiques et leurs interactions;2020;2019-20;2019;2019;0;0;0;3;2;1;1;0;1;;;;;4bsxJ
577;École doctorale Structure et dynamique des systèmes vivants;SDSV;5;Biologie, médecine et santé;2020;2019-20;2019;2019;62;36;26;206;118;88;55;33;22;;;;;4bsxJ
578;École doctorale Sciences de l'Homme et de la Société;ED SHS;5;Biologie, médecine et santé;2020;2019-20;2019;2019;0;0;0;2;0;2;2;1;1;;;;;Ud43O
579;École doctorale Sciences mécaniques et energétiques, matériaux et géosciences;SMEMaG;2;Physique;2020;2019-20;2019;2019;5;0;5;26;1;25;10;4;6;;;;;atMj7
579;École doctorale Sciences mécaniques et energétiques, matériaux et géosciences;SMEMaG;8;Sciences pour l'ingénieur;2020;2019-20;2019;2019;55;9;46;213;58;155;87;19;68;;;;;atMj7
583;École doctorale Risques et Société;;3;Sciences de la terre et de l'univers, espace;2020;2019-20;2019;2019;2;2;0;5;2;3;0;0;0;;;;;wUBi9
584;École doctorale Biodiversité, Agriculture, Alimentation, Environnement, Terre, Eau;GAIA;8;Sciences pour l'ingénieur;2020;2019-20;2019;2019;1;1;0;11;8;3;24;12;12;;;;;F1h5f
585;École doctorale Sciences, Technologie,  Sante;EDSTS;4;Chimie;2020;2019-20;2019;2019;15;7;8;47;22;25;11;5;6;;;;;NM3Dl
585;École doctorale Sciences, Technologie,  Sante;EDSTS;8;Sciences pour l'ingénieur;2020;2019-20;2019;2019;11;3;8;44;12;32;8;5;3;;;;;NM3Dl
588;École doctorale Milieu insulaire tropical : dynamiques de développement, sociétés, patrimoine et culture dans l'espace Caraïbes-Amériques;;6;Sciences humaines et humanités;2020;2019-20;2019;2019;26;20;6;134;83;51;7;6;1;;;;;4W5IO
589;École doctorale Milieu insulaire tropical à risques : protection, valorisation , santé et développement;;1;Mathématiques et leurs interactions;2020;2019-20;2019;2019;4;0;4;12;4;8;2;1;1;;;;;2cqi3
593;École doctorale Droit, Gestion, sciences Économiques et Politique;DGEP;7;Sciences de la société;2020;2019-20;2019;2019;44;15;29;229;85;144;21;11;10;;;;;41pAm
597;École doctorale Sciences économiques et sciences de Gestion;EDGE;7;Sciences de la société;2020;2019-20;2019;2019;39;15;24;199;79;120;51;26;25;;;;;d8Zuu
598;École doctorale Sciences de La Mer et du Littoral;SML;7;Sciences de la société;2020;2019-20;2019;2019;4;2;2;17;8;9;4;3;1;;;;;Smen6
605;École doctorale Biologie Santé;ED BS;5;Biologie, médecine et santé;2020;2019-20;2019;2019;133;70;63;560;308;252;135;67;68;;;;;w8CxU
605;École doctorale Biologie Santé;ED BS;9;Sciences et technologies de l'information et de la communication;2020;2019-20;2019;2019;1;0;1;1;0;1;0;0;0;;;;;w8CxU
607;École doctorale Sciences et Ingénierie des Ressources Naturelles;SIReNA;8;Sciences pour l'ingénieur;2020;2019-20;2019;2019;7;0;7;18;4;14;3;0;3;;;;;vi9w2
608;École doctorale Sciences et Ingénierie des Molécules, des Produits, des Procédés et de l'Énergie;SIMPPÉ;4;Chimie;2020;2019-20;2019;2019;2;2;0;9;6;3;1;1;0;;;;;TyNjM
609;École doctorale Sciences et Ingénierie des Matériaux, Mécanique, Énergétique -;SIMME;4;Chimie;2020;2019-20;2019;2019;9;2;7;27;13;14;15;3;12;;;;;N4Rjy
609;École doctorale Sciences et Ingénierie des Matériaux, Mécanique, Énergétique -;SIMME;8;Sciences pour l'ingénieur;2020;2019-20;2019;2019;36;10;26;163;43;120;50;12;38;;;;;N4Rjy
610;École doctorale Sciences et Ingénierie des Systèmes, Mathématiques, Informatique;SISMI;2;Physique;2020;2019-20;2019;2019;2;0;2;12;3;9;5;0;5;;;;;dBCUB
612;École doctorale Humanités;;6;Sciences humaines et humanités;2020;2019-20;2019;2019;57;31;26;270;144;126;37;26;11;;;;;v30I8
617;École doctorale Sciences de la Société : Territoires, Economie et Droit;SSTED;6;Sciences humaines et humanités;2020;2019-20;2019;2019;24;13;11;81;32;49;10;5;5;;;;;Kl9ZX
618;École doctorale EUCLIDE;;4;Chimie;2020;2019-20;2019;2019;2;0;2;18;8;10;5;1;4;;;;;qveTN
618;École doctorale EUCLIDE;;8;Sciences pour l'ingénieur;2020;2019-20;2019;2019;11;7;4;44;17;27;7;3;4;;;;;qveTN
618;École doctorale EUCLIDE;;10;Sciences agronomiques et écologiques;2020;2019-20;2019;2019;9;7;2;45;25;20;7;3;4;;;;;qveTN
619;École doctorale Sciences Fondamentales et Santé;SFS;1;Mathématiques et leurs interactions;2020;2019-20;2019;2019;1;0;1;3;1;2;1;1;0;;;;;JiZVW
619;École doctorale Sciences Fondamentales et Santé;SFS;9;Sciences et technologies de l'information et de la communication;2020;2019-20;2019;2019;0;0;0;1;1;0;0;0;0;;;;;JiZVW
623;École doctorale Savoir, Sciences, Éducation;SSE;6;Sciences humaines et humanités;2020;2019-20;2019;2019;8;6;2;41;33;8;4;3;1;;;;;98lMD
626;École doctorale de l’Institut Polytechnique de Paris;;3;Sciences de la terre et de l'univers, espace;2020;2019-20;2019;2019;6;2;4;13;4;9;0;0;0;;;;;DL5fO
626;École doctorale de l’Institut Polytechnique de Paris;;4;Chimie;2020;2019-20;2019;2019;11;7;4;40;18;22;2;0;2;;;;;DL5fO
8;École doctorale Histoire du droit, philosophie du droit et sociologie du droit;;7;Sciences de la société;2012;2011-12;2011;2011;14;5;9;67;28;39;11;3;8;;;;;pGSed
9;École doctorale Droit international, droit européen, relations internationales et droit comparé;;7;Sciences de la société;2012;2011-12;2011;2011;49;31;18;236;134;102;15;10;5;;;;;v1emR
19;École doctorale Littératures françaises et comparée;;6;Sciences humaines et humanités;2012;2011-12;2011;2011;71;48;23;334;233;101;54;40;14;;;;;13M43
38;École doctorale Langages, espaces, temps, sociétés;;7;Sciences de la société;2012;2011-12;2011;2011;7;7;0;32;20;12;5;3;2;;;;;pGgDX
40;École doctorale Sciences chimiques;EDSC;4;Chimie;2012;2011-12;2011;2011;71;30;41;281;118;163;82;48;34;;;;;wde3D
52;École doctorale Physique et astrophysique de Lyon;PHAST;2;Physique;2012;2011-12;2011;2011;34;12;22;134;34;100;29;7;22;;;;;61XPb
58;École doctorale Langues, littératures, cultures, civilisations;LLCC;6;Sciences humaines et humanités;2012;2011-12;2011;2011;127;72;55;480;276;204;68;37;31;;;;;I9ATR
65;École doctorale Sciences de la Vie, Santé, Agronomie, Environnement;;10;Sciences agronomiques et écologiques;2012;2011-12;2011;2011;25;13;12;99;60;39;29;11;18;;;;;MAOG4
71;École doctorale Sciences pour l'ingénieur;;8;Sciences pour l'ingénieur;2012;2011-12;2011;2011;46;17;29;176;73;103;38;12;26;;;;;H6UYp
71;École doctorale Sciences pour l'ingénieur;;9;Sciences et technologies de l'information et de la communication;2012;2011-12;2011;2011;18;3;15;79;25;54;20;5;15;;;;;H6UYp
72;École doctorale Sciences pour l'ingénieur;SPI;8;Sciences pour l'ingénieur;2012;2011-12;2011;2011;99;24;75;314;70;244;65;14;51;;;;;47QPx
78;École doctorale Sociétés, langages, temps, connaissances;STLC;6;Sciences humaines et humanités;2012;2011-12;2011;2011;63;30;33;224;119;105;32;20;12;;;;;vLU3i
92;École doctorale Vie -  Agro - Santé;;1;Mathématiques et leurs interactions;2012;2011-12;2011;2011;1;0;1;2;0;2;0;0;0;;;;;RjvXY
102;École doctorale Santé, sciences, technologies;;1;Mathématiques et leurs interactions;2012;2011-12;2011;2011;1;0;1;13;4;9;5;1;4;;;;;4h65n
102;École doctorale Santé, sciences, technologies;;2;Physique;2012;2011-12;2011;2011;1;0;1;8;1;7;0;0;0;;;;;4h65n
102;École doctorale Santé, sciences, technologies;;10;Sciences agronomiques et écologiques;2012;2011-12;2011;2011;0;0;0;3;2;1;15;6;9;;;;;4h65n
112;École doctorale Archéologie;;6;Sciences humaines et humanités;2012;2011-12;2011;2011;50;34;16;340;208;132;19;11;8;;;;;EvU7R
130;École doctorale Informatique, télécommunications et électronique de Paris;EDITE;9;Sciences et technologies de l'information et de la communication;2012;2011-12;2011;2011;198;59;139;863;245;618;175;43;132;;;;;O5ysj
141;École doctorale Droit et science politique;DSP;7;Sciences de la société;2012;2011-12;2011;2011;47;18;29;320;142;178;18;8;10;;;;;CyNBf
146;École doctorale Galilée;GALILEE;1;Mathématiques et leurs interactions;2012;2011-12;2011;2011;9;2;7;49;11;38;12;2;10;;;;;71hqm
146;École doctorale Galilée;GALILEE;5;Biologie, médecine et santé;2012;2011-12;2011;2011;12;9;3;62;37;25;12;8;4;;;;;71hqm
156;École doctorale Sciences de la mer;;6;Sciences humaines et humanités;2012;2011-12;2011;2011;1;1;0;9;5;4;3;2;1;;;;;EGY9P
156;École doctorale Sciences de la mer;;8;Sciences pour l'ingénieur;2012;2011-12;2011;2011;11;1;10;28;3;25;4;1;3;;;;;EGY9P
160;École doctorale Électronique, électrotechnique, automatique;EEA;8;Sciences pour l'ingénieur;2012;2011-12;2011;2011;23;8;15;92;16;76;30;7;23;;;;;EgfMQ
166;École doctorale Information, structures et systèmes;I2S;10;Sciences agronomiques et écologiques;2012;2011-12;2011;2011;1;0;1;1;0;1;0;0;0;;;;;2uO68
181;École doctorale Structure, informations, matière et matériaux;Simem;4;Chimie;2012;2011-12;2011;2011;18;4;14;52;16;36;16;4;12;;;;;c1D6f
216;École doctorale Ingénierie pour la santé, la cognition, l'environnement;EDISCE;9;Sciences et technologies de l'information et de la communication;2012;2011-12;2011;2011;14;5;9;43;16;27;5;2;3;;;;;fPs1t
216;École doctorale Ingénierie pour la santé, la cognition, l'environnement;EDISCE;10;Sciences agronomiques et écologiques;2012;2011-12;2011;2011;1;0;1;5;4;1;0;0;0;;;;;fPs1t
218;École doctorale Chimie et sciences du vivant;EDCSV;4;Chimie;2012;2011-12;2011;2011;21;12;9;91;43;48;21;10;11;;;;;8bcJh
218;École doctorale Chimie et sciences du vivant;EDCSV;10;Sciences agronomiques et écologiques;2012;2011-12;2011;2011;4;2;2;18;8;10;3;0;3;;;;;8bcJh
222;École doctorale Sciences chimiques;EDSC;5;Biologie, médecine et santé;2012;2011-12;2011;2011;1;0;1;5;2;3;2;1;1;;;;;AdU8Q
227;École doctorale Sciences de la nature et de l'homme;;4;Chimie;2012;2011-12;2011;2011;1;1;0;3;3;0;0;0;0;;;;;xiDA5
227;École doctorale Sciences de la nature et de l'homme;;5;Biologie, médecine et santé;2012;2011-12;2011;2011;19;9;10;75;42;33;22;12;10;;;;;xiDA5
227;École doctorale Sciences de la nature et de l'homme;;9;Sciences et technologies de l'information et de la communication;2012;2011-12;2011;2011;0;0;0;1;1;0;1;1;0;;;;;xiDA5
245;École doctorale Sciences économiques, juridiques, politiques et de gestion;;7;Sciences de la société;2012;2011-12;2011;2011;32;12;20;199;77;122;29;9;20;;;;;ShLUg
249;École doctorale Droit comparé;;7;Sciences de la société;2012;2011-12;2011;2011;27;14;13;138;77;61;16;6;10;;;;;yu36C
260;École doctorale pluridisciplinaire;;4;Chimie;2012;2011-12;2011;2011;1;0;1;11;5;6;2;1;1;;;;;sCk1f
260;École doctorale pluridisciplinaire;;10;Sciences agronomiques et écologiques;2012;2011-12;2011;2011;1;0;1;19;15;4;2;1;1;;;;;sCk1f
261;École doctorale Cognition, comportements, conduites humaines;3CH;6;Sciences humaines et humanités;2012;2011-12;2011;2011;37;28;9;128;94;34;38;27;11;;;;;KOLCy
263;École doctorale Sciences juridiques, économiques et de gestion;;7;Sciences de la société;2012;2011-12;2011;2011;42;20;22;167;92;75;33;17;16;;;;;1nUr6
266;École doctorale Biologie, santé, environnement;BIOSE;5;Biologie, médecine et santé;2012;2011-12;2011;2011;47;25;22;189;106;83;44;27;17;;;;;386V9
267;École doctorale Arts et médias;;6;Sciences humaines et humanités;2012;2011-12;2011;2011;78;57;21;318;234;84;32;18;14;;;;;eCF5C
269;École doctorale Mathématiques, sciences de l'information et de l'ingénieur;MSII;9;Sciences et technologies de l'information et de la communication;2012;2011-12;2011;2011;1;1;0;3;2;1;1;0;1;;;;;5E625
270;École doctorale Théologie et sciences religieuses;;7;Sciences de la société;2012;2011-12;2011;2011;0;0;0;10;1;9;0;0;0;;;;;BRKC1
273;École doctorale Biologie et biotechnologie;B2T;5;Biologie, médecine et santé;2012;2011-12;2011;2011;63;38;25;246;152;94;46;26;20;;;;;Wtta6
282;École doctorale Droit privé;;7;Sciences de la société;2012;2011-12;2011;2011;61;30;31;315;169;146;28;10;18;;;;;Gz5rp
283;École doctorale Droit international et européen;;7;Sciences de la société;2012;2011-12;2011;2011;38;22;16;181;103;78;7;2;5;;;;;uIq4K
285;École doctorale Sciences pratiques;;8;Sciences pour l'ingénieur;2012;2011-12;2011;2011;25;3;22;127;26;101;32;7;25;;;;;Jd3t2
286;École doctorale de l'Ehess;;7;Sciences de la société;2012;2011-12;2011;2011;153;86;67;694;392;302;83;35;48;;;;;2S146
287;École doctorale Sciences pour l'ingénieur;;4;Chimie;2012;2011-12;2011;2011;3;0;3;15;6;9;2;0;2;;;;;48Q1j
287;École doctorale Sciences pour l'ingénieur;;9;Sciences et technologies de l'information et de la communication;2012;2011-12;2011;2011;3;1;2;42;18;24;9;5;4;;;;;48Q1j
300;École doctorale Sciences Économiques;ED SE;7;Sciences de la société;2012;2011-12;2011;2011;13;5;8;83;32;51;12;7;5;;;;;5x3fM
304;École doctorale Sciences et environnements;;4;Chimie;2012;2011-12;2011;2011;0;0;0;4;3;1;0;0;0;;;;;2ywZn
305;École doctorale Énergie et environnement;E2;4;Chimie;2012;2011-12;2011;2011;1;0;1;13;3;10;1;1;0;;;;;Kbt8I
305;École doctorale Énergie et environnement;E2;9;Sciences et technologies de l'information et de la communication;2012;2011-12;2011;2011;1;0;1;5;0;5;1;0;1;;;;;Kbt8I
306;École doctorale Sciences des procédés, sciences des aliments;;3;Sciences de la terre et de l'univers, espace;2012;2011-12;2011;2011;0;0;0;1;1;0;0;0;0;;;;;adF7W
323;École doctorale Génie électrique, électronique et télécommunications;GEET;5;Biologie, médecine et santé;2012;2011-12;2011;2011;9;3;6;27;11;16;0;0;0;;;;;arcz6
323;École doctorale Génie électrique, électronique et télécommunications;GEET;9;Sciences et technologies de l'information et de la communication;2012;2011-12;2011;2011;29;10;19;162;35;127;52;7;45;;;;;arcz6
326;École doctorale Comportement, langage, éducation, socialisation, cognition;CLESCO;5;Biologie, médecine et santé;2012;2011-12;2011;2011;6;2;4;49;23;26;13;3;10;;;;;nWIlG
328;École doctorale Arts, lettres, langues, philosophie et communication;ALLPH@;6;Sciences humaines et humanités;2012;2011-12;2011;2011;53;28;25;243;137;106;48;26;22;;;;;xLxMh
350;École doctorale Sciences humaines et sociales : savoirs, critique, expertises;;6;Sciences humaines et humanités;2012;2011-12;2011;2011;79;46;33;355;195;160;49;21;28;;;;;Dg9jV
351;École doctorale Sciences physiques, mathématiques et de l'information pour l'ingénieur;SPMII;1;Mathématiques et leurs interactions;2012;2011-12;2011;2011;7;3;4;36;17;19;7;2;5;;;;;rY4EP
351;École doctorale Sciences physiques, mathématiques et de l'information pour l'ingénieur;SPMII;4;Chimie;2012;2011-12;2011;2011;4;0;4;10;3;7;5;1;4;;;;;rY4EP
352;École doctorale Physique et sciences de la matière;;2;Physique;2012;2011-12;2011;2011;75;26;49;288;86;202;59;22;37;;;;;fb5YC
353;École doctorale Sciences pour l'ingénieur : mécanique, physique, micro et nanoélectronique;;1;Mathématiques et leurs interactions;2012;2011-12;2011;2011;2;0;2;2;0;2;0;0;0;;;;;vk5Kp
353;École doctorale Sciences pour l'ingénieur : mécanique, physique, micro et nanoélectronique;;2;Physique;2012;2011-12;2011;2011;3;0;3;8;1;7;9;1;8;;;;;vk5Kp
353;École doctorale Sciences pour l'ingénieur : mécanique, physique, micro et nanoélectronique;;3;Sciences de la terre et de l'univers, espace;2012;2011-12;2011;2011;2;1;1;8;4;4;0;0;0;;;;;vk5Kp
353;École doctorale Sciences pour l'ingénieur : mécanique, physique, micro et nanoélectronique;;9;Sciences et technologies de l'information et de la communication;2012;2011-12;2011;2011;0;0;0;13;1;12;0;0;0;;;;;vk5Kp
355;École doctorale Espaces, cultures, sociétés;;6;Sciences humaines et humanités;2012;2011-12;2011;2011;86;46;40;492;332;160;60;33;27;;;;;2kMf5
358;École doctorale Sciences, technologies, santé;;9;Sciences et technologies de l'information et de la communication;2012;2011-12;2011;2011;9;4;5;43;11;32;9;1;8;;;;;OZA3U
358;École doctorale Sciences, technologies, santé;;10;Sciences agronomiques et écologiques;2012;2011-12;2011;2011;3;1;2;24;13;11;7;2;5;;;;;OZA3U
361;École doctorale Sciences et Technologies;ED ST;6;Sciences humaines et humanités;2012;2011-12;2011;2011;3;2;1;16;4;12;1;1;0;;;;;cOUmL
364;École doctorale Sciences fondamentales et appliquées;EDSFA;4;Chimie;2012;2011-12;2011;2011;10;4;6;44;21;23;17;8;9;;;;;E483q
364;École doctorale Sciences fondamentales et appliquées;EDSFA;8;Sciences pour l'ingénieur;2012;2011-12;2011;2011;15;2;13;77;20;57;18;3;15;;;;;E483q
370;École doctorale Lettres, sciences humaines et sociales;LSHS;6;Sciences humaines et humanités;2012;2011-12;2011;2011;49;27;22;242;136;106;25;11;14;;;;;xAXXx
371;École doctorale Louis Pasteur;;4;Chimie;2012;2011-12;2011;2011;5;1;4;23;8;15;6;3;3;;;;;2tr4F
372;École doctorale Sciences économiques et de gestion;;7;Sciences de la société;2012;2011-12;2011;2011;56;23;33;294;132;162;63;24;39;;;;;JK63A
373;École doctorale Santé, information/communications et mathématiques, matière;SICMA;9;Sciences et technologies de l'information et de la communication;2012;2011-12;2011;2011;60;8;52;231;52;179;59;11;48;;;;;hTJF5
377;École doctorale Environnement et société;;10;Sciences agronomiques et écologiques;2012;2011-12;2011;2011;1;1;0;2;1;1;0;0;0;;;;;ZMG5u
378;École doctorale Sciences de l'homme et de la société;SHS;5;Biologie, médecine et santé;2012;2011-12;2011;2011;0;0;0;3;0;3;2;1;1;;;;;3XKuF
378;École doctorale Sciences de l'homme et de la société;SHS;7;Sciences de la société;2012;2011-12;2011;2011;29;12;17;90;38;52;22;11;11;;;;;3XKuF
387;École doctorale Interdisciplinaire pour le vivant;I-ViV;5;Biologie, médecine et santé;2012;2011-12;2011;2011;16;10;6;91;53;38;31;15;16;;;;;06uKM
390;École doctorale Génie des procédés et technologies avancées;;8;Sciences pour l'ingénieur;2012;2011-12;2011;2011;14;5;9;64;22;42;12;2;10;;;;;sK3wm
392;École doctorale Diversité du vivant;;5;Biologie, médecine et santé;2012;2011-12;2011;2011;15;5;10;61;28;33;10;5;5;;;;;537J0
392;École doctorale Diversité du vivant;;10;Sciences agronomiques et écologiques;2012;2011-12;2011;2011;7;3;4;35;16;19;17;13;4;;;;;537J0
393;École doctorale Pierre Louis de Santé Publique : Épidémiologie et Sciences de l'information biomédicale;PLSP;9;Sciences et technologies de l'information et de la communication;2012;2011-12;2011;2011;3;0;3;19;5;14;2;0;2;;;;;69445
397;École doctorale Physique et chimie des matériaux;;2;Physique;2012;2011-12;2011;2011;18;6;12;101;37;64;19;6;13;;;;;WxSt9
400;École doctorale Savoirs scientifiques : épistémologie, histoire des sciences, didactique des disciplines;;5;Biologie, médecine et santé;2012;2011-12;2011;2011;3;0;3;9;3;6;0;0;0;;;;;nRax3
401;École doctorale Sciences sociales;;6;Sciences humaines et humanités;2012;2011-12;2011;2011;44;22;22;205;89;116;17;10;7;;;;;raQ7K
405;École doctorale Économie, management,mathématiques et physique de Cergy;EM2C;1;Mathématiques et leurs interactions;2012;2011-12;2011;2011;2;0;2;22;11;11;1;0;1;;;;;QbwSB
417;École doctorale Sciences et Ingénierie;S&I;3;Sciences de la terre et de l'univers, espace;2012;2011-12;2011;2011;2;0;2;12;2;10;3;1;2;;;;;SSBvE
417;École doctorale Sciences et Ingénierie;S&I;4;Chimie;2012;2011-12;2011;2011;8;3;5;21;10;11;5;4;1;;;;;SSBvE
417;École doctorale Sciences et Ingénierie;S&I;9;Sciences et technologies de l'information et de la communication;2012;2011-12;2011;2011;11;3;8;47;11;36;11;2;9;;;;;SSBvE
425;École doctorale Innovation thérapeutique : du fondamental à l'appliqué;;4;Chimie;2012;2011-12;2011;2011;12;7;5;35;15;20;6;2;4;;;;;DkgNy
432;École doctorale Sciences des métiers de l'ingénieur;SMI;8;Sciences pour l'ingénieur;2012;2011-12;2011;2011;115;21;94;464;104;360;126;33;93;;;;;nSsHB
435;École doctorale Agriculture, alimentation, biologie, environnement et santé;;1;Mathématiques et leurs interactions;2012;2011-12;2011;2011;7;2;5;13;5;8;1;1;0;;;;;mC35U
435;École doctorale Agriculture, alimentation, biologie, environnement et santé;;7;Sciences de la société;2012;2011-12;2011;2011;5;3;2;40;19;21;4;3;1;;;;;mC35U
435;École doctorale Agriculture, alimentation, biologie, environnement et santé;;10;Sciences agronomiques et écologiques;2012;2011-12;2011;2011;27;15;12;115;58;57;33;16;17;;;;;mC35U
436;École doctorale Médicament, toxicologie, chimie, environnement;MTCE;5;Biologie, médecine et santé;2012;2011-12;2011;2011;34;19;15;122;75;47;32;14;18;;;;;dPsg3
447;École doctorale de l'école polytechnique;;3;Sciences de la terre et de l'univers, espace;2012;2011-12;2011;2011;4;3;1;16;8;8;2;0;2;;;;;zgCCh
447;École doctorale de l'école polytechnique;;7;Sciences de la société;2012;2011-12;2011;2011;5;1;4;24;6;18;5;1;4;;;;;zgCCh
450;École doctorale Recherches en psychanalyse et psychopathologie;PSY²;6;Sciences humaines et humanités;2012;2011-12;2011;2011;77;49;28;299;200;99;44;31;13;;;;;8jI3f
469;École doctorale du Pacifique;EDP;4;Chimie;2012;2011-12;2011;2011;0;0;0;4;2;2;2;0;2;;;;;t9Z2n
474;École doctorale Interdisciplinaire européenne frontières du vivant;FDV;1;Mathématiques et leurs interactions;2012;2011-12;2011;2011;2;0;2;2;0;2;2;0;2;;;;;E727j
476;École doctorale Neurosciences et cognition;NSCO;5;Biologie, médecine et santé;2012;2011-12;2011;2011;24;16;8;110;64;46;30;16;14;;;;;B1H0x
477;École doctorale Systèmes intégrés en biologie, agronomie, géosciences, hydrosciences, environnement;SIBAGHE;5;Biologie, médecine et santé;2012;2011-12;2011;2011;25;11;14;100;49;51;51;19;32;;;;;zfN3N
479;École doctorale Sciences juridiques et politiques;;7;Sciences de la société;2012;2011-12;2011;2011;103;51;52;601;275;326;44;19;25;;;;;34mid
480;École doctorale Montaigne-humanités;;6;Sciences humaines et humanités;2012;2011-12;2011;2011;131;72;59;662;371;291;75;41;34;;;;;f3SeZ
482;École doctorale Sciences de la matière;SDM;8;Sciences pour l'ingénieur;2012;2011-12;2011;2011;5;2;3;8;2;6;1;0;1;;;;;kmeZ4
483;École doctorale Histoire, géographie, aménagement, urbanisme, archéologie, science politique, sociologie, anthropologie;SCSO;3;Sciences de la terre et de l'univers, espace;2012;2011-12;2011;2011;7;3;4;34;19;15;4;1;3;;;;;hc6u4
486;École doctorale Sciences économiques et de gestion;SEG;7;Sciences de la société;2012;2011-12;2011;2011;31;11;20;188;91;97;48;21;27;;;;;h1GZ3
488;École doctorale Sciences, ingénierie, santé;SIS;9;Sciences et technologies de l'information et de la communication;2012;2011-12;2011;2011;33;9;24;137;37;100;37;14;23;;;;;Fy2lK
489;École doctorale Sciences et ingénierie des systèmes, de l'environnement et des organisations;SISEO;7;Sciences de la société;2012;2011-12;2011;2011;7;3;4;37;20;17;4;4;0;;;;;6pT77
489;École doctorale Sciences et ingénierie des systèmes, de l'environnement et des organisations;SISEO;9;Sciences et technologies de l'information et de la communication;2012;2011-12;2011;2011;3;0;3;13;3;10;4;2;2;;;;;6pT77
490;École doctorale Environnement - Santé/STIC;E2S;4;Chimie;2012;2011-12;2011;2011;0;0;0;0;0;0;2;1;1;;;;;sYTua
490;École doctorale Environnement - Santé/STIC;E2S;9;Sciences et technologies de l'information et de la communication;2012;2011-12;2011;2011;27;5;22;91;16;75;21;5;16;;;;;sYTua
492;École doctorale Droit;;7;Sciences de la société;2012;2011-12;2011;2011;66;33;33;430;193;237;65;25;40;;;;;kOQsX
494;École doctorale Jean-Henri Lambert;;1;Mathématiques et leurs interactions;2012;2011-12;2011;2011;2;0;2;6;0;6;1;0;1;;;;;A3m51
495;École doctorale Végétal, environnement, nutrition, agroalimentaire, mer;VENAM;3;Sciences de la terre et de l'univers, espace;2012;2011-12;2011;2011;2;1;1;6;4;2;3;3;0;;;;;HL495
497;École doctorale Normande de Biologie Intégrative, Santé, Environnement;Ed NBISE;5;Biologie, médecine et santé;2012;2011-12;2011;2011;65;29;36;248;128;120;50;24;26;;;;;0D9Je
503;École doctorale Sciences et technologies de l'information et de mathématiques;STIM;1;Mathématiques et leurs interactions;2012;2011-12;2011;2011;8;2;6;45;13;32;7;2;5;;;;;JQevP
504;École doctorale Cognition, éducation, interactions;CEI;6;Sciences humaines et humanités;2012;2011-12;2011;2011;52;25;27;190;115;75;25;13;12;;;;;39naT
505;École doctorale Sciences de l'homme, des organisations et de la société;SHOS;7;Sciences de la société;2012;2011-12;2011;2011;80;42;38;353;157;196;59;26;33;;;;;qts78
508;École doctorale Normande de chimie;EDNC;5;Biologie, médecine et santé;2012;2011-12;2011;2011;2;0;2;6;1;5;2;1;1;;;;;E52OO
510;École doctorale Ingénierie - Matériaux, mécanique, environnement, énergétique, procédés, production;IMEP2;8;Sciences pour l'ingénieur;2012;2011-12;2011;2011;102;34;68;369;116;253;76;20;56;;;;;Ce7NF
510;École doctorale Ingénierie - Matériaux, mécanique, environnement, énergétique, procédés, production;IMEP2;9;Sciences et technologies de l'information et de la communication;2012;2011-12;2011;2011;1;0;1;3;0;3;0;0;0;;;;;Ce7NF
517;École doctorale Particules, noyaux, cosmologie;;2;Physique;2012;2011-12;2011;2011;56;15;41;160;45;115;49;11;38;;;;;9kK48
518;École doctorale Matière condensée et interfaces;;2;Physique;2012;2011-12;2011;2011;28;8;20;100;30;70;18;3;15;;;;;Sg04R
519;École doctorale Sciences humaines et sociales - Perspectives européennes;SHS-PE;9;Sciences et technologies de l'information et de la communication;2012;2011-12;2011;2011;1;1;0;2;2;0;0;0;0;;;;;2f5qs
520;École doctorale Humanités;;6;Sciences humaines et humanités;2012;2011-12;2011;2011;102;65;37;456;288;168;53;33;20;;;;;rI175
521;École doctorale Sciences et ingénierie pour l'information, mathématiques;S2I;8;Sciences pour l'ingénieur;2012;2011-12;2011;2011;1;0;1;3;1;2;1;0;1;;;;;V6i83
523;École doctorale Sciences pour l'environnement - Gay Lussac;;4;Chimie;2012;2011-12;2011;2011;31;13;18;102;46;56;34;11;23;;;;;6xD69
523;École doctorale Sciences pour l'environnement - Gay Lussac;;5;Biologie, médecine et santé;2012;2011-12;2011;2011;7;4;3;21;13;8;7;3;4;;;;;6xD69
523;École doctorale Sciences pour l'environnement - Gay Lussac;;10;Sciences agronomiques et écologiques;2012;2011-12;2011;2011;16;9;7;52;27;25;12;4;8;;;;;6xD69
528;École doctorale Ville, transports et territoires;VTT;3;Sciences de la terre et de l'univers, espace;2012;2011-12;2011;2011;0;0;0;2;1;1;0;0;0;;;;;68zCc
530;École doctorale Organisations, marchés, institutions;OMI;7;Sciences de la société;2012;2011-12;2011;2011;40;14;26;207;92;115;33;20;13;;;;;4htv7
534;École doctorale Modélisation et instrumentation en physique, énergie, géosciences et environnement;MIPEGE;4;Chimie;2012;2011-12;2011;2011;1;1;0;7;3;4;1;0;1;;;;;K93eR
535;École doctorale Sciences de la société;SDS;6;Sciences humaines et humanités;2012;2011-12;2011;2011;10;4;6;26;13;13;1;0;1;;;;;iEUOV
539;École doctorale Sciences et technologies de Versailles;;1;Mathématiques et leurs interactions;2012;2011-12;2011;2011;6;1;5;12;3;9;2;0;2;;;;;nv3h8
540;"École doctorale École transdisciplinaire ""lettres/sciences""";;8;Sciences pour l'ingénieur;2012;2011-12;2011;2011;1;1;0;1;1;0;0;0;0;;;;;tWWw7
544;École doctorale Inter-Med : Espaces, temps, cultures;INTER-MED;6;Sciences humaines et humanités;2012;2011-12;2011;2011;55;29;26;296;118;178;42;14;28;;;;;7VjtD
545;École doctorale Sociétés, politique et santé publique;SP2;6;Sciences humaines et humanités;2012;2011-12;2011;2011;24;14;10;99;55;44;26;12;14;;;;;IAKR4
19;École doctorale Littératures françaises et comparée;;6;Sciences humaines et humanités;2023;2022-23;2022;2022;43;27;16;266;181;85;28;18;10;5;4;13;6;13M43
31;École doctorale Pratiques et théories du sens;;6;Sciences humaines et humanités;2023;2022-23;2022;2022;50;27;23;328;170;158;42;26;16;8;7;17;10;1S466
34;École doctorale Matériaux;;4;Chimie;2023;2022-23;2022;2022;12;6;6;33;18;15;4;2;2;2;2;0;0;1Iufh
37;École doctorale Sciences physiques pour l'ingénieur et microtechniques;SPIM;8;Sciences pour l'ingénieur;2023;2022-23;2022;2022;43;17;26;178;56;122;46;10;36;21;20;5;0;F7G1B
47;École doctorale Physique;;2;Physique;2023;2022-23;2022;2022;102;28;74;345;79;266;99;23;76;46;49;4;0;8kNpd
58;École doctorale Langues, littératures, cultures, civilisations;LLCC;6;Sciences humaines et humanités;2023;2022-23;2022;2022;66;36;30;451;264;187;52;36;16;5;11;14;22;I9ATR
60;École doctorale Territoires, temps, sociétés et développement;TTSD;6;Sciences humaines et humanités;2023;2022-23;2022;2022;39;24;15;174;106;68;30;21;9;1;17;6;6;fkIh6
60;École doctorale Territoires, temps, sociétés et développement;TTSD;10;Sciences agronomiques et écologiques;2023;2022-23;2022;2022;1;1;0;3;2;1;1;1;0;0;1;0;0;fkIh6
62;École doctorale Sciences de la vie et de la santé;;2;Physique;2023;2022-23;2022;2022;1;0;1;2;1;1;1;1;0;0;0;1;0;vZzE7
62;École doctorale Sciences de la vie et de la santé;;9;Sciences et technologies de l'information et de la communication;2023;2022-23;2022;2022;0;0;0;1;0;1;0;0;0;0;0;0;0;vZzE7
65;École doctorale Sciences de la Vie, Santé, Agronomie, Environnement;;5;Biologie, médecine et santé;2023;2022-23;2022;2022;64;45;19;234;148;86;65;42;23;28;32;5;0;MAOG4
65;École doctorale Sciences de la Vie, Santé, Agronomie, Environnement;;10;Sciences agronomiques et écologiques;2023;2022-23;2022;2022;0;0;0;0;0;0;1;1;0;0;0;1;0;MAOG4
67;École doctorale Sciences juridiques et politiques;;7;Sciences de la société;2023;2022-23;2022;2022;64;30;34;405;204;201;60;26;34;5;7;16;32;qrOj1
70;École doctorale Sciences pour l'ingénieur;EDSPI;9;Sciences et technologies de l'information et de la communication;2023;2022-23;2022;2022;4;2;2;42;11;31;8;3;5;8;0;0;0;G413P
71;École doctorale Sciences pour l'ingénieur;;5;Biologie, médecine et santé;2023;2022-23;2022;2022;3;1;2;11;3;8;2;1;1;0;2;0;0;H6UYp
71;École doctorale Sciences pour l'ingénieur;;8;Sciences pour l'ingénieur;2023;2022-23;2022;2022;36;16;20;176;62;114;40;12;28;12;26;2;0;H6UYp
71;École doctorale Sciences pour l'ingénieur;;9;Sciences et technologies de l'information et de la communication;2023;2022-23;2022;2022;1;1;0;8;3;5;3;1;2;0;2;1;0;H6UYp
85;École doctorale Sciences de la vie et de la santé;SVS;5;Biologie, médecine et santé;2023;2022-23;2022;2022;62;44;18;225;150;75;35;21;14;9;23;3;0;YdiMF
122;École doctorale Europe latine - Amérique latine;;7;Sciences de la société;2023;2022-23;2022;2022;7;4;3;44;25;19;6;4;2;0;0;2;4;z9lZY
129;École doctorale Sciences de l'environnement d'Ile de France;SEIF;1;Mathématiques et leurs interactions;2023;2022-23;2022;2022;0;0;0;1;0;1;2;1;1;2;0;0;0;TnAPh
130;École doctorale Informatique, télécommunications et électronique de Paris;EDITE;8;Sciences pour l'ingénieur;2023;2022-23;2022;2022;5;3;2;39;8;31;9;1;8;2;5;2;0;O5ysj
130;École doctorale Informatique, télécommunications et électronique de Paris;EDITE;9;Sciences et technologies de l'information et de la communication;2023;2022-23;2022;2022;104;23;81;490;119;371;98;16;82;41;50;7;0;O5ysj
138;École doctorale Lettres, langues, spectacles;LLS;6;Sciences humaines et humanités;2023;2022-23;2022;2022;40;25;15;212;137;75;27;20;7;0;5;11;11;y9O3k
138;École doctorale Lettres, langues, spectacles;LLS;9;Sciences et technologies de l'information et de la communication;2023;2022-23;2022;2022;2;1;1;8;2;6;0;0;0;0;0;0;0;y9O3k
139;École doctorale Connaissance, langage, modélisation;CLM;5;Biologie, médecine et santé;2023;2022-23;2022;2022;0;0;0;5;5;0;3;3;0;0;2;1;0;1lxGH
139;École doctorale Connaissance, langage, modélisation;CLM;7;Sciences de la société;2023;2022-23;2022;2022;3;1;2;6;3;3;0;0;0;0;0;0;0;1lxGH
146;École doctorale Galilée;GALILEE;2;Physique;2023;2022-23;2022;2022;4;3;1;21;7;14;6;0;6;2;4;0;0;71hqm
146;École doctorale Galilée;GALILEE;8;Sciences pour l'ingénieur;2023;2022-23;2022;2022;21;10;11;56;17;39;12;0;12;4;8;0;0;71hqm
159;École doctorale Esthétique, sciences et technologies des arts;EDESTA;6;Sciences humaines et humanités;2023;2022-23;2022;2022;34;25;9;221;142;79;29;19;10;0;3;8;18;zj1Vj
160;École doctorale Électronique, électrotechnique, automatique;EEA;5;Biologie, médecine et santé;2023;2022-23;2022;2022;8;4;4;17;9;8;2;0;2;0;2;0;0;EgfMQ
160;École doctorale Électronique, électrotechnique, automatique;EEA;9;Sciences et technologies de l'information et de la communication;2023;2022-23;2022;2022;24;7;17;119;26;93;31;8;23;13;17;1;0;EgfMQ
162;École doctorale Mécanique, énergétique, génie civil, acoustique;MEGA;5;Biologie, médecine et santé;2023;2022-23;2022;2022;7;2;5;40;14;26;12;5;7;4;6;2;0;7wCke
166;École doctorale Information, structures et systèmes;I2S;1;Mathématiques et leurs interactions;2023;2022-23;2022;2022;21;9;12;64;21;43;17;5;12;7;7;3;0;2uO68
166;École doctorale Information, structures et systèmes;I2S;3;Sciences de la terre et de l'univers, espace;2023;2022-23;2022;2022;0;0;0;1;0;1;0;0;0;0;0;0;0;2uO68
166;École doctorale Information, structures et systèmes;I2S;10;Sciences agronomiques et écologiques;2023;2022-23;2022;2022;2;0;2;3;0;3;1;0;1;1;0;0;0;2uO68
168;École doctorale Sciences chimiques et biologiques pour la santé;SCBS;2;Physique;2023;2022-23;2022;2022;2;0;2;3;0;3;0;0;0;0;0;0;0;8cEME
173;École doctorale Sciences de l'univers, de l'environnement et de l'espace;SDU2E;2;Physique;2023;2022-23;2022;2022;14;7;7;22;9;13;0;0;0;0;0;0;0;R0Z9c
173;École doctorale Sciences de l'univers, de l'environnement et de l'espace;SDU2E;4;Chimie;2023;2022-23;2022;2022;0;0;0;1;0;1;0;0;0;0;0;0;0;R0Z9c
173;École doctorale Sciences de l'univers, de l'environnement et de l'espace;SDU2E;5;Biologie, médecine et santé;2023;2022-23;2022;2022;2;1;1;2;1;1;0;0;0;0;0;0;0;R0Z9c
173;École doctorale Sciences de l'univers, de l'environnement et de l'espace;SDU2E;10;Sciences agronomiques et écologiques;2023;2022-23;2022;2022;8;4;4;27;15;12;3;1;2;0;2;1;0;R0Z9c
182;École doctorale Physique et chimie-physique;;5;Biologie, médecine et santé;2023;2022-23;2022;2022;4;3;1;7;5;2;1;0;1;0;1;0;0;3My6I
209;École doctorale Sciences physiques et de L'ingénieur;SPI;3;Sciences de la terre et de l'univers, espace;2023;2022-23;2022;2022;5;2;3;14;5;9;1;0;1;1;0;0;0;tZcIZ
211;École doctorale Sciences exactes et leurs applications;ED SEA;1;Mathématiques et leurs interactions;2023;2022-23;2022;2022;7;2;5;35;11;24;7;4;3;5;1;1;0;1G1iC
211;École doctorale Sciences exactes et leurs applications;ED SEA;10;Sciences agronomiques et écologiques;2023;2022-23;2022;2022;7;3;4;29;15;14;7;4;3;5;2;0;0;1G1iC
216;École doctorale Ingénierie pour la santé, la cognition, l'environnement;EDISCE;8;Sciences pour l'ingénieur;2023;2022-23;2022;2022;1;1;0;2;1;1;0;0;0;0;0;0;0;fPs1t
217;École doctorale Mathématiques, sciences et technologies de l'information, informatique;MSTII;9;Sciences et technologies de l'information et de la communication;2023;2022-23;2022;2022;54;9;45;254;55;199;40;12;28;11;27;2;0;Ehx7v
218;École doctorale Chimie et sciences du vivant;EDCSV;5;Biologie, médecine et santé;2023;2022-23;2022;2022;67;45;22;230;153;77;59;37;22;17;32;9;1;8bcJh
218;École doctorale Chimie et sciences du vivant;EDCSV;10;Sciences agronomiques et écologiques;2023;2022-23;2022;2022;13;9;4;60;32;28;15;9;6;4;10;1;0;8bcJh
222;École doctorale Sciences chimiques;EDSC;2;Physique;2023;2022-23;2022;2022;1;1;0;11;4;7;2;0;2;0;2;0;0;AdU8Q
224;École doctorale Cognition, langage, interaction;;1;Mathématiques et leurs interactions;2023;2022-23;2022;2022;2;0;2;14;3;11;1;1;0;1;0;0;0;7v43e
224;École doctorale Cognition, langage, interaction;;6;Sciences humaines et humanités;2023;2022-23;2022;2022;20;15;5;128;86;42;13;7;6;1;2;5;5;7v43e
224;École doctorale Cognition, langage, interaction;;8;Sciences pour l'ingénieur;2023;2022-23;2022;2022;1;1;0;7;7;0;2;0;2;0;1;0;1;7v43e
227;École doctorale Sciences de la nature et de l'homme;;3;Sciences de la terre et de l'univers, espace;2023;2022-23;2022;2022;9;2;7;24;9;15;10;5;5;6;1;2;1;xiDA5
227;École doctorale Sciences de la nature et de l'homme;;4;Chimie;2023;2022-23;2022;2022;3;2;1;10;4;6;2;2;0;1;1;0;0;xiDA5
231;École doctorale Économie et gestion;EDEG;7;Sciences de la société;2023;2022-23;2022;2022;33;21;12;154;82;72;29;20;9;3;12;11;3;KT720
251;École doctorale Sciences de l'environnement;;4;Chimie;2023;2022-23;2022;2022;9;4;5;23;9;14;2;2;0;0;1;1;0;VR28y
251;École doctorale Sciences de l'environnement;;6;Sciences humaines et humanités;2023;2022-23;2022;2022;0;0;0;7;4;3;2;2;0;0;2;0;0;VR28y
251;École doctorale Sciences de l'environnement;;10;Sciences agronomiques et écologiques;2023;2022-23;2022;2022;14;9;5;54;29;25;9;4;5;2;7;0;0;VR28y
265;École doctorale Langues, littératures et sociétés du monde;;6;Sciences humaines et humanités;2023;2022-23;2022;2022;43;20;23;284;146;138;24;17;7;0;4;12;8;4YWGW
267;École doctorale Arts et médias;;6;Sciences humaines et humanités;2023;2022-23;2022;2022;13;10;3;119;69;50;25;18;7;2;2;5;16;eCF5C
269;École doctorale Mathématiques, sciences de l'information et de l'ingénieur;MSII;2;Physique;2023;2022-23;2022;2022;4;2;2;10;3;7;2;1;1;2;0;0;0;5E625
269;École doctorale Mathématiques, sciences de l'information et de l'ingénieur;MSII;6;Sciences humaines et humanités;2023;2022-23;2022;2022;0;0;0;2;2;0;0;0;0;0;0;0;0;5E625
270;École doctorale Théologie et sciences religieuses;;6;Sciences humaines et humanités;2023;2022-23;2022;2022;18;8;10;66;27;39;17;2;15;5;2;8;2;BRKC1
279;École doctorale Arts plastiques, esthétique et sciences de l'art;APESA;6;Sciences humaines et humanités;2023;2022-23;2022;2022;22;15;7;153;110;43;25;17;8;3;0;3;19;BpW1j
280;École doctorale Philosophie;;6;Sciences humaines et humanités;2023;2022-23;2022;2022;48;19;29;252;104;148;37;11;26;4;4;10;19;kJxnm
284;École doctorale Droit et Science Politique;DSP;6;Sciences humaines et humanités;2023;2022-23;2022;2022;4;2;2;46;27;19;1;1;0;0;0;1;0;ahH92
300;École doctorale Sciences Économiques;ED SE;7;Sciences de la société;2023;2022-23;2022;2022;8;3;5;41;14;27;8;5;3;0;7;1;0;5x3fM
305;École doctorale Énergie et environnement;E2;5;Biologie, médecine et santé;2023;2022-23;2022;2022;10;6;4;33;13;20;4;2;2;1;3;0;0;Kbt8I
305;École doctorale Énergie et environnement;E2;9;Sciences et technologies de l'information et de la communication;2023;2022-23;2022;2022;0;0;0;5;3;2;2;2;0;1;1;0;0;Kbt8I
309;École doctorale Systèmes;EDSYS;8;Sciences pour l'ingénieur;2023;2022-23;2022;2022;26;5;21;73;16;57;10;2;8;7;3;0;0;8TT4b
327;École doctorale Temps, espaces, sociétés, cultures;TESC;6;Sciences humaines et humanités;2023;2022-23;2022;2022;38;23;15;252;155;97;25;11;14;0;5;11;9;IjgiJ
340;École doctorale Biologie moléculaire, intégrative et cellulaire;BMIC;5;Biologie, médecine et santé;2023;2022-23;2022;2022;73;46;27;329;208;121;68;42;26;28;34;5;1;db7xq
361;École doctorale Sciences et Technologies;ED ST;7;Sciences de la société;2023;2022-23;2022;2022;2;2;0;16;7;9;3;2;1;0;2;0;1;cOUmL
361;École doctorale Sciences et Technologies;ED ST;8;Sciences pour l'ingénieur;2023;2022-23;2022;2022;7;1;6;42;11;31;4;1;3;3;1;0;0;cOUmL
364;École doctorale Sciences fondamentales et appliquées;EDSFA;2;Physique;2023;2022-23;2022;2022;27;9;18;82;19;63;17;4;13;8;6;3;0;E483q
372;École doctorale Sciences économiques et de gestion;;7;Sciences de la société;2023;2022-23;2022;2022;34;16;18;152;82;70;31;20;11;4;15;10;2;JK63A
395;École doctorale Milieux, cultures et sociétés du passé et du présent;MCSPP;7;Sciences de la société;2023;2022-23;2022;2022;10;9;1;68;48;20;8;6;2;0;1;1;6;2quEb
398;École doctorale Géosciences, ressources naturelles et environnement;GRNE;1;Mathématiques et leurs interactions;2023;2022-23;2022;2022;1;1;0;2;1;1;0;0;0;0;0;0;0;Zi4Zf
398;École doctorale Géosciences, ressources naturelles et environnement;GRNE;8;Sciences pour l'ingénieur;2023;2022-23;2022;2022;0;0;0;4;3;1;3;2;1;1;2;0;0;Zi4Zf
401;École doctorale Sciences sociales;;7;Sciences de la société;2023;2022-23;2022;2022;20;11;9;149;80;69;18;8;10;4;2;4;8;raQ7K
402;École doctorale Sciences de la vie et de la santé;SVS;4;Chimie;2023;2022-23;2022;2022;0;0;0;1;0;1;0;0;0;0;0;0;0;YKgsU
405;École doctorale Économie, management,mathématiques et physique de Cergy;EM2C;7;Sciences de la société;2023;2022-23;2022;2022;14;6;8;80;34;46;16;8;8;2;2;5;7;QbwSB
405;École doctorale Économie, management,mathématiques et physique de Cergy;EM2C;8;Sciences pour l'ingénieur;2023;2022-23;2022;2022;0;0;0;1;0;1;0;0;0;0;0;0;0;QbwSB
411;École doctorale Humanités nouvelles : Fernand Braudel;;7;Sciences de la société;2023;2022-23;2022;2022;2;1;1;5;2;3;0;0;0;0;0;0;0;l2rFh
414;École doctorale Sciences de la vie et de la santé;;4;Chimie;2023;2022-23;2022;2022;0;0;0;2;2;0;1;1;0;0;0;0;1;YI4xS
414;École doctorale Sciences de la vie et de la santé;;5;Biologie, médecine et santé;2023;2022-23;2022;2022;142;79;63;504;283;221;120;70;50;37;71;8;4;YI4xS
417;École doctorale Sciences et Ingénierie;S&I;8;Sciences pour l'ingénieur;2023;2022-23;2022;2022;10;2;8;51;16;35;12;6;6;1;10;1;0;SSBvE
432;École doctorale Sciences des métiers de l'ingénieur;SMI;1;Mathématiques et leurs interactions;2023;2022-23;2022;2022;0;0;0;1;0;1;1;1;0;0;1;0;0;nSsHB
434;École doctorale Géographie de Paris - Espaces, sociétés, aménagement;EDGP;6;Sciences humaines et humanités;2023;2022-23;2022;2022;37;23;14;201;116;85;36;22;14;2;5;16;13;1FmLX
446;École doctorale Biologie - Santé;EDBSL;1;Mathématiques et leurs interactions;2023;2022-23;2022;2022;0;0;0;3;2;1;1;1;0;1;0;0;0;4iEUF
455;École doctorale Économie, Gestion, Information et Communication;EGIC;7;Sciences de la société;2023;2022-23;2022;2022;25;8;17;92;33;59;8;3;5;3;0;0;5;qCOg3
458;École doctorale Sciences écologiques, vétérinaires, agronomiques et bioingénieries;SEVAB;10;Sciences agronomiques et écologiques;2023;2022-23;2022;2022;72;45;27;239;137;102;62;35;27;20;37;3;2;Yf3TI
459;École doctorale Sciences chimiques Balard;;8;Sciences pour l'ingénieur;2023;2022-23;2022;2022;3;1;2;9;1;8;1;0;1;1;0;0;0;YFs2W
460;École doctorale Sciences juridiques;SJ;7;Sciences de la société;2023;2022-23;2022;2022;8;6;2;105;62;43;20;13;7;0;1;5;14;ZB5I5
463;École doctorale Sciences du mouvement humain;SMH;5;Biologie, médecine et santé;2023;2022-23;2022;2022;21;8;13;116;47;69;19;8;11;5;11;1;2;UbtlY
467;École doctorale Aéronautique, astronautique;AA;2;Physique;2023;2022-23;2022;2022;0;0;0;4;4;0;2;0;2;1;1;0;0;U7l45
467;École doctorale Aéronautique, astronautique;AA;6;Sciences humaines et humanités;2023;2022-23;2022;2022;0;0;0;4;2;2;2;2;0;1;1;0;0;U7l45
472;École doctorale de l'EPHE;;5;Biologie, médecine et santé;2023;2022-23;2022;2022;10;7;3;53;33;20;11;7;4;1;5;3;2;27zK4
472;École doctorale de l'EPHE;;9;Sciences et technologies de l'information et de la communication;2023;2022-23;2022;2022;1;0;1;6;1;5;1;1;0;0;0;1;0;27zK4
473;École doctorale Sciences de l'homme et de la société;SHS;6;Sciences humaines et humanités;2023;2022-23;2022;2022;93;52;41;511;303;208;57;34;23;4;20;13;20;8qKD9
475;École doctorale Mathématiques, informatique, télécommunications de Toulouse;MITT;9;Sciences et technologies de l'information et de la communication;2023;2022-23;2022;2022;63;12;51;269;56;213;68;21;47;34;28;6;0;xcp2r
476;École doctorale Neurosciences et cognition;NSCO;6;Sciences humaines et humanités;2023;2022-23;2022;2022;6;3;3;24;12;12;3;3;0;2;1;0;0;B1H0x
479;École doctorale Sciences juridiques et politiques;;7;Sciences de la société;2023;2022-23;2022;2022;43;21;22;241;127;114;26;11;15;3;0;7;16;34mid
480;École doctorale Montaigne-humanités;;3;Sciences de la terre et de l'univers, espace;2023;2022-23;2022;2022;0;0;0;12;5;7;6;3;3;0;4;1;1;f3SeZ
482;École doctorale Sciences de la matière;SDM;8;Sciences pour l'ingénieur;2023;2022-23;2022;2022;9;4;5;36;17;19;13;4;9;0;12;0;1;kmeZ4
483;École doctorale Histoire, géographie, aménagement, urbanisme, archéologie, science politique, sociologie, anthropologie;SCSO;7;Sciences de la société;2023;2022-23;2022;2022;29;18;11;224;127;97;29;19;10;0;4;12;13;hc6u4
492;École doctorale Droit;;7;Sciences de la société;2023;2022-23;2022;2022;44;23;21;273;143;130;25;10;15;6;11;8;0;kOQsX
497;École doctorale Normande de Biologie Intégrative, Santé, Environnement;Ed NBISE;2;Physique;2023;2022-23;2022;2022;0;0;0;3;1;2;0;0;0;0;0;0;0;0D9Je
512;École doctorale Informatique et mathématiques;InfoMaths;10;Sciences agronomiques et écologiques;2023;2022-23;2022;2022;0;0;0;0;0;0;4;4;0;2;2;0;0;t86bi
515;École doctorale Complexité du vivant;CdV;9;Sciences et technologies de l'information et de la communication;2023;2022-23;2022;2022;0;0;0;1;0;1;0;0;0;0;0;0;0;CbV9s
519;École doctorale Sciences humaines et sociales - Perspectives européennes;SHS-PE;6;Sciences humaines et humanités;2023;2022-23;2022;2022;61;38;23;329;187;142;42;24;18;9;2;14;17;2f5qs
519;École doctorale Sciences humaines et sociales - Perspectives européennes;SHS-PE;7;Sciences de la société;2023;2022-23;2022;2022;0;0;0;6;2;4;0;0;0;0;0;0;0;2f5qs
520;École doctorale Humanités;;6;Sciences humaines et humanités;2023;2022-23;2022;2022;54;34;20;244;154;90;34;23;11;1;6;13;14;rI175
529;École doctorale Cultures et sociétés;CS;6;Sciences humaines et humanités;2023;2022-23;2022;2022;52;42;10;234;144;90;31;17;14;1;7;11;12;XU9tb
530;École doctorale Organisations, marchés, institutions;OMI;5;Biologie, médecine et santé;2023;2022-23;2022;2022;0;0;0;3;0;3;0;0;0;0;0;0;0;4htv7
530;École doctorale Organisations, marchés, institutions;OMI;7;Sciences de la société;2023;2022-23;2022;2022;16;11;5;79;45;34;14;8;6;1;2;6;5;4htv7
536;École doctorale Sciences et agrosciences;;1;Mathématiques et leurs interactions;2023;2022-23;2022;2022;1;0;1;5;1;4;1;1;0;1;0;0;0;pHfqe
536;École doctorale Sciences et agrosciences;;2;Physique;2023;2022-23;2022;2022;0;0;0;2;0;2;0;0;0;0;0;0;0;pHfqe
541;École doctorale de sciences humaines et sociales de La Réunion;SHS;5;Biologie, médecine et santé;2023;2022-23;2022;2022;1;1;0;1;1;0;0;0;0;0;0;0;0;21SpE
541;École doctorale de sciences humaines et sociales de La Réunion;SHS;7;Sciences de la société;2023;2022-23;2022;2022;8;1;7;25;7;18;1;0;1;0;0;1;0;21SpE
542;École doctorale de sciences de La Réunion;STS;6;Sciences humaines et humanités;2023;2022-23;2022;2022;1;1;0;3;2;1;1;0;1;0;0;1;0;2pAql
542;École doctorale de sciences de La Réunion;STS;9;Sciences et technologies de l'information et de la communication;2023;2022-23;2022;2022;2;1;1;5;2;3;2;0;2;0;1;1;0;2pAql
543;École doctorale de Dauphine;;1;Mathématiques et leurs interactions;2023;2022-23;2022;2022;17;2;15;54;7;47;13;3;10;6;6;1;0;u8w6A
545;École doctorale Sociétés, politique et santé publique;SP2;7;Sciences de la société;2023;2022-23;2022;2022;16;5;11;123;60;63;12;3;9;0;3;6;3;IAKR4
549;École doctorale Santé, Sciences Biologiques et Chimie du Vivant;SSBCV;2;Physique;2023;2022-23;2022;2022;1;0;1;3;1;2;0;0;0;0;0;0;0;B9ggO
556;École doctorale Homme, Sociétés, Risques, Territoire;HSRT;7;Sciences de la société;2023;2022-23;2022;2022;46;24;22;226;121;105;24;13;11;2;7;9;6;5QEaX
563;École doctorale Médicament - Toxicologie - Chimie - Imageries;MTCI;5;Biologie, médecine et santé;2023;2022-23;2022;2022;58;35;23;186;107;79;51;30;21;18;30;3;0;j8uk1
564;École doctorale Physique en Ile de France;PIF;2;Physique;2023;2022-23;2022;2022;206;51;155;727;174;553;179;40;139;106;68;5;0;39AcN
566;École doctorale Sciences du Sport, de la Motricité et du Mouvement Humain;SMMH;7;Sciences de la société;2023;2022-23;2022;2022;0;0;0;4;2;2;0;0;0;0;0;0;0;3iv8y
567;École doctorale Sciences du Végétal : du gène à l'écosystème;;5;Biologie, médecine et santé;2023;2022-23;2022;2022;23;17;6;53;32;21;16;8;8;4;10;2;0;tuDkA
568;École doctorale Signalisations et Réseaux Intégratifs en Biologie;BIOSIGNE;5;Biologie, médecine et santé;2023;2022-23;2022;2022;37;21;16;109;72;37;22;14;8;1;15;6;0;CGttG
569;École doctorale Innovation thérapeutique : du fondamental à l'appliqué;;5;Biologie, médecine et santé;2023;2022-23;2022;2022;49;33;16;231;142;89;62;41;21;21;32;8;1;jx8ET
575;École doctorale Electrical, Optical, Bio : Physics and Engineering;EOBE;8;Sciences pour l'ingénieur;2023;2022-23;2022;2022;66;22;44;194;54;140;36;13;23;13;16;6;1;dfhyn
579;École doctorale Sciences mécaniques et energétiques, matériaux et géosciences;SMEMaG;8;Sciences pour l'ingénieur;2023;2022-23;2022;2022;74;16;58;259;63;196;53;12;41;17;29;6;1;atMj7
582;École doctorale Cancérologie, Biologie, Médecine, Santé;CBMS;5;Biologie, médecine et santé;2023;2022-23;2022;2022;52;31;21;218;135;83;47;25;22;11;25;9;2;75bj4
585;École doctorale Sciences, Technologie,  Sante;EDSTS;10;Sciences agronomiques et écologiques;2023;2022-23;2022;2022;18;8;10;59;33;26;19;6;13;10;9;0;0;NM3Dl
587;École doctorale Diversites, santé et développement en Amazonie;;6;Sciences humaines et humanités;2023;2022-23;2022;2022;2;1;1;13;11;2;1;1;0;0;0;1;0;V14tj
588;École doctorale Milieu insulaire tropical : dynamiques de développement, sociétés, patrimoine et culture dans l'espace Caraïbes-Amériques;;7;Sciences de la société;2023;2022-23;2022;2022;0;0;0;0;0;0;3;1;2;1;0;1;1;4W5IO
589;École doctorale Milieu insulaire tropical à risques : protection, valorisation , santé et développement;;5;Biologie, médecine et santé;2023;2022-23;2022;2022;0;0;0;0;0;0;2;2;0;2;0;0;0;2cqi3
591;École doctorale Physique, Sciences de l'Ingenieur, Materiaux, Énergie;PSIME;3;Sciences de la terre et de l'univers, espace;2023;2022-23;2022;2022;3;3;0;9;4;5;1;0;1;1;0;0;0;Hn5Om
593;École doctorale Droit, Gestion, sciences Économiques et Politique;DGEP;7;Sciences de la société;2023;2022-23;2022;2022;36;21;15;229;90;139;34;23;11;2;4;12;16;41pAm
597;École doctorale Sciences économiques et sciences de Gestion;EDGE;7;Sciences de la société;2023;2022-23;2022;2022;17;10;7;90;39;51;13;6;7;1;8;4;0;d8Zuu
598;École doctorale Sciences de La Mer et du Littoral;SML;4;Chimie;2023;2022-23;2022;2022;0;0;0;0;0;0;1;1;0;1;0;0;0;Smen6
600;École doctorale Écologie, Géosciences, Agronomie et Alimentation;EGAAL;10;Sciences agronomiques et écologiques;2023;2022-23;2022;2022;9;8;1;40;26;14;12;6;6;6;6;0;0;urS33
601;École doctorale Mathématiques et Sciences et Technologies de l'information et de la Communication;MathSTIC;1;Mathématiques et leurs interactions;2023;2022-23;2022;2022;16;2;14;49;8;41;21;3;18;18;3;0;0;3Ue20
606;École doctorale Chimie - Mécanique - Matériaux - Physique;C2MP;8;Sciences pour l'ingénieur;2023;2022-23;2022;2022;33;9;24;131;33;98;34;14;20;15;13;5;1;UkNR2
607;École doctorale Sciences et Ingénierie des Ressources Naturelles;SIReNA;5;Biologie, médecine et santé;2023;2022-23;2022;2022;2;2;0;2;2;0;0;0;0;0;0;0;0;vi9w2
607;École doctorale Sciences et Ingénierie des Ressources Naturelles;SIReNA;10;Sciences agronomiques et écologiques;2023;2022-23;2022;2022;24;14;10;107;61;46;28;13;15;6;22;0;0;vi9w2
609;École doctorale Sciences et Ingénierie des Matériaux, Mécanique, Énergétique -;SIMME;2;Physique;2023;2022-23;2022;2022;0;0;0;0;0;0;4;1;3;3;1;0;0;N4Rjy
609;École doctorale Sciences et Ingénierie des Matériaux, Mécanique, Énergétique -;SIMME;8;Sciences pour l'ingénieur;2023;2022-23;2022;2022;0;0;0;0;0;0;42;10;32;13;25;4;0;N4Rjy
610;École doctorale Sciences et Ingénierie des Systèmes, Mathématiques, Informatique;SISMI;1;Mathématiques et leurs interactions;2023;2022-23;2022;2022;0;0;0;0;0;0;3;0;3;0;2;1;0;dBCUB
614;École doctorale Chimie, Écologie, Géosciences, Agrosciences - Théodore Monod;CEGA;3;Sciences de la terre et de l'univers, espace;2023;2022-23;2022;2022;0;0;0;0;0;0;6;3;3;3;3;0;0;uc10I
618;École doctorale EUCLIDE;;3;Sciences de la terre et de l'univers, espace;2023;2022-23;2022;2022;5;2;3;11;2;9;6;3;3;3;3;0;0;qveTN
619;École doctorale Sciences Fondamentales et Santé;SFS;3;Sciences de la terre et de l'univers, espace;2023;2022-23;2022;2022;0;0;0;2;0;2;1;0;1;0;1;0;0;JiZVW
619;École doctorale Sciences Fondamentales et Santé;SFS;8;Sciences pour l'ingénieur;2023;2022-23;2022;2022;3;1;2;3;1;2;0;0;0;0;0;0;0;JiZVW
620;École doctorale Sciences du Numérique et de l'Ingénieur;SNI;1;Mathématiques et leurs interactions;2023;2022-23;2022;2022;4;3;1;8;4;4;0;0;0;0;0;0;0;Dr40w
620;École doctorale Sciences du Numérique et de l'Ingénieur;SNI;8;Sciences pour l'ingénieur;2023;2022-23;2022;2022;6;2;4;39;13;26;11;6;5;5;4;2;0;Dr40w
620;École doctorale Sciences du Numérique et de l'Ingénieur;SNI;9;Sciences et technologies de l'information et de la communication;2023;2022-23;2022;2022;7;2;5;39;9;30;8;2;6;6;2;0;0;Dr40w
620;École doctorale Sciences du Numérique et de l'Ingénieur;SNI;10;Sciences agronomiques et écologiques;2023;2022-23;2022;2022;0;0;0;1;1;0;0;0;0;0;0;0;0;Dr40w
625;École doctorale Mondes Anglophones, Germanophones, Iraniens, Indiens, et Études Européennes;MAGIIE;6;Sciences humaines et humanités;2023;2022-23;2022;2022;19;12;7;119;73;46;7;5;2;0;0;3;4;JiOMD
625;École doctorale Mondes Anglophones, Germanophones, Iraniens, Indiens, et Études Européennes;MAGIIE;7;Sciences de la société;2023;2022-23;2022;2022;5;4;1;21;13;8;2;0;2;0;0;1;1;JiOMD
626;École doctorale de l’Institut Polytechnique de Paris;;2;Physique;2023;2022-23;2022;2022;45;14;31;169;48;121;45;11;34;31;12;2;0;DL5fO
626;École doctorale de l’Institut Polytechnique de Paris;;4;Chimie;2023;2022-23;2022;2022;9;4;5;35;21;14;16;5;11;10;4;2;0;DL5fO
626;École doctorale de l’Institut Polytechnique de Paris;;7;Sciences de la société;2023;2022-23;2022;2022;24;9;15;103;47;56;28;11;17;2;10;11;5;DL5fO
630;École doctorale Droit, Economie et Management;DEM;7;Sciences de la société;2023;2022-23;2022;2022;38;15;23;246;116;130;25;6;19;3;5;8;9;78n8c
631;École doctorale Mathématiques, sciences du numérique et de leurs interactions;MADIS;1;Mathématiques et leurs interactions;2023;2022-23;2022;2022;9;0;9;37;10;27;13;2;11;8;5;0;0;OImap
631;École doctorale Mathématiques, sciences du numérique et de leurs interactions;MADIS;9;Sciences et technologies de l'information et de la communication;2023;2022-23;2022;2022;57;8;49;196;48;148;57;11;46;29;24;3;1;OImap
632;École doctorale Science de l’ingénierie et des systèmes;ENGSYS;9;Sciences et technologies de l'information et de la communication;2023;2022-23;2022;2022;24;7;17;116;29;87;34;4;30;16;18;0;0;1jT2e
633;École doctorale Cultures, Sociétés, Territoires;CST;6;Sciences humaines et humanités;2023;2022-23;2022;2022;10;8;2;53;31;22;4;2;2;1;2;1;0;54818
635;École doctorale Polytechnique Hauts-de-France;PHF;1;Mathématiques et leurs interactions;2023;2022-23;2022;2022;3;1;2;6;2;4;2;0;2;2;0;0;0;p2m23
636;;;1;Mathématiques et leurs interactions;2023;2022-23;2022;2022;1;0;1;14;0;14;0;0;0;0;0;0;0;
636;;;10;Sciences agronomiques et écologiques;2023;2022-23;2022;2022;0;0;0;11;6;5;2;0;2;1;1;0;0;
641;École doctorale Mathématiques et Sciences et Technologies du numérique, de l’Information et de la Communication;MaSTIC;8;Sciences pour l'ingénieur;2023;2022-23;2022;2022;4;2;2;6;2;4;3;1;2;1;2;0;0;4kq8w
644;;;1;Mathématiques et leurs interactions;2023;2022-23;2022;2022;6;2;4;20;5;15;2;1;1;1;1;0;0;
644;;;9;Sciences et technologies de l'information et de la communication;2023;2022-23;2022;2022;26;8;18;108;33;75;31;9;22;9;22;0;0;
645;;;10;Sciences agronomiques et écologiques;2023;2022-23;2022;2022;0;0;0;2;1;1;0;0;0;0;0;0;0;
648;;;1;Mathématiques et leurs interactions;2023;2022-23;2022;2022;1;0;1;3;0;3;3;0;3;3;0;0;0;
648;;;2;Physique;2023;2022-23;2022;2022;3;0;3;14;1;13;0;0;0;0;0;0;0;
648;;;8;Sciences pour l'ingénieur;2023;2022-23;2022;2022;19;7;12;80;27;53;24;5;19;10;10;4;0;
649;;;10;Sciences agronomiques et écologiques;2023;2022-23;2022;2022;1;0;1;7;3;4;0;0;0;0;0;0;0;
650;;;7;Sciences de la société;2023;2022-23;2022;2022;12;6;6;83;40;43;0;0;0;0;0;0;0;
653;École doctorale Sciences et Ingénierie;S&I;1;Mathématiques et leurs interactions;2023;2022-23;2022;2022;2;0;2;7;2;5;4;0;4;3;0;0;1;vpw2d
653;École doctorale Sciences et Ingénierie;S&I;4;Chimie;2023;2022-23;2022;2022;23;11;12;79;27;52;7;5;2;6;1;0;0;vpw2d
653;École doctorale Sciences et Ingénierie;S&I;8;Sciences pour l'ingénieur;2023;2022-23;2022;2022;1;1;0;6;2;4;8;4;4;7;0;1;0;vpw2d
653;École doctorale Sciences et Ingénierie;S&I;10;Sciences agronomiques et écologiques;2023;2022-23;2022;2022;0;0;0;2;0;2;0;0;0;0;0;0;0;vpw2d
7;École doctorale Georges Vedel - Droit public interne, science administrative et science politique;;7;Sciences de la société;2021;2020-21;2020;2020;28;10;18;162;65;97;14;6;8;0;4;1;9;Dw881
8;École doctorale Histoire du droit, philosophie du droit et sociologie du droit;;7;Sciences de la société;2021;2020-21;2020;2020;11;8;3;90;41;49;6;1;5;0;1;0;5;pGSed
31;École doctorale Pratiques et théories du sens;;6;Sciences humaines et humanités;2021;2020-21;2020;2020;57;31;26;377;210;167;35;19;16;2;6;13;14;1S466
34;École doctorale Matériaux;;4;Chimie;2021;2020-21;2020;2020;4;3;1;22;13;9;3;1;2;1;2;0;0;1Iufh
34;École doctorale Matériaux;;8;Sciences pour l'ingénieur;2021;2020-21;2020;2020;28;9;19;125;50;75;38;14;24;17;17;3;1;1Iufh
40;École doctorale Sciences chimiques;EDSC;4;Chimie;2021;2020-21;2020;2020;80;39;41;292;134;158;54;25;29;36;16;2;0;wde3D
41;École doctorale Droit;;7;Sciences de la société;2021;2020-21;2020;2020;55;22;33;324;156;168;28;9;19;2;2;10;14;KnOQK
42;École doctorale Entreprise, économie, société;EES;6;Sciences humaines et humanités;2021;2020-21;2020;2020;17;7;10;112;48;64;12;4;8;4;2;5;1;uO01d
60;École doctorale Territoires, temps, sociétés et développement;TTSD;7;Sciences de la société;2021;2020-21;2020;2020;17;12;5;88;49;39;5;3;2;0;1;3;1;fkIh6
62;École doctorale Sciences de la vie et de la santé;;3;Sciences de la terre et de l'univers, espace;2021;2020-21;2020;2020;0;0;0;2;2;0;0;0;0;0;0;0;0;vZzE7
62;École doctorale Sciences de la vie et de la santé;;5;Biologie, médecine et santé;2021;2020-21;2020;2020;191;107;84;724;411;313;133;74;59;43;67;20;3;vZzE7
74;École doctorale Sciences juridiques, politique et de gestion;SJPG;7;Sciences de la société;2021;2020-21;2020;2020;37;23;14;250;127;123;19;9;10;2;2;6;9;3A2RY
78;École doctorale Sociétés, langages, temps, connaissances;STLC;6;Sciences humaines et humanités;2021;2020-21;2020;2020;36;22;14;208;124;84;19;11;8;3;9;5;2;vLU3i
88;École doctorale Droit et science politique;DSP;7;Sciences de la société;2021;2020-21;2020;2020;25;13;12;223;99;124;21;6;15;0;3;9;9;elnAJ
101;École doctorale de Sciences juridiques;;7;Sciences de la société;2021;2020-21;2020;2020;45;24;21;197;94;103;9;5;4;2;1;2;4;569G2
104;École doctorale Sciences de la matière, du rayonnement et de l'environnement;SMRE;2;Physique;2021;2020-21;2020;2020;22;8;14;62;19;43;15;7;8;8;6;1;0;Q5iFz
104;École doctorale Sciences de la matière, du rayonnement et de l'environnement;SMRE;5;Biologie, médecine et santé;2021;2020-21;2020;2020;2;2;0;6;4;2;1;1;0;0;1;0;0;Q5iFz
105;École doctorale Terre, univers, environnement;;3;Sciences de la terre et de l'univers, espace;2021;2020-21;2020;2020;42;12;30;158;54;104;35;16;19;24;10;0;1;lcWAf
113;École doctorale Histoire;;6;Sciences humaines et humanités;2021;2020-21;2020;2020;47;19;28;278;130;148;30;16;14;3;2;8;17;G5wHs
139;École doctorale Connaissance, langage, modélisation;CLM;7;Sciences de la société;2021;2020-21;2020;2020;1;0;1;5;4;1;0;0;0;0;0;0;0;1lxGH
146;École doctorale Galilée;GALILEE;1;Mathématiques et leurs interactions;2021;2020-21;2020;2020;9;0;9;35;9;26;7;3;4;2;5;0;0;71hqm
146;École doctorale Galilée;GALILEE;9;Sciences et technologies de l'information et de la communication;2021;2020-21;2020;2020;15;5;10;46;11;35;9;6;3;7;2;0;0;71hqm
159;École doctorale Esthétique, sciences et technologies des arts;EDESTA;6;Sciences humaines et humanités;2021;2020-21;2020;2020;38;22;16;240;150;90;25;13;12;0;3;14;8;zj1Vj
166;École doctorale Information, structures et systèmes;I2S;1;Mathématiques et leurs interactions;2021;2020-21;2020;2020;23;5;18;78;24;54;12;3;9;7;3;2;0;2uO68
166;École doctorale Information, structures et systèmes;I2S;4;Chimie;2021;2020-21;2020;2020;2;1;1;5;3;2;1;1;0;1;0;0;0;2uO68
166;École doctorale Information, structures et systèmes;I2S;10;Sciences agronomiques et écologiques;2021;2020-21;2020;2020;0;0;0;1;0;1;1;0;1;1;0;0;0;2uO68
173;École doctorale Sciences de l'univers, de l'environnement et de l'espace;SDU2E;2;Physique;2021;2020-21;2020;2020;8;2;6;8;2;6;0;0;0;0;0;0;0;R0Z9c
173;École doctorale Sciences de l'univers, de l'environnement et de l'espace;SDU2E;5;Biologie, médecine et santé;2021;2020-21;2020;2020;0;0;0;1;0;1;0;0;0;0;0;0;0;R0Z9c
173;École doctorale Sciences de l'univers, de l'environnement et de l'espace;SDU2E;8;Sciences pour l'ingénieur;2021;2020-21;2020;2020;2;0;2;8;0;8;3;2;1;2;1;0;0;R0Z9c
178;École doctorale Sciences fondamentales;;1;Mathématiques et leurs interactions;2021;2020-21;2020;2020;4;0;4;17;2;15;2;1;1;1;0;0;1;1AiR7
178;École doctorale Sciences fondamentales;;2;Physique;2021;2020-21;2020;2020;7;5;2;25;11;14;4;1;3;4;0;0;0;1AiR7
178;École doctorale Sciences fondamentales;;4;Chimie;2021;2020-21;2020;2020;10;3;7;49;20;29;11;8;3;8;3;0;0;1AiR7
184;École doctorale Mathématiques et informatique de Marseille;;1;Mathématiques et leurs interactions;2021;2020-21;2020;2020;38;9;29;102;28;74;19;7;12;8;9;2;0;DDObG
188;École doctorale Histoire moderne et contemporaine;;6;Sciences humaines et humanités;2021;2020-21;2020;2020;21;9;12;154;74;80;13;2;11;0;6;4;3;RSZ7F
205;École doctorale Interdisciplinaire Sciences-Santé;EDISS;7;Sciences de la société;2021;2020-21;2020;2020;0;0;0;0;0;0;1;1;0;1;0;0;0;69W38
205;École doctorale Interdisciplinaire Sciences-Santé;EDISS;8;Sciences pour l'ingénieur;2021;2020-21;2020;2020;0;0;0;1;1;0;0;0;0;0;0;0;0;69W38
211;École doctorale Sciences exactes et leurs applications;ED SEA;3;Sciences de la terre et de l'univers, espace;2021;2020-21;2020;2020;7;6;1;20;9;11;5;1;4;0;5;0;0;1G1iC
211;École doctorale Sciences exactes et leurs applications;ED SEA;4;Chimie;2021;2020-21;2020;2020;32;16;16;100;45;55;23;7;16;17;5;1;0;1G1iC
211;École doctorale Sciences exactes et leurs applications;ED SEA;5;Biologie, médecine et santé;2021;2020-21;2020;2020;9;3;6;32;17;15;5;4;1;3;2;0;0;1G1iC
211;École doctorale Sciences exactes et leurs applications;ED SEA;9;Sciences et technologies de l'information et de la communication;2021;2020-21;2020;2020;5;1;4;24;6;18;1;0;1;1;0;0;0;1G1iC
211;École doctorale Sciences exactes et leurs applications;ED SEA;10;Sciences agronomiques et écologiques;2021;2020-21;2020;2020;2;2;0;5;3;2;0;0;0;0;0;0;0;1G1iC
217;École doctorale Mathématiques, sciences et technologies de l'information, informatique;MSTII;9;Sciences et technologies de l'information et de la communication;2021;2020-21;2020;2020;58;15;43;207;53;154;55;12;43;17;31;7;0;Ehx7v
220;École doctorale Électronique, électrotechnique, automatique, traitement du signal;EEATS;4;Chimie;2021;2020-21;2020;2020;1;1;0;1;1;0;0;0;0;0;0;0;0;IxEaw
220;École doctorale Électronique, électrotechnique, automatique, traitement du signal;EEATS;5;Biologie, médecine et santé;2021;2020-21;2020;2020;1;0;1;7;4;3;0;0;0;0;0;0;0;IxEaw
221;École doctorale Augustin Cournot - Sciences économiques et de gestion - Sciences, technologies et sociétés;EDAC;7;Sciences de la société;2021;2020-21;2020;2020;19;12;7;87;46;41;12;4;8;7;2;1;2;5z9rW
222;École doctorale Sciences chimiques;EDSC;5;Biologie, médecine et santé;2021;2020-21;2020;2020;0;0;0;6;1;5;3;2;1;3;0;0;0;AdU8Q
224;École doctorale Cognition, langage, interaction;;1;Mathématiques et leurs interactions;2021;2020-21;2020;2020;2;0;2;15;5;10;1;0;1;0;1;0;0;7v43e
227;École doctorale Sciences de la nature et de l'homme;;10;Sciences agronomiques et écologiques;2021;2020-21;2020;2020;8;3;5;30;11;19;20;11;9;10;10;0;0;xiDA5
250;École doctorale Sciences chimiques;;4;Chimie;2021;2020-21;2020;2020;32;14;18;125;57;68;24;7;17;19;5;0;0;O0Fav
251;École doctorale Sciences de l'environnement;;3;Sciences de la terre et de l'univers, espace;2021;2020-21;2020;2020;29;15;14;100;46;54;12;7;5;3;8;0;1;VR28y
251;École doctorale Sciences de l'environnement;;4;Chimie;2021;2020-21;2020;2020;2;1;1;22;11;11;3;2;1;1;2;0;0;VR28y
265;École doctorale Langues, littératures et sociétés du monde;;6;Sciences humaines et humanités;2021;2020-21;2020;2020;53;29;24;286;170;116;32;24;8;5;5;13;9;4YWGW
305;École doctorale Énergie et environnement;E2;5;Biologie, médecine et santé;2021;2020-21;2020;2020;11;5;6;32;15;17;7;4;3;6;1;0;0;Kbt8I
309;École doctorale Systèmes;EDSYS;8;Sciences pour l'ingénieur;2021;2020-21;2020;2020;17;5;12;67;18;49;21;10;11;11;10;0;0;8TT4b
326;École doctorale Comportement, langage, éducation, socialisation, cognition;CLESCO;7;Sciences de la société;2021;2020-21;2020;2020;2;1;1;9;7;2;0;0;0;0;0;0;0;nWIlG
328;École doctorale Arts, lettres, langues, philosophie et communication;ALLPH@;7;Sciences de la société;2021;2020-21;2020;2020;3;1;2;11;8;3;1;1;0;0;0;1;0;xLxMh
341;École doctorale Évolution, écosystèmes, microbiologie, modélisation;E2M2;5;Biologie, médecine et santé;2021;2020-21;2020;2020;19;10;9;107;56;51;20;13;7;9;9;2;0;J83I0
341;École doctorale Évolution, écosystèmes, microbiologie, modélisation;E2M2;10;Sciences agronomiques et écologiques;2021;2020-21;2020;2020;14;9;5;73;46;27;14;7;7;4;8;2;0;J83I0
355;École doctorale Espaces, cultures, sociétés;;6;Sciences humaines et humanités;2021;2020-21;2020;2020;38;17;21;192;93;99;29;18;11;4;11;6;8;2kMf5
356;École doctorale Cognition, langage, éducation;;6;Sciences humaines et humanités;2021;2020-21;2020;2020;80;39;41;266;151;115;34;20;14;9;13;12;0;55Cpz
391;École doctorale Sciences mécaniques, acoustique et électronique et robotique de Paris;SMAER;8;Sciences pour l'ingénieur;2021;2020-21;2020;2020;46;15;31;181;49;132;43;10;33;26;16;1;0;k0eue
395;École doctorale Milieux, cultures et sociétés du passé et du présent;MCSPP;6;Sciences humaines et humanités;2021;2020-21;2020;2020;48;30;18;217;136;81;42;26;16;3;2;13;24;2quEb
395;École doctorale Milieux, cultures et sociétés du passé et du présent;MCSPP;7;Sciences de la société;2021;2020-21;2020;2020;16;10;6;75;51;24;7;7;0;0;0;1;6;2quEb
405;École doctorale Économie, management,mathématiques et physique de Cergy;EM2C;2;Physique;2021;2020-21;2020;2020;4;0;4;10;1;9;3;1;2;2;1;0;0;QbwSB
413;École doctorale Sciences de la terre et de l'environnement;STE;3;Sciences de la terre et de l'univers, espace;2021;2020-21;2020;2020;10;2;8;48;15;33;19;7;12;11;7;1;0;u9BA9
413;École doctorale Sciences de la terre et de l'environnement;STE;5;Biologie, médecine et santé;2021;2020-21;2020;2020;1;0;1;1;0;1;0;0;0;0;0;0;0;u9BA9
414;École doctorale Sciences de la vie et de la santé;;5;Biologie, médecine et santé;2021;2020-21;2020;2020;121;71;50;472;273;199;112;62;50;43;63;4;2;YI4xS
417;École doctorale Sciences et Ingénierie;S&I;4;Chimie;2021;2020-21;2020;2020;7;2;5;29;10;19;5;4;1;2;2;1;0;SSBvE
433;École doctorale Concepts et langages;;6;Sciences humaines et humanités;2021;2020-21;2020;2020;59;27;32;446;253;193;38;20;18;2;9;20;7;v8q34
455;École doctorale Économie, Gestion, Information et Communication;EGIC;6;Sciences humaines et humanités;2021;2020-21;2020;2020;6;4;2;59;40;19;7;6;1;0;4;1;2;qCOg3
455;École doctorale Économie, Gestion, Information et Communication;EGIC;7;Sciences de la société;2021;2020-21;2020;2020;15;7;8;86;37;49;15;2;13;0;11;2;2;qCOg3
458;École doctorale Sciences écologiques, vétérinaires, agronomiques et bioingénieries;SEVAB;10;Sciences agronomiques et écologiques;2021;2020-21;2020;2020;63;38;25;228;128;100;61;34;27;32;24;5;0;Yf3TI
463;École doctorale Sciences du mouvement humain;SMH;5;Biologie, médecine et santé;2021;2020-21;2020;2020;16;11;5;67;35;32;11;6;5;2;7;1;1;UbtlY
465;École doctorale Économie Panthéon Sorbonne;EPS;1;Mathématiques et leurs interactions;2021;2020-21;2020;2020;3;1;2;16;2;14;6;4;2;4;2;0;0;MV68S
467;École doctorale Aéronautique, astronautique;AA;2;Physique;2021;2020-21;2020;2020;2;2;0;4;3;1;1;1;0;0;1;0;0;U7l45
467;École doctorale Aéronautique, astronautique;AA;6;Sciences humaines et humanités;2021;2020-21;2020;2020;1;1;0;7;4;3;1;0;1;0;0;0;1;U7l45
469;École doctorale du Pacifique;EDP;4;Chimie;2021;2020-21;2020;2020;1;1;0;6;5;1;2;1;1;0;0;2;0;t9Z2n
469;École doctorale du Pacifique;EDP;7;Sciences de la société;2021;2020-21;2020;2020;3;2;1;17;9;8;2;2;0;1;0;1;0;t9Z2n
469;École doctorale du Pacifique;EDP;8;Sciences pour l'ingénieur;2021;2020-21;2020;2020;1;0;1;4;1;3;1;0;1;0;1;0;0;t9Z2n
469;École doctorale du Pacifique;EDP;9;Sciences et technologies de l'information et de la communication;2021;2020-21;2020;2020;0;0;0;4;1;3;0;0;0;0;0;0;0;t9Z2n
472;École doctorale de l'EPHE;;3;Sciences de la terre et de l'univers, espace;2021;2020-21;2020;2020;1;1;0;8;4;4;1;1;0;0;0;1;0;27zK4
472;École doctorale de l'EPHE;;5;Biologie, médecine et santé;2021;2020-21;2020;2020;7;5;2;39;24;15;9;6;3;4;5;0;0;27zK4
474;École doctorale Interdisciplinaire européenne frontières du vivant;FDV;1;Mathématiques et leurs interactions;2021;2020-21;2020;2020;0;0;0;9;3;6;0;0;0;0;0;0;0;E727j
481;École doctorale Sciences sociales et humanités;SSH;6;Sciences humaines et humanités;2021;2020-21;2020;2020;29;14;15;124;68;56;13;9;4;5;0;3;5;E3z5j
483;École doctorale Histoire, géographie, aménagement, urbanisme, archéologie, science politique, sociologie, anthropologie;SCSO;6;Sciences humaines et humanités;2021;2020-21;2020;2020;49;26;23;340;177;163;36;22;14;4;8;10;14;hc6u4
488;École doctorale Sciences, ingénierie, santé;SIS;1;Mathématiques et leurs interactions;2021;2020-21;2020;2020;5;0;5;14;3;11;3;0;3;2;0;1;0;Fy2lK
488;École doctorale Sciences, ingénierie, santé;SIS;5;Biologie, médecine et santé;2021;2020-21;2020;2020;26;10;16;103;38;65;18;6;12;6;8;4;0;Fy2lK
488;École doctorale Sciences, ingénierie, santé;SIS;9;Sciences et technologies de l'information et de la communication;2021;2020-21;2020;2020;28;3;25;137;37;100;33;9;24;15;15;3;0;Fy2lK
489;École doctorale Sciences et ingénierie des systèmes, de l'environnement et des organisations;SISEO;7;Sciences de la société;2021;2020-21;2020;2020;7;4;3;36;19;17;6;4;2;2;4;0;0;6pT77
489;École doctorale Sciences et ingénierie des systèmes, de l'environnement et des organisations;SISEO;8;Sciences pour l'ingénieur;2021;2020-21;2020;2020;15;6;9;48;22;26;18;6;12;8;9;1;0;6pT77
489;École doctorale Sciences et ingénierie des systèmes, de l'environnement et des organisations;SISEO;9;Sciences et technologies de l'information et de la communication;2021;2020-21;2020;2020;5;3;2;16;6;10;6;3;3;4;2;0;0;6pT77
497;École doctorale Normande de Biologie Intégrative, Santé, Environnement;Ed NBISE;3;Sciences de la terre et de l'univers, espace;2021;2020-21;2020;2020;3;0;3;10;2;8;3;0;3;0;2;1;0;0D9Je
497;École doctorale Normande de Biologie Intégrative, Santé, Environnement;Ed NBISE;5;Biologie, médecine et santé;2021;2020-21;2020;2020;59;40;19;264;154;110;45;26;19;21;13;6;5;0D9Je
508;École doctorale Normande de chimie;EDNC;4;Chimie;2021;2020-21;2020;2020;58;21;37;188;73;115;31;14;17;22;8;1;0;E52OO
509;École doctorale Civilisations et sociétés euro-méditerranéennes et comparées;;7;Sciences de la société;2021;2020-21;2020;2020;12;5;7;119;47;72;11;2;9;1;3;2;5;9tbyG
510;École doctorale Ingénierie - Matériaux, mécanique, environnement, énergétique, procédés, production;IMEP2;8;Sciences pour l'ingénieur;2021;2020-21;2020;2020;122;40;82;452;145;307;87;29;58;55;22;10;0;Ce7NF
512;École doctorale Informatique et mathématiques;InfoMaths;1;Mathématiques et leurs interactions;2021;2020-21;2020;2020;23;5;18;102;18;84;18;5;13;11;6;0;1;t86bi
515;École doctorale Complexité du vivant;CdV;5;Biologie, médecine et santé;2021;2020-21;2020;2020;73;40;33;291;179;112;58;36;22;22;36;0;0;CbV9s
528;École doctorale Ville, transports et territoires;VTT;5;Biologie, médecine et santé;2021;2020-21;2020;2020;0;0;0;0;0;0;1;0;1;0;0;1;0;68zCc
528;École doctorale Ville, transports et territoires;VTT;8;Sciences pour l'ingénieur;2021;2020-21;2020;2020;2;0;2;23;6;17;6;1;5;1;2;2;1;68zCc
531;École doctorale Sciences, ingénierie et environnement;SIE;2;Physique;2021;2020-21;2020;2020;1;0;1;2;0;2;0;0;0;0;0;0;0;b5BYq
536;École doctorale Sciences et agrosciences;;2;Physique;2021;2020-21;2020;2020;0;0;0;1;0;1;0;0;0;0;0;0;0;pHfqe
537;École doctorale Culture et patrimoine;C&P;6;Sciences humaines et humanités;2021;2020-21;2020;2020;19;10;9;83;42;41;9;4;5;2;1;5;1;GxI4a
540;"École doctorale École transdisciplinaire ""lettres/sciences""";;6;Sciences humaines et humanités;2021;2020-21;2020;2020;29;13;16;191;86;105;17;9;8;1;6;6;4;tWWw7
542;École doctorale de sciences de La Réunion;STS;1;Mathématiques et leurs interactions;2021;2020-21;2020;2020;0;0;0;2;1;1;1;1;0;0;0;0;1;2pAql
542;École doctorale de sciences de La Réunion;STS;2;Physique;2021;2020-21;2020;2020;3;1;2;16;5;11;2;1;1;0;1;1;0;2pAql
542;École doctorale de sciences de La Réunion;STS;6;Sciences humaines et humanités;2021;2020-21;2020;2020;1;1;0;4;2;2;0;0;0;0;0;0;0;2pAql
542;École doctorale de sciences de La Réunion;STS;7;Sciences de la société;2021;2020-21;2020;2020;0;0;0;1;1;0;0;0;0;0;0;0;0;2pAql
542;École doctorale de sciences de La Réunion;STS;9;Sciences et technologies de l'information et de la communication;2021;2020-21;2020;2020;0;0;0;2;0;2;1;1;0;0;1;0;0;2pAql
542;École doctorale de sciences de La Réunion;STS;10;Sciences agronomiques et écologiques;2021;2020-21;2020;2020;2;1;1;14;9;5;4;2;2;1;3;0;0;2pAql
544;École doctorale Inter-Med : Espaces, temps, cultures;INTER-MED;7;Sciences de la société;2021;2020-21;2020;2020;12;3;9;117;49;68;7;5;2;0;1;4;2;7VjtD
546;École doctorale Abbé Grégoire;;6;Sciences humaines et humanités;2021;2020-21;2020;2020;44;21;23;176;92;84;24;17;7;0;8;9;7;ZSn7q
548;École doctorale Mer et Sciences;;9;Sciences et technologies de l'information et de la communication;2021;2020-21;2020;2020;8;1;7;25;6;19;7;3;4;1;4;1;1;QX0fS
549;École doctorale Santé, Sciences Biologiques et Chimie du Vivant;SSBCV;5;Biologie, médecine et santé;2021;2020-21;2020;2020;59;35;24;206;129;77;48;28;20;19;26;3;0;B9ggO
549;École doctorale Santé, Sciences Biologiques et Chimie du Vivant;SSBCV;8;Sciences pour l'ingénieur;2021;2020-21;2020;2020;0;0;0;1;1;0;0;0;0;0;0;0;0;B9ggO
552;École doctorale Énergie - Matériaux - Sciences de la Terre et de l'Univers;EMTSU;4;Chimie;2021;2020-21;2020;2020;8;4;4;41;24;17;6;4;2;4;2;0;0;NTZhw
554;École doctorale Environnements - Santé;E-S;2;Physique;2021;2020-21;2020;2020;0;0;0;3;1;2;1;0;1;0;0;1;0;ElyFU
554;École doctorale Environnements - Santé;E-S;6;Sciences humaines et humanités;2021;2020-21;2020;2020;0;0;0;7;2;5;4;3;1;3;1;0;0;ElyFU
562;École doctorale Bio Sorbonne Paris Cité;BioSPC;5;Biologie, médecine et santé;2021;2020-21;2020;2020;152;102;50;535;351;184;123;81;42;47;68;8;0;4Yju6
566;École doctorale Sciences du Sport, de la Motricité et du Mouvement Humain;SMMH;5;Biologie, médecine et santé;2021;2020-21;2020;2020;14;7;7;64;25;39;11;5;6;4;2;5;0;3iv8y
566;École doctorale Sciences du Sport, de la Motricité et du Mouvement Humain;SMMH;9;Sciences et technologies de l'information et de la communication;2021;2020-21;2020;2020;1;1;0;1;1;0;0;0;0;0;0;0;0;3iv8y
569;École doctorale Innovation thérapeutique : du fondamental à l'appliqué;;5;Biologie, médecine et santé;2021;2020-21;2020;2020;60;33;27;239;146;93;48;30;18;25;19;4;0;jx8ET
570;École doctorale Santé Publique;EDSP;1;Mathématiques et leurs interactions;2021;2020-21;2020;2020;0;0;0;4;2;2;2;1;1;0;2;0;0;9lgE4
570;École doctorale Santé Publique;EDSP;10;Sciences agronomiques et écologiques;2021;2020-21;2020;2020;1;1;0;1;1;0;0;0;0;0;0;0;0;9lgE4
573;École doctorale Interfaces : Approches Interdisciplinaires, Fondements, Applications et Innovation;ED INTERFACES;2;Physique;2021;2020-21;2020;2020;8;4;4;28;9;19;5;1;4;3;1;1;0;gG820
575;École doctorale Electrical, Optical, Bio : Physics and Engineering;EOBE;9;Sciences et technologies de l'information et de la communication;2021;2020-21;2020;2020;6;0;6;21;6;15;4;1;3;2;2;0;0;dfhyn
576;École doctorale Particules, Hadrons, Énergie, Noyau, Instrumentation, Imagerie, Cosmos et Simulation;PHENIICS;1;Mathématiques et leurs interactions;2021;2020-21;2020;2020;0;0;0;1;1;0;1;0;1;0;1;0;0;qC4rf
577;École doctorale Structure et dynamique des systèmes vivants;SDSV;4;Chimie;2021;2020-21;2020;2020;0;0;0;1;1;0;1;1;0;1;0;0;0;4bsxJ
579;École doctorale Sciences mécaniques et energétiques, matériaux et géosciences;SMEMaG;8;Sciences pour l'ingénieur;2021;2020-21;2020;2020;45;12;33;200;46;154;51;20;31;17;29;4;1;atMj7
583;École doctorale Risques et Société;;1;Mathématiques et leurs interactions;2021;2020-21;2020;2020;0;0;0;0;0;0;1;0;1;0;1;0;0;wUBi9
583;École doctorale Risques et Société;;3;Sciences de la terre et de l'univers, espace;2021;2020-21;2020;2020;2;1;1;3;2;1;2;0;2;0;2;0;0;wUBi9
583;École doctorale Risques et Société;;7;Sciences de la société;2021;2020-21;2020;2020;3;1;2;10;3;7;1;1;0;0;0;1;0;wUBi9
585;École doctorale Sciences, Technologie,  Sante;EDSTS;9;Sciences et technologies de l'information et de la communication;2021;2020-21;2020;2020;17;5;12;80;26;54;5;0;5;2;2;1;0;NM3Dl
585;École doctorale Sciences, Technologie,  Sante;EDSTS;10;Sciences agronomiques et écologiques;2021;2020-21;2020;2020;6;4;2;42;24;18;3;1;2;2;0;1;0;NM3Dl
586;École doctorale Sciences Humaines et Sociales;EDSHS;6;Sciences humaines et humanités;2021;2020-21;2020;2020;86;49;37;367;207;160;14;6;8;2;5;4;3;0RKVX
586;École doctorale Sciences Humaines et Sociales;EDSHS;7;Sciences de la société;2021;2020-21;2020;2020;12;7;5;138;70;68;6;3;3;0;3;2;1;0RKVX
587;École doctorale Diversites, santé et développement en Amazonie;;4;Chimie;2021;2020-21;2020;2020;1;0;1;1;0;1;0;0;0;0;0;0;0;V14tj
587;École doctorale Diversites, santé et développement en Amazonie;;6;Sciences humaines et humanités;2021;2020-21;2020;2020;4;2;2;17;10;7;0;0;0;0;0;0;0;V14tj
588;École doctorale Milieu insulaire tropical : dynamiques de développement, sociétés, patrimoine et culture dans l'espace Caraïbes-Amériques;;6;Sciences humaines et humanités;2021;2020-21;2020;2020;20;11;9;83;58;25;12;7;5;0;2;4;6;4W5IO
590;École doctorale Mathematiques, Information, Ingenierie des Systemes;MIIS;9;Sciences et technologies de l'information et de la communication;2021;2020-21;2020;2020;29;4;25;134;32;102;26;7;19;17;9;0;0;L20t5
592;École doctorale Lettres, Communication, Langues, Arts;LECLA;6;Sciences humaines et humanités;2021;2020-21;2020;2020;33;22;11;197;124;73;19;10;9;2;6;8;3;sY7f3
597;École doctorale Sciences économiques et sciences de Gestion;EDGE;7;Sciences de la société;2021;2020-21;2020;2020;43;19;24;195;79;116;46;21;25;12;17;14;3;d8Zuu
600;École doctorale Écologie, Géosciences, Agronomie et Alimentation;EGAAL;3;Sciences de la terre et de l'univers, espace;2021;2020-21;2020;2020;10;5;5;56;21;35;17;7;10;14;3;0;0;urS33
600;École doctorale Écologie, Géosciences, Agronomie et Alimentation;EGAAL;4;Chimie;2021;2020-21;2020;2020;0;0;0;4;2;2;0;0;0;0;0;0;0;urS33
600;École doctorale Écologie, Géosciences, Agronomie et Alimentation;EGAAL;10;Sciences agronomiques et écologiques;2021;2020-21;2020;2020;47;28;19;177;96;81;45;26;19;25;20;0;0;urS33
604;École doctorale Sociétés, Temps, Territoires;STT;6;Sciences humaines et humanités;2021;2020-21;2020;2020;74;42;32;362;171;191;41;21;20;1;7;18;15;SZI5T
604;École doctorale Sociétés, Temps, Territoires;STT;9;Sciences et technologies de l'information et de la communication;2021;2020-21;2020;2020;1;0;1;3;0;3;0;0;0;0;0;0;0;SZI5T
605;École doctorale Biologie Santé;ED BS;5;Biologie, médecine et santé;2021;2020-21;2020;2020;141;74;67;548;297;251;129;66;63;67;52;9;1;w8CxU
607;École doctorale Sciences et Ingénierie des Ressources Naturelles;SIReNA;10;Sciences agronomiques et écologiques;2021;2020-21;2020;2020;27;13;14;108;53;55;18;11;7;8;9;1;0;vi9w2
610;École doctorale Sciences et Ingénierie des Systèmes, Mathématiques, Informatique;SISMI;1;Mathématiques et leurs interactions;2021;2020-21;2020;2020;12;4;8;35;8;27;6;1;5;4;2;0;0;dBCUB
613;École doctorale Sciences de la Société, Territoires, Sciences Economiques et de Gestion;SSTSEG;7;Sciences de la société;2021;2020-21;2020;2020;37;16;21;138;62;76;14;4;10;1;4;4;5;6eLRF
614;École doctorale Chimie, Écologie, Géosciences, Agrosciences - Théodore Monod;CEGA;10;Sciences agronomiques et écologiques;2021;2020-21;2020;2020;1;0;1;11;3;8;3;2;1;2;0;1;0;uc10I
615;École doctorale Sciences Biologiques et Santé;SBS;5;Biologie, médecine et santé;2021;2020-21;2020;2020;39;23;16;166;93;73;33;19;14;19;13;1;0;TNa15
616;École doctorale Humanités et Langues;H&L;6;Sciences humaines et humanités;2021;2020-21;2020;2020;53;33;20;245;138;107;32;17;15;4;8;9;11;FYOlf
617;École doctorale Sciences de la Société : Territoires, Economie et Droit;SSTED;3;Sciences de la terre et de l'univers, espace;2021;2020-21;2020;2020;0;0;0;5;1;4;0;0;0;0;0;0;0;Kl9ZX
618;École doctorale EUCLIDE;;7;Sciences de la société;2021;2020-21;2020;2020;4;0;4;38;16;22;6;5;1;1;1;2;2;qveTN
620;École doctorale Sciences du Numérique et de l'Ingénieur;SNI;2;Physique;2021;2020-21;2020;2020;2;0;2;13;6;7;2;2;0;2;0;0;0;Dr40w
620;École doctorale Sciences du Numérique et de l'Ingénieur;SNI;9;Sciences et technologies de l'information et de la communication;2021;2020-21;2020;2020;14;2;12;48;9;39;7;1;6;3;3;1;0;Dr40w
622;École doctorale Sciences du langage;SDL;6;Sciences humaines et humanités;2021;2020-21;2020;2020;45;32;13;295;203;92;38;27;11;4;10;11;13;9DsG2
623;École doctorale Savoir, Sciences, Éducation;SSE;7;Sciences de la société;2021;2020-21;2020;2020;6;4;2;12;6;6;1;0;1;0;1;0;0;98lMD
624;École doctorale Sciences des Sociétés;SDS;6;Sciences humaines et humanités;2021;2020-21;2020;2020;25;14;11;167;92;75;27;16;11;3;2;12;10;cGIjW
626;École doctorale de l’Institut Polytechnique de Paris;;2;Physique;2021;2020-21;2020;2020;43;8;35;159;35;124;38;15;23;32;6;0;0;DL5fO
629;École doctorale Sciences sociales et Humanités;SSH;6;Sciences humaines et humanités;2021;2020-21;2020;2020;30;13;17;124;59;65;12;6;6;0;3;5;4;nnSns
34;École doctorale Matériaux;;3;Sciences de la terre et de l'univers, espace;2014;2013-14;2013;2013;0;0;0;0;0;0;1;0;1;;;;;1Iufh
37;École doctorale Sciences physiques pour l'ingénieur et microtechniques;SPIM;8;Sciences pour l'ingénieur;2014;2013-14;2013;2013;73;15;58;278;62;216;71;16;55;;;;;F7G1B
38;École doctorale Langages, espaces, temps, sociétés;;6;Sciences humaines et humanités;2014;2013-14;2013;2013;68;31;37;282;148;134;35;18;17;;;;;pGgDX
47;École doctorale Physique;;2;Physique;2014;2013-14;2013;2013;118;34;84;397;107;290;80;18;62;;;;;8kNpd
65;École doctorale Sciences de la Vie, Santé, Agronomie, Environnement;;10;Sciences agronomiques et écologiques;2014;2013-14;2013;2013;14;8;6;74;42;32;19;9;10;;;;;MAOG4
71;École doctorale Sciences pour l'ingénieur;;1;Mathématiques et leurs interactions;2014;2013-14;2013;2013;1;0;1;8;5;3;2;1;1;;;;;H6UYp
71;École doctorale Sciences pour l'ingénieur;;9;Sciences et technologies de l'information et de la communication;2014;2013-14;2013;2013;21;4;17;85;22;63;22;9;13;;;;;H6UYp
72;École doctorale Sciences pour l'ingénieur;SPI;9;Sciences et technologies de l'information et de la communication;2014;2013-14;2013;2013;108;29;79;361;101;260;87;28;59;;;;;47QPx
74;École doctorale Sciences juridiques, politique et de gestion;SJPG;7;Sciences de la société;2014;2013-14;2013;2013;61;29;32;284;135;149;19;11;8;;;;;3A2RY
84;École doctorale Sciences et technologies de l'information et de la communication;STIC;9;Sciences et technologies de l'information et de la communication;2014;2013-14;2013;2013;54;13;41;253;55;198;62;14;48;;;;;9wS2W
92;École doctorale Vie -  Agro - Santé;;4;Chimie;2014;2013-14;2013;2013;0;0;0;1;1;0;1;1;0;;;;;RjvXY
92;École doctorale Vie -  Agro - Santé;;10;Sciences agronomiques et écologiques;2014;2013-14;2013;2013;29;18;11;94;54;40;20;10;10;;;;;RjvXY
132;École doctorale Sciences du langage;;6;Sciences humaines et humanités;2014;2013-14;2013;2013;16;11;5;89;57;32;13;11;2;;;;;5AUF1
138;École doctorale Lettres, langues, spectacles;LLS;6;Sciences humaines et humanités;2014;2013-14;2013;2013;58;35;23;270;170;100;32;16;16;;;;;y9O3k
139;École doctorale Connaissance, langage, modélisation;CLM;1;Mathématiques et leurs interactions;2014;2013-14;2013;2013;3;0;3;6;1;5;0;0;0;;;;;1lxGH
139;École doctorale Connaissance, langage, modélisation;CLM;7;Sciences de la société;2014;2013-14;2013;2013;6;2;4;6;2;4;0;0;0;;;;;1lxGH
145;École doctorale Sciences du végétal : du gène à l'écosystème;;5;Biologie, médecine et santé;2014;2013-14;2013;2013;28;12;16;97;55;42;26;14;12;;;;;ubDmM
146;École doctorale Galilée;GALILEE;2;Physique;2014;2013-14;2013;2013;7;3;4;35;13;22;6;1;5;;;;;71hqm
146;École doctorale Galilée;GALILEE;4;Chimie;2014;2013-14;2013;2013;3;0;3;13;7;6;6;1;5;;;;;71hqm
146;École doctorale Galilée;GALILEE;9;Sciences et technologies de l'information et de la communication;2014;2013-14;2013;2013;1;1;0;47;17;30;18;4;14;;;;;71hqm
156;École doctorale Sciences de la mer;;5;Biologie, médecine et santé;2014;2013-14;2013;2013;22;14;8;67;41;26;13;4;9;;;;;EGY9P
160;École doctorale Électronique, électrotechnique, automatique;EEA;5;Biologie, médecine et santé;2014;2013-14;2013;2013;4;1;3;14;4;10;2;0;2;;;;;EgfMQ
160;École doctorale Électronique, électrotechnique, automatique;EEA;9;Sciences et technologies de l'information et de la communication;2014;2013-14;2013;2013;35;14;21;106;35;71;15;5;10;;;;;EgfMQ
166;École doctorale Information, structures et systèmes;I2S;3;Sciences de la terre et de l'univers, espace;2014;2013-14;2013;2013;1;1;0;3;1;2;1;1;0;;;;;2uO68
166;École doctorale Information, structures et systèmes;I2S;8;Sciences pour l'ingénieur;2014;2013-14;2013;2013;26;4;22;84;24;60;21;3;18;;;;;2uO68
173;École doctorale Sciences de l'univers, de l'environnement et de l'espace;SDU2E;3;Sciences de la terre et de l'univers, espace;2014;2013-14;2013;2013;81;23;58;293;99;194;56;21;35;;;;;R0Z9c
173;École doctorale Sciences de l'univers, de l'environnement et de l'espace;SDU2E;10;Sciences agronomiques et écologiques;2014;2013-14;2013;2013;8;3;5;31;16;15;4;4;0;;;;;R0Z9c
180;École doctorale Sciences humaines et sociales : cultures, individus, sociétés;SHS;7;Sciences de la société;2014;2013-14;2013;2013;39;26;13;146;92;54;15;12;3;;;;;D2BT3
181;École doctorale Structure, informations, matière et matériaux;Simem;2;Physique;2014;2013-14;2013;2013;12;3;9;42;9;33;21;5;16;;;;;c1D6f
182;École doctorale Physique et chimie-physique;;8;Sciences pour l'ingénieur;2014;2013-14;2013;2013;0;0;0;5;0;5;1;0;1;;;;;3My6I
205;École doctorale Interdisciplinaire Sciences-Santé;EDISS;5;Biologie, médecine et santé;2014;2013-14;2013;2013;45;30;15;175;93;82;38;23;15;;;;;69W38
206;École doctorale Chimie : chimie, procédés, environnement;;4;Chimie;2014;2013-14;2013;2013;77;33;44;324;153;171;91;46;45;;;;;m0UhD
206;École doctorale Chimie : chimie, procédés, environnement;;8;Sciences pour l'ingénieur;2014;2013-14;2013;2013;5;4;1;28;15;13;6;1;5;;;;;m0UhD
209;École doctorale Sciences physiques et de L'ingénieur;SPI;3;Sciences de la terre et de l'univers, espace;2014;2013-14;2013;2013;2;1;1;11;4;7;4;3;1;;;;;tZcIZ
209;École doctorale Sciences physiques et de L'ingénieur;SPI;8;Sciences pour l'ingénieur;2014;2013-14;2013;2013;25;4;21;80;21;59;36;13;23;;;;;tZcIZ
211;École doctorale Sciences exactes et leurs applications;ED SEA;1;Mathématiques et leurs interactions;2014;2013-14;2013;2013;4;1;3;28;7;21;9;4;5;;;;;1G1iC
211;École doctorale Sciences exactes et leurs applications;ED SEA;5;Biologie, médecine et santé;2014;2013-14;2013;2013;8;5;3;18;14;4;2;1;1;;;;;1G1iC
211;École doctorale Sciences exactes et leurs applications;ED SEA;8;Sciences pour l'ingénieur;2014;2013-14;2013;2013;7;1;6;37;6;31;7;2;5;;;;;1G1iC
211;École doctorale Sciences exactes et leurs applications;ED SEA;10;Sciences agronomiques et écologiques;2014;2013-14;2013;2013;0;0;0;10;6;4;4;0;4;;;;;1G1iC
216;École doctorale Ingénierie pour la santé, la cognition, l'environnement;EDISCE;3;Sciences de la terre et de l'univers, espace;2014;2013-14;2013;2013;1;0;1;1;0;1;0;0;0;;;;;fPs1t
216;École doctorale Ingénierie pour la santé, la cognition, l'environnement;EDISCE;5;Biologie, médecine et santé;2014;2013-14;2013;2013;25;8;17;114;45;69;20;6;14;;;;;fPs1t
216;École doctorale Ingénierie pour la santé, la cognition, l'environnement;EDISCE;6;Sciences humaines et humanités;2014;2013-14;2013;2013;11;7;4;46;30;16;9;5;4;;;;;fPs1t
216;École doctorale Ingénierie pour la santé, la cognition, l'environnement;EDISCE;8;Sciences pour l'ingénieur;2014;2013-14;2013;2013;9;4;5;15;6;9;0;0;0;;;;;fPs1t
216;École doctorale Ingénierie pour la santé, la cognition, l'environnement;EDISCE;10;Sciences agronomiques et écologiques;2014;2013-14;2013;2013;1;0;1;2;0;2;2;2;0;;;;;fPs1t
221;École doctorale Augustin Cournot - Sciences économiques et de gestion - Sciences, technologies et sociétés;EDAC;7;Sciences de la société;2014;2013-14;2013;2013;21;13;8;90;40;50;16;5;11;;;;;5z9rW
227;École doctorale Sciences de la nature et de l'homme;;3;Sciences de la terre et de l'univers, espace;2014;2013-14;2013;2013;0;0;0;4;2;2;0;0;0;;;;;xiDA5
227;École doctorale Sciences de la nature et de l'homme;;4;Chimie;2014;2013-14;2013;2013;0;0;0;1;1;0;0;0;0;;;;;xiDA5
227;École doctorale Sciences de la nature et de l'homme;;10;Sciences agronomiques et écologiques;2014;2013-14;2013;2013;12;7;5;22;12;10;3;1;2;;;;;xiDA5
240;École doctorale Sciences de l'homme et de la société;SHS;7;Sciences de la société;2014;2013-14;2013;2013;15;7;8;90;40;50;6;1;5;;;;;j345k
251;École doctorale Sciences de l'environnement;;6;Sciences humaines et humanités;2014;2013-14;2013;2013;2;1;1;10;7;3;3;2;1;;;;;VR28y
260;École doctorale pluridisciplinaire;;1;Mathématiques et leurs interactions;2014;2013-14;2013;2013;8;3;5;20;8;12;4;1;3;;;;;sCk1f
260;École doctorale pluridisciplinaire;;2;Physique;2014;2013-14;2013;2013;1;0;1;5;2;3;1;1;0;;;;;sCk1f
260;École doctorale pluridisciplinaire;;3;Sciences de la terre et de l'univers, espace;2014;2013-14;2013;2013;2;2;0;12;6;6;1;0;1;;;;;sCk1f
260;École doctorale pluridisciplinaire;;9;Sciences et technologies de l'information et de la communication;2014;2013-14;2013;2013;5;4;1;16;8;8;5;3;2;;;;;sCk1f
261;École doctorale Cognition, comportements, conduites humaines;3CH;6;Sciences humaines et humanités;2014;2013-14;2013;2013;43;37;6;143;114;29;34;23;11;;;;;KOLCy
263;École doctorale Sciences juridiques, économiques et de gestion;;7;Sciences de la société;2014;2013-14;2013;2013;32;13;19;176;81;95;12;8;4;;;;;1nUr6
265;École doctorale Langues, littératures et sociétés du monde;;7;Sciences de la société;2014;2013-14;2013;2013;13;5;8;41;22;19;3;1;2;;;;;4YWGW
268;École doctorale Langage et langues : description, théorisation, transmission;;6;Sciences humaines et humanités;2014;2013-14;2013;2013;65;46;19;330;245;85;44;30;14;;;;;wAIDE
269;École doctorale Mathématiques, sciences de l'information et de l'ingénieur;MSII;1;Mathématiques et leurs interactions;2014;2013-14;2013;2013;25;3;22;90;18;72;22;6;16;;;;;5E625
269;École doctorale Mathématiques, sciences de l'information et de l'ingénieur;MSII;2;Physique;2014;2013-14;2013;2013;2;1;1;4;1;3;2;1;1;;;;;5E625
270;École doctorale Théologie et sciences religieuses;;6;Sciences humaines et humanités;2014;2013-14;2013;2013;32;4;28;153;33;120;15;2;13;;;;;BRKC1
281;École doctorale Droit public et droit fiscal;;7;Sciences de la société;2014;2013-14;2013;2013;41;14;27;329;135;194;28;11;17;;;;;jr1Nt
285;École doctorale Sciences pratiques;;2;Physique;2014;2013-14;2013;2013;7;0;7;25;6;19;6;4;2;;;;;Jd3t2
286;École doctorale de l'Ehess;;6;Sciences humaines et humanités;2014;2013-14;2013;2013;138;60;78;730;394;336;86;49;37;;;;;2S146
287;École doctorale Sciences pour l'ingénieur;;4;Chimie;2014;2013-14;2013;2013;6;1;5;18;6;12;6;5;1;;;;;48Q1j
287;École doctorale Sciences pour l'ingénieur;;9;Sciences et technologies de l'information et de la communication;2014;2013-14;2013;2013;13;7;6;44;23;21;12;4;8;;;;;48Q1j
305;École doctorale Énergie et environnement;E2;9;Sciences et technologies de l'information et de la communication;2014;2013-14;2013;2013;7;4;3;11;4;7;0;0;0;;;;;Kbt8I
306;École doctorale Sciences des procédés, sciences des aliments;;3;Sciences de la terre et de l'univers, espace;2014;2013-14;2013;2013;0;0;0;0;0;0;1;1;0;;;;;adF7W
306;École doctorale Sciences des procédés, sciences des aliments;;4;Chimie;2014;2013-14;2013;2013;2;1;1;12;4;8;2;0;2;;;;;adF7W
306;École doctorale Sciences des procédés, sciences des aliments;;5;Biologie, médecine et santé;2014;2013-14;2013;2013;8;3;5;20;8;12;6;4;2;;;;;adF7W
309;École doctorale Systèmes;EDSYS;8;Sciences pour l'ingénieur;2014;2013-14;2013;2013;19;5;14;76;27;49;26;9;17;;;;;8TT4b
323;École doctorale Génie électrique, électronique et télécommunications;GEET;8;Sciences pour l'ingénieur;2014;2013-14;2013;2013;33;3;30;113;24;89;27;6;21;;;;;arcz6
323;École doctorale Génie électrique, électronique et télécommunications;GEET;9;Sciences et technologies de l'information et de la communication;2014;2013-14;2013;2013;35;11;24;114;35;79;40;8;32;;;;;arcz6
341;École doctorale Évolution, écosystèmes, microbiologie, modélisation;E2M2;3;Sciences de la terre et de l'univers, espace;2014;2013-14;2013;2013;4;0;4;15;4;11;6;4;2;;;;;J83I0
351;École doctorale Sciences physiques, mathématiques et de l'information pour l'ingénieur;SPMII;2;Physique;2014;2013-14;2013;2013;10;1;9;42;13;29;6;3;3;;;;;rY4EP
352;École doctorale Physique et sciences de la matière;;2;Physique;2014;2013-14;2013;2013;70;21;49;219;71;148;75;17;58;;;;;fb5YC
355;École doctorale Espaces, cultures, sociétés;;7;Sciences de la société;2014;2013-14;2013;2013;38;26;12;192;123;69;34;23;11;;;;;2kMf5
359;École doctorale Mathématiques, télécommunications, informatique, signal, systèmes, électronique;MATISSE;1;Mathématiques et leurs interactions;2014;2013-14;2013;2013;22;7;15;68;23;45;21;4;17;;;;;Y0r76
359;École doctorale Mathématiques, télécommunications, informatique, signal, systèmes, électronique;MATISSE;8;Sciences pour l'ingénieur;2014;2013-14;2013;2013;1;1;0;1;1;0;0;0;0;;;;;Y0r76
361;École doctorale Sciences et Technologies;ED ST;8;Sciences pour l'ingénieur;2014;2013-14;2013;2013;6;2;4;38;7;31;5;1;4;;;;;cOUmL
364;École doctorale Sciences fondamentales et appliquées;EDSFA;2;Physique;2014;2013-14;2013;2013;7;1;6;54;13;41;15;4;11;;;;;E483q
364;École doctorale Sciences fondamentales et appliquées;EDSFA;4;Chimie;2014;2013-14;2013;2013;12;3;9;39;21;18;4;3;1;;;;;E483q
364;École doctorale Sciences fondamentales et appliquées;EDSFA;10;Sciences agronomiques et écologiques;2014;2013-14;2013;2013;2;1;1;2;1;1;0;0;0;;;;;E483q
373;École doctorale Santé, information/communications et mathématiques, matière;SICMA;8;Sciences pour l'ingénieur;2014;2013-14;2013;2013;13;5;8;44;10;34;15;3;12;;;;;hTJF5
373;École doctorale Santé, information/communications et mathématiques, matière;SICMA;9;Sciences et technologies de l'information et de la communication;2014;2013-14;2013;2013;71;18;53;238;56;182;61;17;44;;;;;hTJF5
377;École doctorale Environnement et société;;3;Sciences de la terre et de l'univers, espace;2014;2013-14;2013;2013;1;0;1;11;4;7;0;0;0;;;;;ZMG5u
377;École doctorale Environnement et société;;6;Sciences humaines et humanités;2014;2013-14;2013;2013;11;7;4;57;42;15;3;2;1;;;;;ZMG5u
377;École doctorale Environnement et société;;7;Sciences de la société;2014;2013-14;2013;2013;5;3;2;25;9;16;3;0;3;;;;;ZMG5u
394;École doctorale Physiologie et physiopathologie;p2t;5;Biologie, médecine et santé;2014;2013-14;2013;2013;61;33;28;219;129;90;69;42;27;;;;;VMYmT
396;École doctorale Économie, organisations, société;EOS;7;Sciences de la société;2014;2013-14;2013;2013;58;30;28;259;138;121;57;24;33;;;;;Es5e7
398;École doctorale Géosciences, ressources naturelles et environnement;GRNE;3;Sciences de la terre et de l'univers, espace;2014;2013-14;2013;2013;46;23;23;162;70;92;46;18;28;;;;;Zi4Zf
400;École doctorale Savoirs scientifiques : épistémologie, histoire des sciences, didactique des disciplines;;5;Biologie, médecine et santé;2014;2013-14;2013;2013;8;1;7;34;17;17;2;1;1;;;;;nRax3
401;École doctorale Sciences sociales;;7;Sciences de la société;2014;2013-14;2013;2013;37;24;13;230;135;95;16;3;13;;;;;raQ7K
401;École doctorale Sciences sociales;;9;Sciences et technologies de l'information et de la communication;2014;2013-14;2013;2013;14;4;10;27;6;21;1;1;0;;;;;raQ7K
405;École doctorale Économie, management,mathématiques et physique de Cergy;EM2C;7;Sciences de la société;2014;2013-14;2013;2013;16;8;8;74;36;38;8;4;4;;;;;QbwSB
409;École doctorale Énergie, mécanique, matériaux;EMMA;4;Chimie;2014;2013-14;2013;2013;22;5;17;92;29;63;20;6;14;;;;;KXlbK
409;École doctorale Énergie, mécanique, matériaux;EMMA;8;Sciences pour l'ingénieur;2014;2013-14;2013;2013;26;5;21;111;14;97;22;3;19;;;;;KXlbK
410;École doctorale Sciences et ingénierie des ressources, procédés, produits, environnement;RP2E;3;Sciences de la terre et de l'univers, espace;2014;2013-14;2013;2013;25;11;14;116;40;76;25;12;13;;;;;Q5fxV
410;École doctorale Sciences et ingénierie des ressources, procédés, produits, environnement;RP2E;8;Sciences pour l'ingénieur;2014;2013-14;2013;2013;32;17;15;163;66;97;43;12;31;;;;;Q5fxV
412;École doctorale Lorraine de chimie et physique moléculaires : synthèses, expériences, simulations, applications : de la molécule aux édifices supramoléculaires;SESAMES;2;Physique;2014;2013-14;2013;2013;5;3;2;18;8;10;5;3;2;;;;;mvHX2
414;École doctorale Sciences de la vie et de la santé;;10;Sciences agronomiques et écologiques;2014;2013-14;2013;2013;2;0;2;9;7;2;0;0;0;;;;;YI4xS
418;École doctorale Cancérologie : Biologie, médecine, santé;;5;Biologie, médecine et santé;2014;2013-14;2013;2013;53;36;17;215;139;76;55;36;19;;;;;gYm19
420;École doctorale Santé publique Paris 11 - Paris 5;;5;Biologie, médecine et santé;2014;2013-14;2013;2013;43;30;13;140;90;50;22;14;8;;;;;3BNdi
423;École doctorale Des génomes aux organismes;;2;Physique;2014;2013-14;2013;2013;0;0;0;2;0;2;1;1;0;;;;;VguHK
425;École doctorale Innovation thérapeutique : du fondamental à l'appliqué;;5;Biologie, médecine et santé;2014;2013-14;2013;2013;54;28;26;209;122;87;44;34;10;;;;;DkgNy
435;École doctorale Agriculture, alimentation, biologie, environnement et santé;;3;Sciences de la terre et de l'univers, espace;2014;2013-14;2013;2013;14;8;6;64;36;28;21;7;14;;;;;mC35U
446;École doctorale Biologie - Santé;EDBSL;1;Mathématiques et leurs interactions;2014;2013-14;2013;2013;0;0;0;0;0;0;1;0;1;;;;;4iEUF
447;École doctorale de l'école polytechnique;;4;Chimie;2014;2013-14;2013;2013;19;8;11;64;21;43;15;4;11;;;;;zgCCh
447;École doctorale de l'école polytechnique;;8;Sciences pour l'ingénieur;2014;2013-14;2013;2013;20;5;15;80;23;57;26;5;21;;;;;zgCCh
455;École doctorale Économie, Gestion, Information et Communication;EGIC;7;Sciences de la société;2014;2013-14;2013;2013;19;6;13;90;38;52;8;5;3;;;;;qCOg3
459;École doctorale Sciences chimiques Balard;;4;Chimie;2014;2013-14;2013;2013;78;32;46;268;111;157;65;37;28;;;;;YFs2W
461;École doctorale Droit et science politique;;7;Sciences de la société;2014;2013-14;2013;2013;77;45;32;367;220;147;43;24;19;;;;;QGArN
467;École doctorale Aéronautique, astronautique;AA;5;Biologie, médecine et santé;2014;2013-14;2013;2013;0;0;0;1;1;0;0;0;0;;;;;U7l45
469;École doctorale du Pacifique;EDP;2;Physique;2014;2013-14;2013;2013;0;0;0;2;1;1;0;0;0;;;;;t9Z2n
474;École doctorale Interdisciplinaire européenne frontières du vivant;FDV;2;Physique;2014;2013-14;2013;2013;1;0;1;8;2;6;4;0;4;;;;;E727j
474;École doctorale Interdisciplinaire européenne frontières du vivant;FDV;7;Sciences de la société;2014;2013-14;2013;2013;0;0;0;1;0;1;0;0;0;;;;;E727j
476;École doctorale Neurosciences et cognition;NSCO;6;Sciences humaines et humanités;2014;2013-14;2013;2013;9;6;3;28;20;8;7;5;2;;;;;B1H0x
477;École doctorale Systèmes intégrés en biologie, agronomie, géosciences, hydrosciences, environnement;SIBAGHE;3;Sciences de la terre et de l'univers, espace;2014;2013-14;2013;2013;21;8;13;83;36;47;22;12;10;;;;;zfN3N
479;École doctorale Sciences juridiques et politiques;;7;Sciences de la société;2014;2013-14;2013;2013;74;33;41;439;206;233;59;25;34;;;;;34mid
482;École doctorale Sciences de la matière;SDM;2;Physique;2014;2013-14;2013;2013;35;14;21;129;42;87;31;6;25;;;;;kmeZ4
482;École doctorale Sciences de la matière;SDM;4;Chimie;2014;2013-14;2013;2013;74;33;41;268;113;155;67;27;40;;;;;kmeZ4
483;École doctorale Histoire, géographie, aménagement, urbanisme, archéologie, science politique, sociologie, anthropologie;SCSO;7;Sciences de la société;2014;2013-14;2013;2013;36;14;22;140;61;79;11;6;5;;;;;hc6u4
485;École doctorale Éducation, Psychologie, Information et Communication;EPIC;6;Sciences humaines et humanités;2014;2013-14;2013;2013;56;37;19;336;209;127;32;16;16;;;;;O82eL
487;École doctorale Philosophie;PHCR;6;Sciences humaines et humanités;2014;2013-14;2013;2013;31;13;18;187;77;110;19;10;9;;;;;3BRzJ
488;École doctorale Sciences, ingénierie, santé;SIS;5;Biologie, médecine et santé;2014;2013-14;2013;2013;27;13;14;71;30;41;20;8;12;;;;;Fy2lK
489;École doctorale Sciences et ingénierie des systèmes, de l'environnement et des organisations;SISEO;7;Sciences de la société;2014;2013-14;2013;2013;10;6;4;40;22;18;6;4;2;;;;;6pT77
492;École doctorale Droit;;7;Sciences de la société;2014;2013-14;2013;2013;61;33;28;353;176;177;42;19;23;;;;;kOQsX
493;École doctorale Erasme;;7;Sciences de la société;2014;2013-14;2013;2013;52;23;29;225;97;128;20;9;11;;;;;FPW4T
495;École doctorale Végétal, environnement, nutrition, agroalimentaire, mer;VENAM;10;Sciences agronomiques et écologiques;2014;2013-14;2013;2013;33;17;16;140;80;60;25;13;12;;;;;HL495
496;École doctorale Sociétés, cultures, échanges;SCE;6;Sciences humaines et humanités;2014;2013-14;2013;2013;78;46;32;325;201;124;33;19;14;;;;;633tC
497;École doctorale Normande de Biologie Intégrative, Santé, Environnement;Ed NBISE;3;Sciences de la terre et de l'univers, espace;2014;2013-14;2013;2013;1;0;1;11;5;6;2;1;1;;;;;0D9Je
500;École doctorale Matière, molécules, matériaux en Pays de Loire;3MPL;4;Chimie;2014;2013-14;2013;2013;35;16;19;138;53;85;41;18;23;;;;;822tM
501;École doctorale Droit, économie-gestion, sociétés, territoires;;6;Sciences humaines et humanités;2014;2013-14;2013;2013;9;3;6;48;17;31;6;1;5;;;;;wE7WM
506;École doctorale arts, lettres et langues;;6;Sciences humaines et humanités;2014;2013-14;2013;2013;42;25;17;221;150;71;26;15;11;;;;;m9yqI
510;École doctorale Ingénierie - Matériaux, mécanique, environnement, énergétique, procédés, production;IMEP2;4;Chimie;2014;2013-14;2013;2013;22;10;12;81;44;37;18;6;12;;;;;Ce7NF
510;École doctorale Ingénierie - Matériaux, mécanique, environnement, énergétique, procédés, production;IMEP2;9;Sciences et technologies de l'information et de la communication;2014;2013-14;2013;2013;1;0;1;3;0;3;0;0;0;;;;;Ce7NF
511;École doctorale Sciences et ingénierie;S&I;1;Mathématiques et leurs interactions;2014;2013-14;2013;2013;2;1;1;16;3;13;3;1;2;;;;;7aXuB
514;École doctorale Études anglophones, germanophones et européennes;EDEAGE;6;Sciences humaines et humanités;2014;2013-14;2013;2013;28;19;9;207;146;61;27;20;7;;;;;fuIQs
519;École doctorale Sciences humaines et sociales - Perspectives européennes;SHS-PE;9;Sciences et technologies de l'information et de la communication;2014;2013-14;2013;2013;2;1;1;10;8;2;1;1;0;;;;;2f5qs
522;École doctorale Sciences et ingénierie en matériaux, mécanique, énergétique et aéronautique;SI-MMEA;4;Chimie;2014;2013-14;2013;2013;9;4;5;35;16;19;13;5;8;;;;;82F19
523;École doctorale Sciences pour l'environnement - Gay Lussac;;5;Biologie, médecine et santé;2014;2013-14;2013;2013;9;6;3;28;17;11;1;1;0;;;;;6xD69
528;École doctorale Ville, transports et territoires;VTT;8;Sciences pour l'ingénieur;2014;2013-14;2013;2013;7;2;5;14;5;9;2;1;1;;;;;68zCc
531;École doctorale Sciences, ingénierie et environnement;SIE;4;Chimie;2014;2013-14;2013;2013;15;3;12;48;21;27;8;3;5;;;;;b5BYq
532;École doctorale Mathématiques et sciences et technologies de l'information et de la communication;MSTIC;9;Sciences et technologies de l'information et de la communication;2014;2013-14;2013;2013;52;14;38;174;46;128;39;18;21;;;;;t43KM
534;École doctorale Modélisation et instrumentation en physique, énergie, géosciences et environnement;MIPEGE;3;Sciences de la terre et de l'univers, espace;2014;2013-14;2013;2013;12;5;7;60;26;34;11;3;8;;;;;K93eR
539;École doctorale Sciences et technologies de Versailles;;4;Chimie;2014;2013-14;2013;2013;13;6;7;42;22;20;9;4;5;;;;;nv3h8
541;École doctorale de sciences humaines et sociales de La Réunion;SHS;7;Sciences de la société;2014;2013-14;2013;2013;15;6;9;52;26;26;2;2;0;;;;;21SpE
541;École doctorale de sciences humaines et sociales de La Réunion;SHS;8;Sciences pour l'ingénieur;2014;2013-14;2013;2013;0;0;0;0;0;0;1;1;0;;;;;21SpE
542;École doctorale de sciences de La Réunion;STS;3;Sciences de la terre et de l'univers, espace;2014;2013-14;2013;2013;0;0;0;10;6;4;3;2;1;;;;;2pAql
542;École doctorale de sciences de La Réunion;STS;4;Chimie;2014;2013-14;2013;2013;3;2;1;12;6;6;3;2;1;;;;;2pAql
542;École doctorale de sciences de La Réunion;STS;8;Sciences pour l'ingénieur;2014;2013-14;2013;2013;0;0;0;36;9;27;2;1;1;;;;;2pAql
542;École doctorale de sciences de La Réunion;STS;10;Sciences agronomiques et écologiques;2014;2013-14;2013;2013;9;5;4;33;11;22;0;0;0;;;;;2pAql
546;École doctorale Abbé Grégoire;;6;Sciences humaines et humanités;2014;2013-14;2013;2013;22;16;6;88;59;29;16;11;5;;;;;ZSn7q
547;École doctorale Sciences, Technologie, Santé;EDSTS;4;Chimie;2014;2013-14;2013;2013;16;7;9;75;36;39;33;18;15;;;;;wEdn2
548;École doctorale Mer et Sciences;;3;Sciences de la terre et de l'univers, espace;2014;2013-14;2013;2013;2;2;0;6;3;3;3;0;3;;;;;QX0fS
548;École doctorale Mer et Sciences;;9;Sciences et technologies de l'information et de la communication;2014;2013-14;2013;2013;2;0;2;8;0;8;2;0;2;;;;;QX0fS
549;École doctorale Santé, Sciences Biologiques et Chimie du Vivant;SSBCV;1;Mathématiques et leurs interactions;2014;2013-14;2013;2013;1;1;0;1;1;0;0;0;0;;;;;B9ggO
551;École doctorale Mathématiques, Informatique, Physique Théorique et Ingénierie des Systèmes;MIPTIS;9;Sciences et technologies de l'information et de la communication;2014;2013-14;2013;2013;20;1;19;74;17;57;20;1;19;;;;;Mpudz
552;École doctorale Énergie - Matériaux - Sciences de la Terre et de l'Univers;EMTSU;2;Physique;2014;2013-14;2013;2013;12;5;7;39;13;26;15;4;11;;;;;NTZhw
552;École doctorale Énergie - Matériaux - Sciences de la Terre et de l'Univers;EMTSU;5;Biologie, médecine et santé;2014;2013-14;2013;2013;2;1;1;22;10;12;8;3;5;;;;;NTZhw
553;École doctorale Carnot - Pasteur;;3;Sciences de la terre et de l'univers, espace;2014;2013-14;2013;2013;1;0;1;3;0;3;2;0;2;;;;;6h4Z7
554;École doctorale Environnements - Santé;E-S;10;Sciences agronomiques et écologiques;2014;2013-14;2013;2013;26;16;10;151;86;65;28;17;11;;;;;ElyFU
556;École doctorale Homme, Sociétés, Risques, Territoire;HSRT;6;Sciences humaines et humanités;2014;2013-14;2013;2013;49;26;23;240;115;125;39;18;21;;;;;5QEaX
558;École doctorale Histoire, Mémoire, Patrimoine, Langage;HMPL;9;Sciences et technologies de l'information et de la communication;2014;2013-14;2013;2013;4;2;2;4;2;2;0;0;0;;;;;uX3jT
34;École doctorale Matériaux;;4;Chimie;2015;2014-15;2014;2014;27;10;17;117;59;58;37;21;16;;;;;1Iufh
38;École doctorale Langages, espaces, temps, sociétés;;9;Sciences et technologies de l'information et de la communication;2015;2014-15;2014;2014;2;0;2;5;2;3;2;0;2;;;;;pGgDX
39;École doctorale Mathématiques et Informatique;EDMIB;1;Mathématiques et leurs interactions;2015;2014-15;2014;2014;34;7;27;100;22;78;21;3;18;;;;;TBj2X
41;École doctorale Droit;;7;Sciences de la société;2015;2014-15;2014;2014;55;26;29;322;153;169;35;16;19;;;;;KnOQK
50;École doctorale Langues, littératures et sciences humaines;LLSH;6;Sciences humaines et humanités;2015;2014-15;2014;2014;37;25;12;207;141;66;29;23;6;;;;;8THzQ
62;École doctorale Sciences de la vie et de la santé;;5;Biologie, médecine et santé;2015;2014-15;2014;2014;187;111;76;625;370;255;140;71;69;;;;;vZzE7
71;École doctorale Sciences pour l'ingénieur;;9;Sciences et technologies de l'information et de la communication;2015;2014-15;2014;2014;18;7;11;78;19;59;24;6;18;;;;;H6UYp
72;École doctorale Sciences pour l'ingénieur;SPI;8;Sciences pour l'ingénieur;2015;2014-15;2014;2014;52;12;40;274;68;206;69;19;50;;;;;47QPx
72;École doctorale Sciences pour l'ingénieur;SPI;9;Sciences et technologies de l'information et de la communication;2015;2014-15;2014;2014;120;29;91;423;110;313;107;33;74;;;;;47QPx
77;École doctorale Informatique, automatique, électronique, électrotechnique, mathématiques;IAEM;1;Mathématiques et leurs interactions;2015;2014-15;2014;2014;7;2;5;34;8;26;12;1;11;;;;;TCHTA
77;École doctorale Informatique, automatique, électronique, électrotechnique, mathématiques;IAEM;6;Sciences humaines et humanités;2015;2014-15;2014;2014;0;0;0;2;0;2;0;0;0;;;;;TCHTA
77;École doctorale Informatique, automatique, électronique, électrotechnique, mathématiques;IAEM;8;Sciences pour l'ingénieur;2015;2014-15;2014;2014;2;0;2;18;3;15;6;2;4;;;;;TCHTA
84;École doctorale Sciences et technologies de l'information et de la communication;STIC;1;Mathématiques et leurs interactions;2015;2014-15;2014;2014;3;0;3;11;1;10;1;1;0;;;;;9wS2W
86;École doctorale Sociétés, humanités, arts, lettres;LSHS;6;Sciences humaines et humanités;2015;2014-15;2014;2014;76;37;39;279;169;110;50;27;23;;;;;O8E6y
98;École doctorale Droit-Normandie;EDDN;7;Sciences de la société;2015;2014-15;2014;2014;33;13;20;153;67;86;8;4;4;;;;;9fYyW
101;École doctorale de Sciences juridiques;;7;Sciences de la société;2015;2014-15;2014;2014;42;18;24;252;137;115;35;19;16;;;;;569G2
122;École doctorale Europe latine - Amérique latine;;6;Sciences humaines et humanités;2015;2014-15;2014;2014;14;11;3;112;80;32;15;12;3;;;;;z9lZY
127;École doctorale Astronomie et astrophysique d'Ile de France;A&A;3;Sciences de la terre et de l'univers, espace;2015;2014-15;2014;2014;56;18;38;169;64;105;46;14;32;;;;;cPXrq
132;École doctorale Sciences du langage;;6;Sciences humaines et humanités;2015;2014-15;2014;2014;14;11;3;93;59;34;14;8;6;;;;;5AUF1
139;École doctorale Connaissance, langage, modélisation;CLM;1;Mathématiques et leurs interactions;2015;2014-15;2014;2014;4;1;3;9;1;8;2;1;1;;;;;1lxGH
142;École doctorale Mathématiques de la région Paris-Sud;;1;Mathématiques et leurs interactions;2015;2014-15;2014;2014;34;10;24;107;27;80;32;5;27;;;;;5XlH9
146;École doctorale Galilée;GALILEE;5;Biologie, médecine et santé;2015;2014-15;2014;2014;12;8;4;58;39;19;10;5;5;;;;;71hqm
156;École doctorale Sciences de la mer;;6;Sciences humaines et humanités;2015;2014-15;2014;2014;3;2;1;8;6;2;3;2;1;;;;;EGY9P
156;École doctorale Sciences de la mer;;7;Sciences de la société;2015;2014-15;2014;2014;3;1;2;14;6;8;6;3;3;;;;;EGY9P
156;École doctorale Sciences de la mer;;8;Sciences pour l'ingénieur;2015;2014-15;2014;2014;18;1;17;60;11;49;12;2;10;;;;;EGY9P
166;École doctorale Information, structures et systèmes;I2S;9;Sciences et technologies de l'information et de la communication;2015;2014-15;2014;2014;26;7;19;151;31;120;44;9;35;;;;;2uO68
178;École doctorale Sciences fondamentales;;1;Mathématiques et leurs interactions;2015;2014-15;2014;2014;5;1;4;17;3;14;3;1;2;;;;;1AiR7
178;École doctorale Sciences fondamentales;;2;Physique;2015;2014-15;2014;2014;11;3;8;37;7;30;7;1;6;;;;;1AiR7
178;École doctorale Sciences fondamentales;;3;Sciences de la terre et de l'univers, espace;2015;2014-15;2014;2014;5;4;1;32;15;17;10;6;4;;;;;1AiR7
180;École doctorale Sciences humaines et sociales : cultures, individus, sociétés;SHS;7;Sciences de la société;2015;2014-15;2014;2014;24;13;11;133;82;51;18;14;4;;;;;D2BT3
181;École doctorale Structure, informations, matière et matériaux;Simem;6;Sciences humaines et humanités;2015;2014-15;2014;2014;0;0;0;2;0;2;0;0;0;;;;;c1D6f
182;École doctorale Physique et chimie-physique;;2;Physique;2015;2014-15;2014;2014;30;8;22;136;29;107;39;10;29;;;;;3My6I
182;École doctorale Physique et chimie-physique;;3;Sciences de la terre et de l'univers, espace;2015;2014-15;2014;2014;4;0;4;12;2;10;1;1;0;;;;;3My6I
184;École doctorale Mathématiques et informatique de Marseille;;1;Mathématiques et leurs interactions;2015;2014-15;2014;2014;28;6;22;102;31;71;33;11;22;;;;;DDObG
184;École doctorale Mathématiques et informatique de Marseille;;8;Sciences pour l'ingénieur;2015;2014-15;2014;2014;3;1;2;18;4;14;5;1;4;;;;;DDObG
205;École doctorale Interdisciplinaire Sciences-Santé;EDISS;7;Sciences de la société;2015;2014-15;2014;2014;0;0;0;10;4;6;4;4;0;;;;;69W38
209;École doctorale Sciences physiques et de L'ingénieur;SPI;3;Sciences de la terre et de l'univers, espace;2015;2014-15;2014;2014;1;1;0;7;4;3;2;0;2;;;;;tZcIZ
211;École doctorale Sciences exactes et leurs applications;ED SEA;4;Chimie;2015;2014-15;2014;2014;15;5;10;72;41;31;22;13;9;;;;;1G1iC
211;École doctorale Sciences exactes et leurs applications;ED SEA;8;Sciences pour l'ingénieur;2015;2014-15;2014;2014;15;3;12;44;9;35;13;1;12;;;;;1G1iC
216;École doctorale Ingénierie pour la santé, la cognition, l'environnement;EDISCE;2;Physique;2015;2014-15;2014;2014;0;0;0;3;1;2;0;0;0;;;;;fPs1t
216;École doctorale Ingénierie pour la santé, la cognition, l'environnement;EDISCE;5;Biologie, médecine et santé;2015;2014-15;2014;2014;38;14;24;128;47;81;18;10;8;;;;;fPs1t
216;École doctorale Ingénierie pour la santé, la cognition, l'environnement;EDISCE;6;Sciences humaines et humanités;2015;2014-15;2014;2014;10;7;3;48;34;14;11;5;6;;;;;fPs1t
216;École doctorale Ingénierie pour la santé, la cognition, l'environnement;EDISCE;10;Sciences agronomiques et écologiques;2015;2014-15;2014;2014;1;1;0;3;1;2;0;0;0;;;;;fPs1t
217;École doctorale Mathématiques, sciences et technologies de l'information, informatique;MSTII;1;Mathématiques et leurs interactions;2015;2014-15;2014;2014;24;0;24;94;21;73;22;4;18;;;;;Ehx7v
217;École doctorale Mathématiques, sciences et technologies de l'information, informatique;MSTII;9;Sciences et technologies de l'information et de la communication;2015;2014-15;2014;2014;79;17;62;310;72;238;77;14;63;;;;;Ehx7v
220;École doctorale Électronique, électrotechnique, automatique, traitement du signal;EEATS;9;Sciences et technologies de l'information et de la communication;2015;2014-15;2014;2014;108;24;84;419;108;311;98;25;73;;;;;IxEaw
221;École doctorale Augustin Cournot - Sciences économiques et de gestion - Sciences, technologies et sociétés;EDAC;6;Sciences humaines et humanités;2015;2014-15;2014;2014;4;2;2;11;6;5;2;1;1;;;;;5z9rW
224;École doctorale Cognition, langage, interaction;;1;Mathématiques et leurs interactions;2015;2014-15;2014;2014;1;1;0;1;1;0;1;0;1;;;;;7v43e
224;École doctorale Cognition, langage, interaction;;9;Sciences et technologies de l'information et de la communication;2015;2014-15;2014;2014;2;1;1;10;2;8;2;1;1;;;;;7v43e
227;École doctorale Sciences de la nature et de l'homme;;3;Sciences de la terre et de l'univers, espace;2015;2014-15;2014;2014;3;1;2;6;3;3;1;1;0;;;;;xiDA5
227;École doctorale Sciences de la nature et de l'homme;;9;Sciences et technologies de l'information et de la communication;2015;2014-15;2014;2014;0;0;0;1;1;0;0;0;0;;;;;xiDA5
242;École doctorale Économie - Gestion - Normandie;;7;Sciences de la société;2015;2014-15;2014;2014;22;6;16;101;46;55;20;8;12;;;;;z35ku
251;École doctorale Sciences de l'environnement;;3;Sciences de la terre et de l'univers, espace;2015;2014-15;2014;2014;31;15;16;110;54;56;25;16;9;;;;;VR28y
260;École doctorale pluridisciplinaire;;10;Sciences agronomiques et écologiques;2015;2014-15;2014;2014;1;0;1;7;4;3;4;3;1;;;;;sCk1f
266;École doctorale Biologie, santé, environnement;BIOSE;5;Biologie, médecine et santé;2015;2014-15;2014;2014;43;23;20;159;82;77;40;23;17;;;;;386V9
269;École doctorale Mathématiques, sciences de l'information et de l'ingénieur;MSII;1;Mathématiques et leurs interactions;2015;2014-15;2014;2014;15;5;10;69;17;52;7;2;5;;;;;5E625
270;École doctorale Théologie et sciences religieuses;;6;Sciences humaines et humanités;2015;2014-15;2014;2014;27;11;16;160;40;120;17;5;12;;;;;BRKC1
284;École doctorale Droit et Science Politique;DSP;7;Sciences de la société;2015;2014-15;2014;2014;3;2;1;39;26;13;3;2;1;;;;;ahH92
285;École doctorale Sciences pratiques;;6;Sciences humaines et humanités;2015;2014-15;2014;2014;2;0;2;16;5;11;6;4;2;;;;;Jd3t2
287;École doctorale Sciences pour l'ingénieur;;8;Sciences pour l'ingénieur;2015;2014-15;2014;2014;35;9;26;158;55;103;38;14;24;;;;;48Q1j
305;École doctorale Énergie et environnement;E2;5;Biologie, médecine et santé;2015;2014-15;2014;2014;9;3;6;21;13;8;4;3;1;;;;;Kbt8I
306;École doctorale Sciences des procédés, sciences des aliments;;6;Sciences humaines et humanités;2015;2014-15;2014;2014;1;0;1;1;0;1;0;0;0;;;;;adF7W
306;École doctorale Sciences des procédés, sciences des aliments;;9;Sciences et technologies de l'information et de la communication;2015;2014-15;2014;2014;1;1;0;3;1;2;2;1;1;;;;;adF7W
306;École doctorale Sciences des procédés, sciences des aliments;;10;Sciences agronomiques et écologiques;2015;2014-15;2014;2014;10;6;4;26;13;13;15;12;3;;;;;adF7W
309;École doctorale Systèmes;EDSYS;8;Sciences pour l'ingénieur;2015;2014-15;2014;2014;16;7;9;71;27;44;15;6;9;;;;;8TT4b
323;École doctorale Génie électrique, électronique et télécommunications;GEET;3;Sciences de la terre et de l'univers, espace;2015;2014-15;2014;2014;1;0;1;2;1;1;1;1;0;;;;;arcz6
326;École doctorale Comportement, langage, éducation, socialisation, cognition;CLESCO;6;Sciences humaines et humanités;2015;2014-15;2014;2014;79;57;22;283;190;93;40;25;15;;;;;nWIlG
351;École doctorale Sciences physiques, mathématiques et de l'information pour l'ingénieur;SPMII;4;Chimie;2015;2014-15;2014;2014;1;0;1;10;4;6;3;0;3;;;;;rY4EP
353;École doctorale Sciences pour l'ingénieur : mécanique, physique, micro et nanoélectronique;;2;Physique;2015;2014-15;2014;2014;0;0;0;1;1;0;8;0;8;;;;;vk5Kp
353;École doctorale Sciences pour l'ingénieur : mécanique, physique, micro et nanoélectronique;;4;Chimie;2015;2014-15;2014;2014;1;0;1;3;2;1;1;1;0;;;;;vk5Kp
353;École doctorale Sciences pour l'ingénieur : mécanique, physique, micro et nanoélectronique;;9;Sciences et technologies de l'information et de la communication;2015;2014-15;2014;2014;33;3;30;42;6;36;4;1;3;;;;;vk5Kp
356;École doctorale Cognition, langage, éducation;;6;Sciences humaines et humanités;2015;2014-15;2014;2014;78;37;41;326;184;142;65;46;19;;;;;55Cpz
361;École doctorale Sciences et Technologies;ED ST;8;Sciences pour l'ingénieur;2015;2014-15;2014;2014;11;1;10;41;7;34;8;1;7;;;;;cOUmL
364;École doctorale Sciences fondamentales et appliquées;EDSFA;1;Mathématiques et leurs interactions;2015;2014-15;2014;2014;19;5;14;67;20;47;17;7;10;;;;;E483q
373;École doctorale Santé, information/communications et mathématiques, matière;SICMA;1;Mathématiques et leurs interactions;2015;2014-15;2014;2014;6;2;4;17;7;10;3;2;1;;;;;hTJF5
373;École doctorale Santé, information/communications et mathématiques, matière;SICMA;4;Chimie;2015;2014-15;2014;2014;3;2;1;15;6;9;6;5;1;;;;;hTJF5
373;École doctorale Santé, information/communications et mathématiques, matière;SICMA;5;Biologie, médecine et santé;2015;2014-15;2014;2014;23;11;12;83;37;46;19;10;9;;;;;hTJF5
377;École doctorale Environnement et société;;1;Mathématiques et leurs interactions;2015;2014-15;2014;2014;1;1;0;3;2;1;0;0;0;;;;;ZMG5u
377;École doctorale Environnement et société;;3;Sciences de la terre et de l'univers, espace;2015;2014-15;2014;2014;0;0;0;1;0;1;1;1;0;;;;;ZMG5u
377;École doctorale Environnement et société;;5;Biologie, médecine et santé;2015;2014-15;2014;2014;5;5;0;19;11;8;0;0;0;;;;;ZMG5u
377;École doctorale Environnement et société;;7;Sciences de la société;2015;2014-15;2014;2014;7;7;0;27;14;13;2;1;1;;;;;ZMG5u
393;École doctorale Pierre Louis de Santé Publique : Épidémiologie et Sciences de l'information biomédicale;PLSP;5;Biologie, médecine et santé;2015;2014-15;2014;2014;42;22;20;153;86;67;39;19;20;;;;;69445
394;École doctorale Physiologie et physiopathologie;p2t;5;Biologie, médecine et santé;2015;2014-15;2014;2014;63;38;25;241;148;93;57;29;28;;;;;VMYmT
400;École doctorale Savoirs scientifiques : épistémologie, histoire des sciences, didactique des disciplines;;7;Sciences de la société;2015;2014-15;2014;2014;2;1;1;6;3;3;1;1;0;;;;;nRax3
401;École doctorale Sciences sociales;;6;Sciences humaines et humanités;2015;2014-15;2014;2014;49;24;25;173;81;92;24;9;15;;;;;raQ7K
401;École doctorale Sciences sociales;;7;Sciences de la société;2015;2014-15;2014;2014;35;16;19;188;107;81;30;13;17;;;;;raQ7K
401;École doctorale Sciences sociales;;9;Sciences et technologies de l'information et de la communication;2015;2014-15;2014;2014;9;3;6;28;8;20;0;0;0;;;;;raQ7K
405;École doctorale Économie, management,mathématiques et physique de Cergy;EM2C;6;Sciences humaines et humanités;2015;2014-15;2014;2014;7;3;4;7;3;4;0;0;0;;;;;QbwSB
410;École doctorale Sciences et ingénierie des ressources, procédés, produits, environnement;RP2E;3;Sciences de la terre et de l'univers, espace;2015;2014-15;2014;2014;21;7;14;84;26;58;23;12;11;;;;;Q5fxV
410;École doctorale Sciences et ingénierie des ressources, procédés, produits, environnement;RP2E;8;Sciences pour l'ingénieur;2015;2014-15;2014;2014;32;12;20;99;42;57;61;19;42;;;;;Q5fxV
414;École doctorale Sciences de la vie et de la santé;;4;Chimie;2015;2014-15;2014;2014;0;0;0;3;2;1;0;0;0;;;;;YI4xS
417;École doctorale Sciences et Ingénierie;S&I;2;Physique;2015;2014-15;2014;2014;1;1;0;5;1;4;2;0;2;;;;;SSBvE
417;École doctorale Sciences et Ingénierie;S&I;8;Sciences pour l'ingénieur;2015;2014-15;2014;2014;10;3;7;49;13;36;9;2;7;;;;;SSBvE
417;École doctorale Sciences et Ingénierie;S&I;9;Sciences et technologies de l'information et de la communication;2015;2014-15;2014;2014;10;3;7;42;12;30;15;7;8;;;;;SSBvE
418;École doctorale Cancérologie : Biologie, médecine, santé;;5;Biologie, médecine et santé;2015;2014-15;2014;2014;61;39;22;230;149;81;43;24;19;;;;;gYm19
422;École doctorale Sciences et technologies de l'information, des télécommunications et des systèmes;;5;Biologie, médecine et santé;2015;2014-15;2014;2014;14;7;7;45;19;26;12;6;6;;;;;998UM
422;École doctorale Sciences et technologies de l'information, des télécommunications et des systèmes;;8;Sciences pour l'ingénieur;2015;2014-15;2014;2014;18;3;15;90;16;74;21;5;16;;;;;998UM
423;École doctorale Des génomes aux organismes;;5;Biologie, médecine et santé;2015;2014-15;2014;2014;34;22;12;125;70;55;34;14;20;;;;;VguHK
427;École doctorale Informatique Paris-sud;;9;Sciences et technologies de l'information et de la communication;2015;2014-15;2014;2014;45;12;33;162;42;120;47;12;35;;;;;u0T33
432;École doctorale Sciences des métiers de l'ingénieur;SMI;8;Sciences pour l'ingénieur;2015;2014-15;2014;2014;140;31;109;513;117;396;123;26;97;;;;;nSsHB
433;École doctorale Concepts et langages;;6;Sciences humaines et humanités;2015;2014-15;2014;2014;88;49;39;441;246;195;61;35;26;;;;;v8q34
433;École doctorale Concepts et langages;;9;Sciences et technologies de l'information et de la communication;2015;2014-15;2014;2014;5;1;4;33;16;17;10;7;3;;;;;v8q34
435;École doctorale Agriculture, alimentation, biologie, environnement et santé;;4;Chimie;2015;2014-15;2014;2014;0;0;0;1;0;1;0;0;0;;;;;mC35U
447;École doctorale de l'école polytechnique;;3;Sciences de la terre et de l'univers, espace;2015;2014-15;2014;2014;5;0;5;9;3;6;0;0;0;;;;;zgCCh
447;École doctorale de l'école polytechnique;;4;Chimie;2015;2014-15;2014;2014;10;4;6;54;20;34;14;4;10;;;;;zgCCh
447;École doctorale de l'école polytechnique;;5;Biologie, médecine et santé;2015;2014-15;2014;2014;4;2;2;15;6;9;0;0;0;;;;;zgCCh
447;École doctorale de l'école polytechnique;;6;Sciences humaines et humanités;2015;2014-15;2014;2014;6;0;6;32;7;25;5;2;3;;;;;zgCCh
447;École doctorale de l'école polytechnique;;8;Sciences pour l'ingénieur;2015;2014-15;2014;2014;21;6;15;80;24;56;17;7;10;;;;;zgCCh
450;École doctorale Recherches en psychanalyse et psychopathologie;PSY²;6;Sciences humaines et humanités;2015;2014-15;2014;2014;51;29;22;286;185;101;45;32;13;;;;;8jI3f
454;École doctorale Sciences de l'homme, du politique et du territoire;SHPT;6;Sciences humaines et humanités;2015;2014-15;2014;2014;39;18;21;215;112;103;34;17;17;;;;;Opv31
461;École doctorale Droit et science politique;;7;Sciences de la société;2015;2014-15;2014;2014;74;43;31;317;193;124;63;37;26;;;;;QGArN
463;École doctorale Sciences du mouvement humain;SMH;7;Sciences de la société;2015;2014-15;2014;2014;0;0;0;3;0;3;0;0;0;;;;;UbtlY
467;École doctorale Aéronautique, astronautique;AA;1;Mathématiques et leurs interactions;2015;2014-15;2014;2014;5;1;4;13;1;12;2;0;2;;;;;U7l45
467;École doctorale Aéronautique, astronautique;AA;6;Sciences humaines et humanités;2015;2014-15;2014;2014;1;0;1;5;1;4;1;1;0;;;;;U7l45
467;École doctorale Aéronautique, astronautique;AA;8;Sciences pour l'ingénieur;2015;2014-15;2014;2014;4;1;3;19;4;15;13;4;9;;;;;U7l45
472;École doctorale de l'EPHE;;7;Sciences de la société;2015;2014-15;2014;2014;10;7;3;15;9;6;1;1;0;;;;;27zK4
472;École doctorale de l'EPHE;;10;Sciences agronomiques et écologiques;2015;2014-15;2014;2014;7;4;3;15;6;9;0;0;0;;;;;27zK4
473;École doctorale Sciences de l'homme et de la société;SHS;6;Sciences humaines et humanités;2015;2014-15;2014;2014;140;77;63;566;335;231;74;43;31;;;;;8qKD9
477;École doctorale Systèmes intégrés en biologie, agronomie, géosciences, hydrosciences, environnement;SIBAGHE;5;Biologie, médecine et santé;2015;2014-15;2014;2014;6;4;2;56;33;23;17;7;10;;;;;zfN3N
479;École doctorale Sciences juridiques et politiques;;7;Sciences de la société;2015;2014-15;2014;2014;72;33;39;399;186;213;45;18;27;;;;;34mid
482;École doctorale Sciences de la matière;SDM;2;Physique;2015;2014-15;2014;2014;25;8;17;119;41;78;29;8;21;;;;;kmeZ4
483;École doctorale Histoire, géographie, aménagement, urbanisme, archéologie, science politique, sociologie, anthropologie;SCSO;7;Sciences de la société;2015;2014-15;2014;2014;40;27;13;214;100;114;44;27;17;;;;;hc6u4
484;École doctorale Lettres, langues, linguistique, arts;3LA;6;Sciences humaines et humanités;2015;2014-15;2014;2014;108;65;43;560;333;227;63;36;27;;;;;BlCQD
487;École doctorale Philosophie;PHCR;6;Sciences humaines et humanités;2015;2014-15;2014;2014;24;10;14;167;63;104;23;10;13;;;;;3BRzJ
489;École doctorale Sciences et ingénierie des systèmes, de l'environnement et des organisations;SISEO;3;Sciences de la terre et de l'univers, espace;2015;2014-15;2014;2014;2;1;1;17;10;7;4;3;1;;;;;6pT77
489;École doctorale Sciences et ingénierie des systèmes, de l'environnement et des organisations;SISEO;4;Chimie;2015;2014-15;2014;2014;0;0;0;7;4;3;2;0;2;;;;;6pT77
489;École doctorale Sciences et ingénierie des systèmes, de l'environnement et des organisations;SISEO;8;Sciences pour l'ingénieur;2015;2014-15;2014;2014;18;6;12;51;15;36;13;1;12;;;;;6pT77
500;École doctorale Matière, molécules, matériaux en Pays de Loire;3MPL;2;Physique;2015;2014-15;2014;2014;25;9;16;84;29;55;21;5;16;;;;;822tM
500;École doctorale Matière, molécules, matériaux en Pays de Loire;3MPL;9;Sciences et technologies de l'information et de la communication;2015;2014-15;2014;2014;0;0;0;1;0;1;0;0;0;;;;;822tM
500;École doctorale Matière, molécules, matériaux en Pays de Loire;3MPL;10;Sciences agronomiques et écologiques;2015;2014-15;2014;2014;0;0;0;1;0;1;0;0;0;;;;;822tM
502;École doctorale Biologie - Santé;;6;Sciences humaines et humanités;2015;2014-15;2014;2014;1;1;0;1;1;0;0;0;0;;;;;JCFV7
503;École doctorale Sciences et technologies de l'information et de mathématiques;STIM;1;Mathématiques et leurs interactions;2015;2014-15;2014;2014;15;3;12;53;14;39;17;5;12;;;;;JQevP
503;École doctorale Sciences et technologies de l'information et de mathématiques;STIM;2;Physique;2015;2014-15;2014;2014;1;0;1;2;0;2;0;0;0;;;;;JQevP
509;École doctorale Civilisations et sociétés euro-méditerranéennes et comparées;;7;Sciences de la société;2015;2014-15;2014;2014;13;6;7;91;39;52;15;6;9;;;;;9tbyG
510;École doctorale Ingénierie - Matériaux, mécanique, environnement, énergétique, procédés, production;IMEP2;3;Sciences de la terre et de l'univers, espace;2015;2014-15;2014;2014;1;0;1;1;0;1;0;0;0;;;;;Ce7NF
510;École doctorale Ingénierie - Matériaux, mécanique, environnement, énergétique, procédés, production;IMEP2;4;Chimie;2015;2014-15;2014;2014;17;7;10;77;38;39;22;10;12;;;;;Ce7NF
521;École doctorale Sciences et ingénierie pour l'information, mathématiques;S2I;2;Physique;2015;2014-15;2014;2014;5;0;5;21;2;19;0;0;0;;;;;V6i83
523;École doctorale Sciences pour l'environnement - Gay Lussac;;3;Sciences de la terre et de l'univers, espace;2015;2014-15;2014;2014;6;4;2;36;15;21;10;7;3;;;;;6xD69
525;"École doctorale Lettres, pensée, arts et histoire, ""Civilisation de l'antiquité à nos jours""";LPAH;6;Sciences humaines et humanités;2015;2014-15;2014;2014;50;27;23;252;157;95;35;15;20;;;;;19Rpr
526;École doctorale Sociétés et organisations;SORG;7;Sciences de la société;2015;2014-15;2014;2014;25;9;16;103;47;56;14;10;4;;;;;5F3Fd
530;École doctorale Organisations, marchés, institutions;OMI;5;Biologie, médecine et santé;2015;2014-15;2014;2014;1;1;0;2;2;0;0;0;0;;;;;4htv7
530;École doctorale Organisations, marchés, institutions;OMI;8;Sciences pour l'ingénieur;2015;2014-15;2014;2014;2;2;0;2;2;0;1;0;1;;;;;4htv7
531;École doctorale Sciences, ingénierie et environnement;SIE;3;Sciences de la terre et de l'univers, espace;2015;2014-15;2014;2014;9;4;5;41;19;22;14;9;5;;;;;b5BYq
534;École doctorale Modélisation et instrumentation en physique, énergie, géosciences et environnement;MIPEGE;1;Mathématiques et leurs interactions;2015;2014-15;2014;2014;0;0;0;1;0;1;0;0;0;;;;;K93eR
536;École doctorale Sciences et agrosciences;;4;Chimie;2015;2014-15;2014;2014;7;4;3;13;7;6;8;7;1;;;;;pHfqe
537;École doctorale Culture et patrimoine;C&P;6;Sciences humaines et humanités;2015;2014-15;2014;2014;11;6;5;28;13;15;7;4;3;;;;;GxI4a
538;École doctorale Culture, régulation, institutions et territoire;CRIT;6;Sciences humaines et humanités;2015;2014-15;2014;2014;21;15;6;135;83;52;10;3;7;;;;;8T505
539;École doctorale Sciences et technologies de Versailles;;3;Sciences de la terre et de l'univers, espace;2015;2014-15;2014;2014;1;1;0;6;2;4;0;0;0;;;;;nv3h8
542;École doctorale de sciences de La Réunion;STS;2;Physique;2015;2014-15;2014;2014;5;2;3;25;9;16;0;0;0;;;;;2pAql
546;École doctorale Abbé Grégoire;;6;Sciences humaines et humanités;2015;2014-15;2014;2014;29;15;14;133;78;55;19;14;5;;;;;ZSn7q
546;École doctorale Abbé Grégoire;;7;Sciences de la société;2015;2014-15;2014;2014;21;9;12;94;45;49;17;9;8;;;;;ZSn7q
547;École doctorale Sciences, Technologie, Santé;EDSTS;4;Chimie;2015;2014-15;2014;2014;22;5;17;64;23;41;16;10;6;;;;;wEdn2
547;École doctorale Sciences, Technologie, Santé;EDSTS;8;Sciences pour l'ingénieur;2015;2014-15;2014;2014;20;8;12;93;23;70;12;5;7;;;;;wEdn2
548;École doctorale Mer et Sciences;;3;Sciences de la terre et de l'univers, espace;2015;2014-15;2014;2014;0;0;0;4;4;0;2;0;2;;;;;QX0fS
548;École doctorale Mer et Sciences;;5;Biologie, médecine et santé;2015;2014-15;2014;2014;2;0;2;6;2;4;2;2;0;;;;;QX0fS
549;École doctorale Santé, Sciences Biologiques et Chimie du Vivant;SSBCV;1;Mathématiques et leurs interactions;2015;2014-15;2014;2014;0;0;0;1;1;0;0;0;0;;;;;B9ggO
549;École doctorale Santé, Sciences Biologiques et Chimie du Vivant;SSBCV;2;Physique;2015;2014-15;2014;2014;0;0;0;2;0;2;0;0;0;;;;;B9ggO
551;École doctorale Mathématiques, Informatique, Physique Théorique et Ingénierie des Systèmes;MIPTIS;2;Physique;2015;2014-15;2014;2014;3;0;3;5;1;4;1;0;1;;;;;Mpudz
551;École doctorale Mathématiques, Informatique, Physique Théorique et Ingénierie des Systèmes;MIPTIS;6;Sciences humaines et humanités;2015;2014-15;2014;2014;0;0;0;1;1;0;0;0;0;;;;;Mpudz
552;École doctorale Énergie - Matériaux - Sciences de la Terre et de l'Univers;EMTSU;5;Biologie, médecine et santé;2015;2014-15;2014;2014;4;1;3;15;6;9;8;4;4;;;;;NTZhw
552;École doctorale Énergie - Matériaux - Sciences de la Terre et de l'Univers;EMTSU;9;Sciences et technologies de l'information et de la communication;2015;2014-15;2014;2014;2;1;1;7;2;5;3;1;2;;;;;NTZhw
553;École doctorale Carnot - Pasteur;;3;Sciences de la terre et de l'univers, espace;2015;2014-15;2014;2014;0;0;0;4;0;4;1;0;1;;;;;6h4Z7
563;École doctorale Médicament - Toxicologie - Chimie - Imageries;MTCI;4;Chimie;2015;2014-15;2014;2014;12;4;8;43;19;24;12;7;5;;;;;j8uk1
6;École doctorale Droit privé;;7;Sciences de la société;2013;2012-13;2012;2012;59;28;31;302;144;158;32;14;18;;;;;UMnW1
20;École doctorale Civilisations, cultures, littératures et sociétés;;6;Sciences humaines et humanités;2013;2012-13;2012;2012;58;42;16;242;172;70;23;17;6;;;;;agjNi
22;École doctorale Mondes anciens et médiévaux;;6;Sciences humaines et humanités;2013;2012-13;2012;2012;41;27;14;218;137;81;44;24;20;;;;;fqCbl
34;École doctorale Matériaux;;1;Mathématiques et leurs interactions;2013;2012-13;2012;2012;2;2;0;3;2;1;2;0;2;;;;;1Iufh
34;École doctorale Matériaux;;3;Sciences de la terre et de l'univers, espace;2013;2012-13;2012;2012;2;1;1;6;4;2;6;5;1;;;;;1Iufh
38;École doctorale Langages, espaces, temps, sociétés;;6;Sciences humaines et humanités;2013;2012-13;2012;2012;61;30;31;281;150;131;43;25;18;;;;;pGgDX
38;École doctorale Langages, espaces, temps, sociétés;;7;Sciences de la société;2013;2012-13;2012;2012;9;6;3;36;22;14;3;2;1;;;;;pGgDX
72;École doctorale Sciences pour l'ingénieur;SPI;1;Mathématiques et leurs interactions;2013;2012-13;2012;2012;22;8;14;65;19;46;12;1;11;;;;;47QPx
72;École doctorale Sciences pour l'ingénieur;SPI;9;Sciences et technologies de l'information et de la communication;2013;2012-13;2012;2012;112;30;82;405;125;280;104;28;76;;;;;47QPx
77;École doctorale Informatique, automatique, électronique, électrotechnique, mathématiques;IAEM;8;Sciences pour l'ingénieur;2013;2012-13;2012;2012;8;2;6;20;4;16;14;1;13;;;;;TCHTA
77;École doctorale Informatique, automatique, électronique, électrotechnique, mathématiques;IAEM;9;Sciences et technologies de l'information et de la communication;2013;2012-13;2012;2012;56;14;42;225;55;170;55;14;41;;;;;TCHTA
104;École doctorale Sciences de la matière, du rayonnement et de l'environnement;SMRE;3;Sciences de la terre et de l'univers, espace;2013;2012-13;2012;2012;16;12;4;56;25;31;6;3;3;;;;;Q5iFz
104;École doctorale Sciences de la matière, du rayonnement et de l'environnement;SMRE;4;Chimie;2013;2012-13;2012;2012;60;21;39;248;84;164;69;26;43;;;;;Q5iFz
104;École doctorale Sciences de la matière, du rayonnement et de l'environnement;SMRE;5;Biologie, médecine et santé;2013;2012-13;2012;2012;4;0;4;21;9;12;3;3;0;;;;;Q5iFz
119;École doctorale Science politique;;7;Sciences de la société;2013;2012-13;2012;2012;20;9;11;117;62;55;15;9;6;;;;;eyibb
124;École doctorale Histoire de l'art et archéologie;;6;Sciences humaines et humanités;2013;2012-13;2012;2012;49;27;22;266;190;76;25;17;8;;;;;MBN4L
132;École doctorale Sciences du langage;;6;Sciences humaines et humanités;2013;2012-13;2012;2012;15;11;4;98;65;33;12;7;5;;;;;5AUF1
139;École doctorale Connaissance, langage, modélisation;CLM;1;Mathématiques et leurs interactions;2013;2012-13;2012;2012;1;0;1;3;1;2;1;0;1;;;;;1lxGH
139;École doctorale Connaissance, langage, modélisation;CLM;6;Sciences humaines et humanités;2013;2012-13;2012;2012;77;50;27;363;199;164;46;22;24;;;;;1lxGH
142;École doctorale Mathématiques de la région Paris-Sud;;1;Mathématiques et leurs interactions;2013;2012-13;2012;2012;34;10;24;113;26;87;21;4;17;;;;;5XlH9
145;École doctorale Sciences du végétal : du gène à l'écosystème;;5;Biologie, médecine et santé;2013;2012-13;2012;2012;22;14;8;56;35;21;24;13;11;;;;;ubDmM
145;École doctorale Sciences du végétal : du gène à l'écosystème;;10;Sciences agronomiques et écologiques;2013;2012-13;2012;2012;12;9;3;62;40;22;10;4;6;;;;;ubDmM
146;École doctorale Galilée;GALILEE;9;Sciences et technologies de l'information et de la communication;2013;2012-13;2012;2012;11;3;8;55;22;33;15;6;9;;;;;71hqm
154;École doctorale Sciences de la vie et de la santé;SVS;5;Biologie, médecine et santé;2013;2012-13;2012;2012;91;49;42;285;149;136;76;43;33;;;;;hLn36
157;École doctorale Génétique, cellulaire, immunologie, infectiologie et développement;GC2ID;5;Biologie, médecine et santé;2013;2012-13;2012;2012;71;44;27;260;180;80;78;52;26;;;;;Sl3l2
158;École doctorale Cerveau, cognition, comportement;3C;6;Sciences humaines et humanités;2013;2012-13;2012;2012;11;4;7;27;11;16;3;2;1;;;;;Il62F
160;École doctorale Électronique, électrotechnique, automatique;EEA;8;Sciences pour l'ingénieur;2013;2012-13;2012;2012;28;6;22;105;16;89;26;1;25;;;;;EgfMQ
160;École doctorale Électronique, électrotechnique, automatique;EEA;9;Sciences et technologies de l'information et de la communication;2013;2012-13;2012;2012;33;8;25;125;32;93;34;6;28;;;;;EgfMQ
178;École doctorale Sciences fondamentales;;1;Mathématiques et leurs interactions;2013;2012-13;2012;2012;6;1;5;17;5;12;4;1;3;;;;;1AiR7
178;École doctorale Sciences fondamentales;;2;Physique;2013;2012-13;2012;2012;12;2;10;35;7;28;7;1;6;;;;;1AiR7
181;École doctorale Structure, informations, matière et matériaux;Simem;8;Sciences pour l'ingénieur;2013;2012-13;2012;2012;3;1;2;25;5;20;6;3;3;;;;;c1D6f
182;École doctorale Physique et chimie-physique;;8;Sciences pour l'ingénieur;2013;2012-13;2012;2012;0;0;0;8;0;8;4;1;3;;;;;3My6I
209;École doctorale Sciences physiques et de L'ingénieur;SPI;2;Physique;2013;2012-13;2012;2012;27;4;23;78;13;65;21;7;14;;;;;tZcIZ
209;École doctorale Sciences physiques et de L'ingénieur;SPI;3;Sciences de la terre et de l'univers, espace;2013;2012-13;2012;2012;4;2;2;12;5;7;3;2;1;;;;;tZcIZ
209;École doctorale Sciences physiques et de L'ingénieur;SPI;9;Sciences et technologies de l'information et de la communication;2013;2012-13;2012;2012;37;9;28;132;25;107;37;14;23;;;;;tZcIZ
211;École doctorale Sciences exactes et leurs applications;ED SEA;4;Chimie;2013;2012-13;2012;2012;19;12;7;71;37;34;14;8;6;;;;;1G1iC
211;École doctorale Sciences exactes et leurs applications;ED SEA;5;Biologie, médecine et santé;2013;2012-13;2012;2012;4;4;0;12;10;2;2;1;1;;;;;1G1iC
216;École doctorale Ingénierie pour la santé, la cognition, l'environnement;EDISCE;5;Biologie, médecine et santé;2013;2012-13;2012;2012;38;16;22;113;49;64;24;11;13;;;;;fPs1t
216;École doctorale Ingénierie pour la santé, la cognition, l'environnement;EDISCE;6;Sciences humaines et humanités;2013;2012-13;2012;2012;14;11;3;48;31;17;8;5;3;;;;;fPs1t
222;École doctorale Sciences chimiques;EDSC;4;Chimie;2013;2012-13;2012;2012;69;25;44;248;109;139;72;35;37;;;;;AdU8Q
224;École doctorale Cognition, langage, interaction;;8;Sciences pour l'ingénieur;2013;2012-13;2012;2012;1;0;1;12;6;6;3;1;2;;;;;7v43e
234;École doctorale de Sciences Po;;7;Sciences de la société;2013;2012-13;2012;2012;72;34;38;387;209;178;73;41;32;;;;;ux756
245;École doctorale Sciences économiques, juridiques, politiques et de gestion;;7;Sciences de la société;2013;2012-13;2012;2012;47;24;23;237;102;135;23;8;15;;;;;ShLUg
254;École doctorale Sciences de la matière;;2;Physique;2013;2012-13;2012;2012;19;6;13;68;18;50;25;8;17;;;;;365F2
254;École doctorale Sciences de la matière;;3;Sciences de la terre et de l'univers, espace;2013;2012-13;2012;2012;13;6;7;55;24;31;19;10;9;;;;;365F2
254;École doctorale Sciences de la matière;;8;Sciences pour l'ingénieur;2013;2012-13;2012;2012;11;1;10;47;8;39;15;3;12;;;;;365F2
260;École doctorale pluridisciplinaire;;4;Chimie;2013;2012-13;2012;2012;3;2;1;17;10;7;2;2;0;;;;;sCk1f
269;École doctorale Mathématiques, sciences de l'information et de l'ingénieur;MSII;3;Sciences de la terre et de l'univers, espace;2013;2012-13;2012;2012;0;0;0;0;0;0;1;0;1;;;;;5E625
269;École doctorale Mathématiques, sciences de l'information et de l'ingénieur;MSII;5;Biologie, médecine et santé;2013;2012-13;2012;2012;0;0;0;2;1;1;0;0;0;;;;;5E625
269;École doctorale Mathématiques, sciences de l'information et de l'ingénieur;MSII;8;Sciences pour l'ingénieur;2013;2012-13;2012;2012;31;11;20;119;26;93;30;3;27;;;;;5E625
269;École doctorale Mathématiques, sciences de l'information et de l'ingénieur;MSII;9;Sciences et technologies de l'information et de la communication;2013;2012-13;2012;2012;0;0;0;2;0;2;0;0;0;;;;;5E625
275;École doctorale Sciences de gestion;EDSG;7;Sciences de la société;2013;2012-13;2012;2012;20;7;13;94;42;52;19;14;5;;;;;6QC4I
280;École doctorale Philosophie;;6;Sciences humaines et humanités;2013;2012-13;2012;2012;45;19;26;236;103;133;24;11;13;;;;;kJxnm
282;École doctorale Droit privé;;7;Sciences de la société;2013;2012-13;2012;2012;65;31;34;330;170;160;19;14;5;;;;;Gz5rp
286;École doctorale de l'Ehess;;6;Sciences humaines et humanités;2013;2012-13;2012;2012;138;67;71;660;380;280;75;39;36;;;;;2S146
286;École doctorale de l'Ehess;;7;Sciences de la société;2013;2012-13;2012;2012;166;104;62;735;437;298;126;63;63;;;;;2S146
288;École doctorale Ondes et matière;EDOM;2;Physique;2013;2012-13;2012;2012;41;9;32;163;42;121;54;19;35;;;;;kJrcx
304;École doctorale Sciences et environnements;;3;Sciences de la terre et de l'univers, espace;2013;2012-13;2012;2012;7;3;4;33;23;10;5;2;3;;;;;2ywZn
304;École doctorale Sciences et environnements;;7;Sciences de la société;2013;2012-13;2012;2012;7;3;4;20;12;8;1;0;1;;;;;2ywZn
305;École doctorale Énergie et environnement;E2;5;Biologie, médecine et santé;2013;2012-13;2012;2012;5;4;1;16;12;4;4;2;2;;;;;Kbt8I
305;École doctorale Énergie et environnement;E2;8;Sciences pour l'ingénieur;2013;2012-13;2012;2012;12;3;9;45;12;33;10;0;10;;;;;Kbt8I
305;École doctorale Énergie et environnement;E2;9;Sciences et technologies de l'information et de la communication;2013;2012-13;2012;2012;0;0;0;0;0;0;2;0;2;;;;;Kbt8I
306;École doctorale Sciences des procédés, sciences des aliments;;3;Sciences de la terre et de l'univers, espace;2013;2012-13;2012;2012;0;0;0;1;1;0;0;0;0;;;;;adF7W
309;École doctorale Systèmes;EDSYS;9;Sciences et technologies de l'information et de la communication;2013;2012-13;2012;2012;20;7;13;89;31;58;24;3;21;;;;;8TT4b
323;École doctorale Génie électrique, électronique et télécommunications;GEET;8;Sciences pour l'ingénieur;2013;2012-13;2012;2012;30;6;24;98;18;80;13;2;11;;;;;arcz6
323;École doctorale Génie électrique, électronique et télécommunications;GEET;9;Sciences et technologies de l'information et de la communication;2013;2012-13;2012;2012;42;12;30;128;40;88;45;9;36;;;;;arcz6
326;École doctorale Comportement, langage, éducation, socialisation, cognition;CLESCO;6;Sciences humaines et humanités;2013;2012-13;2012;2012;79;47;32;291;184;107;71;49;22;;;;;nWIlG
351;École doctorale Sciences physiques, mathématiques et de l'information pour l'ingénieur;SPMII;8;Sciences pour l'ingénieur;2013;2012-13;2012;2012;36;8;28;151;37;114;31;8;23;;;;;rY4EP
353;École doctorale Sciences pour l'ingénieur : mécanique, physique, micro et nanoélectronique;;2;Physique;2013;2012-13;2012;2012;11;3;8;11;3;8;8;1;7;;;;;vk5Kp
353;École doctorale Sciences pour l'ingénieur : mécanique, physique, micro et nanoélectronique;;4;Chimie;2013;2012-13;2012;2012;0;0;0;2;2;0;0;0;0;;;;;vk5Kp
356;École doctorale Cognition, langage, éducation;;6;Sciences humaines et humanités;2013;2012-13;2012;2012;69;42;27;325;190;135;50;35;15;;;;;55Cpz
361;École doctorale Sciences et Technologies;ED ST;9;Sciences et technologies de l'information et de la communication;2013;2012-13;2012;2012;28;12;16;122;44;78;24;8;16;;;;;cOUmL
364;École doctorale Sciences fondamentales et appliquées;EDSFA;8;Sciences pour l'ingénieur;2013;2012-13;2012;2012;20;6;14;76;17;59;17;8;9;;;;;E483q
370;École doctorale Lettres, sciences humaines et sociales;LSHS;7;Sciences de la société;2013;2012-13;2012;2012;2;2;0;5;4;1;0;0;0;;;;;xAXXx
373;École doctorale Santé, information/communications et mathématiques, matière;SICMA;4;Chimie;2013;2012-13;2012;2012;4;1;3;16;10;6;2;0;2;;;;;hTJF5
373;École doctorale Santé, information/communications et mathématiques, matière;SICMA;5;Biologie, médecine et santé;2013;2012-13;2012;2012;31;14;17;82;36;46;15;9;6;;;;;hTJF5
377;École doctorale Environnement et société;;1;Mathématiques et leurs interactions;2013;2012-13;2012;2012;2;0;2;5;3;2;2;1;1;;;;;ZMG5u
377;École doctorale Environnement et société;;9;Sciences et technologies de l'information et de la communication;2013;2012-13;2012;2012;2;1;1;10;1;9;2;1;1;;;;;ZMG5u
388;École doctorale Chimie physique et chimie analytique de Paris centre;CPCA;4;Chimie;2013;2012-13;2012;2012;58;24;34;204;92;112;62;32;30;;;;;M0Hnd
389;École doctorale La physique, de la particule à la matière condensée;;2;Physique;2013;2012-13;2012;2012;37;6;31;127;26;101;37;12;25;;;;;2ydfg
394;École doctorale Physiologie et physiopathologie;p2t;5;Biologie, médecine et santé;2013;2012-13;2012;2012;73;47;26;231;137;94;69;43;26;;;;;VMYmT
396;École doctorale Économie, organisations, société;EOS;6;Sciences humaines et humanités;2013;2012-13;2012;2012;4;2;2;41;16;25;6;4;2;;;;;Es5e7
396;École doctorale Économie, organisations, société;EOS;7;Sciences de la société;2013;2012-13;2012;2012;62;33;29;283;133;150;53;21;32;;;;;Es5e7
409;École doctorale Énergie, mécanique, matériaux;EMMA;8;Sciences pour l'ingénieur;2013;2012-13;2012;2012;28;1;27;107;12;95;33;8;25;;;;;KXlbK
413;École doctorale Sciences de la terre et de l'environnement;STE;3;Sciences de la terre et de l'univers, espace;2013;2012-13;2012;2012;13;5;8;79;35;44;13;5;8;;;;;u9BA9
414;École doctorale Sciences de la vie et de la santé;;5;Biologie, médecine et santé;2013;2012-13;2012;2012;129;83;46;492;273;219;136;67;69;;;;;YI4xS
417;École doctorale Sciences et Ingénierie;S&I;5;Biologie, médecine et santé;2013;2012-13;2012;2012;3;3;0;9;7;2;3;1;2;;;;;SSBvE
417;École doctorale Sciences et Ingénierie;S&I;9;Sciences et technologies de l'information et de la communication;2013;2012-13;2012;2012;9;2;7;52;14;38;11;2;9;;;;;SSBvE
420;École doctorale Santé publique Paris 11 - Paris 5;;1;Mathématiques et leurs interactions;2013;2012-13;2012;2012;2;1;1;14;9;5;4;4;0;;;;;3BNdi
422;École doctorale Sciences et technologies de l'information, des télécommunications et des systèmes;;9;Sciences et technologies de l'information et de la communication;2013;2012-13;2012;2012;76;18;58;316;79;237;71;15;56;;;;;998UM
423;École doctorale Des génomes aux organismes;;9;Sciences et technologies de l'information et de la communication;2013;2012-13;2012;2012;0;0;0;1;0;1;0;0;0;;;;;VguHK
425;École doctorale Innovation thérapeutique : du fondamental à l'appliqué;;4;Chimie;2013;2012-13;2012;2012;7;3;4;32;14;18;10;4;6;;;;;DkgNy
433;École doctorale Concepts et langages;;9;Sciences et technologies de l'information et de la communication;2013;2012-13;2012;2012;7;4;3;35;23;12;3;2;1;;;;;v8q34
446;École doctorale Biologie - Santé;EDBSL;9;Sciences et technologies de l'information et de la communication;2013;2012-13;2012;2012;0;0;0;0;0;0;2;2;0;;;;;4iEUF
447;École doctorale de l'école polytechnique;;9;Sciences et technologies de l'information et de la communication;2013;2012-13;2012;2012;20;0;20;79;13;66;10;0;10;;;;;zgCCh
450;École doctorale Recherches en psychanalyse et psychopathologie;PSY²;6;Sciences humaines et humanités;2013;2012-13;2012;2012;55;37;18;278;187;91;37;26;11;;;;;8jI3f
454;École doctorale Sciences de l'homme, du politique et du territoire;SHPT;6;Sciences humaines et humanités;2013;2012-13;2012;2012;52;23;29;145;67;78;29;12;17;;;;;Opv31
454;École doctorale Sciences de l'homme, du politique et du territoire;SHPT;7;Sciences de la société;2013;2012-13;2012;2012;25;12;13;231;116;115;13;8;5;;;;;Opv31
455;École doctorale Économie, Gestion, Information et Communication;EGIC;7;Sciences de la société;2013;2012-13;2012;2012;19;8;11;92;42;50;12;4;8;;;;;qCOg3
460;École doctorale Sciences juridiques;SJ;7;Sciences de la société;2013;2012-13;2012;2012;24;7;17;151;64;87;21;8;13;;;;;ZB5I5
461;École doctorale Droit et science politique;;7;Sciences de la société;2013;2012-13;2012;2012;96;54;42;376;219;157;62;30;32;;;;;QGArN
463;École doctorale Sciences du mouvement humain;SMH;8;Sciences pour l'ingénieur;2013;2012-13;2012;2012;4;0;4;15;4;11;5;1;4;;;;;UbtlY
465;École doctorale Économie Panthéon Sorbonne;EPS;1;Mathématiques et leurs interactions;2013;2012-13;2012;2012;5;0;5;33;10;23;0;0;0;;;;;MV68S
467;École doctorale Aéronautique, astronautique;AA;1;Mathématiques et leurs interactions;2013;2012-13;2012;2012;1;0;1;9;2;7;2;0;2;;;;;U7l45
467;École doctorale Aéronautique, astronautique;AA;6;Sciences humaines et humanités;2013;2012-13;2012;2012;2;1;1;6;2;4;0;0;0;;;;;U7l45
469;École doctorale du Pacifique;EDP;2;Physique;2013;2012-13;2012;2012;0;0;0;3;1;2;0;0;0;;;;;t9Z2n
469;École doctorale du Pacifique;EDP;3;Sciences de la terre et de l'univers, espace;2013;2012-13;2012;2012;1;0;1;10;3;7;1;1;0;;;;;t9Z2n
469;École doctorale du Pacifique;EDP;7;Sciences de la société;2013;2012-13;2012;2012;2;0;2;15;6;9;2;0;2;;;;;t9Z2n
470;École doctorale Chimie de Paris-Sud;;4;Chimie;2013;2012-13;2012;2012;69;35;34;247;108;139;57;30;27;;;;;aExpW
473;École doctorale Sciences de l'homme et de la société;SHS;6;Sciences humaines et humanités;2013;2012-13;2012;2012;129;75;54;560;342;218;63;35;28;;;;;8qKD9
474;École doctorale Interdisciplinaire européenne frontières du vivant;FDV;1;Mathématiques et leurs interactions;2013;2012-13;2012;2012;0;0;0;2;0;2;0;0;0;;;;;E727j
474;École doctorale Interdisciplinaire européenne frontières du vivant;FDV;10;Sciences agronomiques et écologiques;2013;2012-13;2012;2012;0;0;0;2;1;1;1;0;1;;;;;E727j
483;École doctorale Histoire, géographie, aménagement, urbanisme, archéologie, science politique, sociologie, anthropologie;SCSO;6;Sciences humaines et humanités;2013;2012-13;2012;2012;108;57;51;543;264;279;72;37;35;;;;;hc6u4
484;École doctorale Lettres, langues, linguistique, arts;3LA;6;Sciences humaines et humanités;2013;2012-13;2012;2012;107;61;46;529;319;210;63;32;31;;;;;BlCQD
488;École doctorale Sciences, ingénierie, santé;SIS;5;Biologie, médecine et santé;2013;2012-13;2012;2012;20;9;11;67;28;39;7;5;2;;;;;Fy2lK
488;École doctorale Sciences, ingénierie, santé;SIS;10;Sciences agronomiques et écologiques;2013;2012-13;2012;2012;2;2;0;6;5;1;1;0;1;;;;;Fy2lK
492;École doctorale Droit;;7;Sciences de la société;2013;2012-13;2012;2012;69;37;32;395;183;212;60;19;41;;;;;kOQsX
495;École doctorale Végétal, environnement, nutrition, agroalimentaire, mer;VENAM;4;Chimie;2013;2012-13;2012;2012;3;2;1;6;3;3;2;0;2;;;;;HL495
495;École doctorale Végétal, environnement, nutrition, agroalimentaire, mer;VENAM;5;Biologie, médecine et santé;2013;2012-13;2012;2012;12;7;5;54;33;21;8;3;5;;;;;HL495
498;École doctorale Sciences pour l'ingénieur, géosciences, architecture;SPIGA;8;Sciences pour l'ingénieur;2013;2012-13;2012;2012;93;24;69;345;91;254;96;23;73;;;;;0vlKH
503;École doctorale Sciences et technologies de l'information et de mathématiques;STIM;8;Sciences pour l'ingénieur;2013;2012-13;2012;2012;6;1;5;24;2;22;6;3;3;;;;;JQevP
506;École doctorale arts, lettres et langues;;6;Sciences humaines et humanités;2013;2012-13;2012;2012;42;30;12;225;153;72;30;22;8;;;;;m9yqI
509;École doctorale Civilisations et sociétés euro-méditerranéennes et comparées;;7;Sciences de la société;2013;2012-13;2012;2012;17;5;12;111;45;66;7;2;5;;;;;9tbyG
511;École doctorale Sciences et ingénierie;S&I;1;Mathématiques et leurs interactions;2013;2012-13;2012;2012;5;0;5;16;3;13;2;0;2;;;;;7aXuB
512;École doctorale Informatique et mathématiques;InfoMaths;1;Mathématiques et leurs interactions;2013;2012-13;2012;2012;23;4;19;79;17;62;23;2;21;;;;;t86bi
513;École doctorale Droit et sciences politiques, économiques et de gestion;DESPEG;7;Sciences de la société;2013;2012-13;2012;2012;92;43;49;413;211;202;43;26;17;;;;;aVHGU
515;École doctorale Complexité du vivant;CdV;5;Biologie, médecine et santé;2013;2012-13;2012;2012;63;39;24;258;157;101;67;38;29;;;;;CbV9s
517;École doctorale Particules, noyaux, cosmologie;;2;Physique;2013;2012-13;2012;2012;34;9;25;121;29;92;36;8;28;;;;;9kK48
519;École doctorale Sciences humaines et sociales - Perspectives européennes;SHS-PE;9;Sciences et technologies de l'information et de la communication;2013;2012-13;2012;2012;0;0;0;0;0;0;1;1;0;;;;;2f5qs
520;École doctorale Humanités;;6;Sciences humaines et humanités;2013;2012-13;2012;2012;99;59;40;437;275;162;52;34;18;;;;;rI175
522;École doctorale Sciences et ingénierie en matériaux, mécanique, énergétique et aéronautique;SI-MMEA;4;Chimie;2013;2012-13;2012;2012;10;4;6;42;19;23;8;3;5;;;;;82F19
523;École doctorale Sciences pour l'environnement - Gay Lussac;;10;Sciences agronomiques et écologiques;2013;2012-13;2012;2012;28;18;10;81;50;31;11;6;5;;;;;6xD69
528;École doctorale Ville, transports et territoires;VTT;6;Sciences humaines et humanités;2013;2012-13;2012;2012;32;12;20;176;96;80;23;13;10;;;;;68zCc
529;École doctorale Cultures et sociétés;CS;6;Sciences humaines et humanités;2013;2012-13;2012;2012;40;19;21;194;98;96;26;11;15;;;;;XU9tb
530;École doctorale Organisations, marchés, institutions;OMI;6;Sciences humaines et humanités;2013;2012-13;2012;2012;18;12;6;89;47;42;6;3;3;;;;;4htv7
531;École doctorale Sciences, ingénierie et environnement;SIE;4;Chimie;2013;2012-13;2012;2012;13;9;4;38;18;20;24;12;12;;;;;b5BYq
531;École doctorale Sciences, ingénierie et environnement;SIE;8;Sciences pour l'ingénieur;2013;2012-13;2012;2012;57;12;45;188;50;138;37;9;28;;;;;b5BYq
532;École doctorale Mathématiques et sciences et technologies de l'information et de la communication;MSTIC;1;Mathématiques et leurs interactions;2013;2012-13;2012;2012;24;6;18;68;18;50;19;5;14;;;;;t43KM
532;École doctorale Mathématiques et sciences et technologies de l'information et de la communication;MSTIC;3;Sciences de la terre et de l'univers, espace;2013;2012-13;2012;2012;6;2;4;20;6;14;3;1;2;;;;;t43KM
535;École doctorale Sciences de la société;SDS;7;Sciences de la société;2013;2012-13;2012;2012;30;15;15;102;58;44;11;3;8;;;;;iEUOV
538;École doctorale Culture, régulation, institutions et territoire;CRIT;7;Sciences de la société;2013;2012-13;2012;2012;50;24;26;241;115;126;21;10;11;;;;;8T505
539;École doctorale Sciences et technologies de Versailles;;1;Mathématiques et leurs interactions;2013;2012-13;2012;2012;2;1;1;11;4;7;0;0;0;;;;;nv3h8
539;École doctorale Sciences et technologies de Versailles;;4;Chimie;2013;2012-13;2012;2012;11;6;5;41;21;20;8;4;4;;;;;nv3h8
540;"École doctorale École transdisciplinaire ""lettres/sciences""";;3;Sciences de la terre et de l'univers, espace;2013;2012-13;2012;2012;1;1;0;2;2;0;0;0;0;;;;;tWWw7
542;École doctorale de sciences de La Réunion;STS;3;Sciences de la terre et de l'univers, espace;2013;2012-13;2012;2012;7;5;2;12;8;4;5;3;2;;;;;2pAql
542;École doctorale de sciences de La Réunion;STS;4;Chimie;2013;2012-13;2012;2012;3;1;2;13;7;6;1;1;0;;;;;2pAql
542;École doctorale de sciences de La Réunion;STS;6;Sciences humaines et humanités;2013;2012-13;2012;2012;1;0;1;3;1;2;2;2;0;;;;;2pAql
543;École doctorale de Dauphine;;7;Sciences de la société;2013;2012-13;2012;2012;91;40;51;347;173;174;57;30;27;;;;;u8w6A
546;École doctorale Abbé Grégoire;;9;Sciences et technologies de l'information et de la communication;2013;2012-13;2012;2012;29;9;20;63;29;34;0;0;0;;;;;ZSn7q
547;École doctorale Sciences, Technologie, Santé;EDSTS;1;Mathématiques et leurs interactions;2013;2012-13;2012;2012;6;3;3;25;7;18;5;1;4;;;;;wEdn2
548;École doctorale Mer et Sciences;;5;Biologie, médecine et santé;2013;2012-13;2012;2012;1;0;1;8;5;3;0;0;0;;;;;QX0fS
549;École doctorale Santé, Sciences Biologiques et Chimie du Vivant;SSBCV;4;Chimie;2013;2012-13;2012;2012;10;6;4;33;20;13;14;9;5;;;;;B9ggO
551;École doctorale Mathématiques, Informatique, Physique Théorique et Ingénierie des Systèmes;MIPTIS;9;Sciences et technologies de l'information et de la communication;2013;2012-13;2012;2012;25;10;15;77;17;60;17;1;16;;;;;Mpudz
552;École doctorale Énergie - Matériaux - Sciences de la Terre et de l'Univers;EMTSU;1;Mathématiques et leurs interactions;2013;2012-13;2012;2012;0;0;0;1;0;1;0;0;0;;;;;NTZhw
552;École doctorale Énergie - Matériaux - Sciences de la Terre et de l'Univers;EMTSU;9;Sciences et technologies de l'information et de la communication;2013;2012-13;2012;2012;3;1;2;12;3;9;5;1;4;;;;;NTZhw
553;École doctorale Carnot - Pasteur;;7;Sciences de la société;2013;2012-13;2012;2012;3;0;3;7;1;6;3;0;3;;;;;6h4Z7
554;École doctorale Environnements - Santé;E-S;5;Biologie, médecine et santé;2013;2012-13;2012;2012;89;45;44;361;200;161;93;49;44;;;;;ElyFU
554;École doctorale Environnements - Santé;E-S;6;Sciences humaines et humanités;2013;2012-13;2012;2012;2;1;1;21;12;9;4;4;0;;;;;ElyFU
555;École doctorale Sciences de l'Homme et de la Société;SHS;6;Sciences humaines et humanités;2013;2012-13;2012;2012;67;29;38;326;167;159;39;19;20;;;;;44G6m
7;École doctorale Georges Vedel - Droit public interne, science administrative et science politique;;7;Sciences de la société;2017;2016-17;2016;2016;30;9;21;183;67;116;16;6;10;;;;;Dw881
37;École doctorale Sciences physiques pour l'ingénieur et microtechniques;SPIM;8;Sciences pour l'ingénieur;2017;2016-17;2016;2016;47;11;36;199;48;151;55;11;44;;;;;F7G1B
40;École doctorale Sciences chimiques;EDSC;4;Chimie;2017;2016-17;2016;2016;77;38;39;309;142;167;82;32;50;;;;;wde3D
42;École doctorale Entreprise, économie, société;EES;7;Sciences de la société;2017;2016-17;2016;2016;27;9;18;103;40;63;27;11;16;;;;;uO01d
47;École doctorale Physique;;8;Sciences pour l'ingénieur;2017;2016-17;2016;2016;2;0;2;10;1;9;1;1;0;;;;;8kNpd
52;École doctorale Physique et astrophysique de Lyon;PHAST;3;Sciences de la terre et de l'univers, espace;2017;2016-17;2016;2016;7;2;5;22;10;12;4;2;2;;;;;61XPb
65;École doctorale Sciences de la Vie, Santé, Agronomie, Environnement;;5;Biologie, médecine et santé;2017;2016-17;2016;2016;42;29;13;181;112;69;44;26;18;;;;;MAOG4
65;École doctorale Sciences de la Vie, Santé, Agronomie, Environnement;;10;Sciences agronomiques et écologiques;2017;2016-17;2016;2016;24;15;9;61;38;23;21;11;10;;;;;MAOG4
67;École doctorale Sciences juridiques et politiques;;6;Sciences humaines et humanités;2017;2016-17;2016;2016;52;23;29;150;73;77;13;9;4;;;;;qrOj1
77;École doctorale Informatique, automatique, électronique, électrotechnique, mathématiques;IAEM;9;Sciences et technologies de l'information et de la communication;2017;2016-17;2016;2016;42;10;32;207;55;152;46;14;32;;;;;TCHTA
79;École doctorale Sciences juridiques, politiques, économiques et de gestion;SJPEG;7;Sciences de la société;2017;2016-17;2016;2016;44;21;23;181;85;96;19;9;10;;;;;ea4x6
85;École doctorale Sciences de la vie et de la santé;SVS;5;Biologie, médecine et santé;2017;2016-17;2016;2016;65;47;18;227;148;79;42;22;20;;;;;YdiMF
88;École doctorale Droit et science politique;DSP;7;Sciences de la société;2017;2016-17;2016;2016;64;30;34;332;153;179;32;12;20;;;;;elnAJ
92;École doctorale Vie -  Agro - Santé;;5;Biologie, médecine et santé;2017;2016-17;2016;2016;54;31;23;220;112;108;62;32;30;;;;;RjvXY
98;École doctorale Droit-Normandie;EDDN;7;Sciences de la société;2017;2016-17;2016;2016;29;16;13;158;79;79;13;4;9;;;;;9fYyW
104;École doctorale Sciences de la matière, du rayonnement et de l'environnement;SMRE;4;Chimie;2017;2016-17;2016;2016;80;27;53;261;117;144;59;23;36;;;;;Q5iFz
105;École doctorale Terre, univers, environnement;;3;Sciences de la terre et de l'univers, espace;2017;2016-17;2016;2016;44;22;22;175;78;97;51;24;27;;;;;lcWAf
129;École doctorale Sciences de l'environnement d'Ile de France;SEIF;3;Sciences de la terre et de l'univers, espace;2017;2016-17;2016;2016;40;28;12;175;87;88;55;22;33;;;;;TnAPh
132;École doctorale Sciences du langage;;6;Sciences humaines et humanités;2017;2016-17;2016;2016;14;11;3;78;55;23;12;9;3;;;;;5AUF1
139;École doctorale Connaissance, langage, modélisation;CLM;8;Sciences pour l'ingénieur;2017;2016-17;2016;2016;5;1;4;22;4;18;2;1;1;;;;;1lxGH
146;École doctorale Galilée;GALILEE;5;Biologie, médecine et santé;2017;2016-17;2016;2016;17;8;9;48;27;21;21;14;7;;;;;71hqm
156;École doctorale Sciences de la mer;;8;Sciences pour l'ingénieur;2017;2016-17;2016;2016;16;2;14;61;15;46;17;4;13;;;;;EGY9P
162;École doctorale Mécanique, énergétique, génie civil, acoustique;MEGA;1;Mathématiques et leurs interactions;2017;2016-17;2016;2016;1;1;0;1;1;0;0;0;0;;;;;7wCke
162;École doctorale Mécanique, énergétique, génie civil, acoustique;MEGA;2;Physique;2017;2016-17;2016;2016;2;1;1;5;1;4;2;1;1;;;;;7wCke
166;École doctorale Information, structures et systèmes;I2S;2;Physique;2017;2016-17;2016;2016;19;4;15;66;23;43;22;13;9;;;;;2uO68
168;École doctorale Sciences chimiques et biologiques pour la santé;SCBS;4;Chimie;2017;2016-17;2016;2016;3;1;2;7;4;3;1;1;0;;;;;8cEME
168;École doctorale Sciences chimiques et biologiques pour la santé;SCBS;5;Biologie, médecine et santé;2017;2016-17;2016;2016;96;60;36;338;205;133;116;65;51;;;;;8cEME
178;École doctorale Sciences fondamentales;;1;Mathématiques et leurs interactions;2017;2016-17;2016;2016;8;2;6;17;3;14;5;0;5;;;;;1AiR7
181;École doctorale Structure, informations, matière et matériaux;Simem;1;Mathématiques et leurs interactions;2017;2016-17;2016;2016;0;0;0;0;0;0;3;1;2;;;;;c1D6f
184;École doctorale Mathématiques et informatique de Marseille;;1;Mathématiques et leurs interactions;2017;2016-17;2016;2016;24;8;16;105;29;76;22;6;16;;;;;DDObG
184;École doctorale Mathématiques et informatique de Marseille;;9;Sciences et technologies de l'information et de la communication;2017;2016-17;2016;2016;8;2;6;36;15;21;5;1;4;;;;;DDObG
205;École doctorale Interdisciplinaire Sciences-Santé;EDISS;6;Sciences humaines et humanités;2017;2016-17;2016;2016;3;3;0;18;11;7;0;0;0;;;;;69W38
205;École doctorale Interdisciplinaire Sciences-Santé;EDISS;8;Sciences pour l'ingénieur;2017;2016-17;2016;2016;0;0;0;5;0;5;2;0;2;;;;;69W38
211;École doctorale Sciences exactes et leurs applications;ED SEA;8;Sciences pour l'ingénieur;2017;2016-17;2016;2016;18;8;10;51;14;37;10;1;9;;;;;1G1iC
216;École doctorale Ingénierie pour la santé, la cognition, l'environnement;EDISCE;4;Chimie;2017;2016-17;2016;2016;1;0;1;3;2;1;0;0;0;;;;;fPs1t
216;École doctorale Ingénierie pour la santé, la cognition, l'environnement;EDISCE;10;Sciences agronomiques et écologiques;2017;2016-17;2016;2016;1;0;1;5;2;3;1;0;1;;;;;fPs1t
217;École doctorale Mathématiques, sciences et technologies de l'information, informatique;MSTII;9;Sciences et technologies de l'information et de la communication;2017;2016-17;2016;2016;65;19;46;297;73;224;70;20;50;;;;;Ehx7v
218;École doctorale Chimie et sciences du vivant;EDCSV;5;Biologie, médecine et santé;2017;2016-17;2016;2016;41;24;17;203;127;76;59;35;24;;;;;8bcJh
218;École doctorale Chimie et sciences du vivant;EDCSV;10;Sciences agronomiques et écologiques;2017;2016-17;2016;2016;3;1;2;18;5;13;7;3;4;;;;;8bcJh
220;École doctorale Électronique, électrotechnique, automatique, traitement du signal;EEATS;8;Sciences pour l'ingénieur;2017;2016-17;2016;2016;55;15;40;208;44;164;36;6;30;;;;;IxEaw
222;École doctorale Sciences chimiques;EDSC;5;Biologie, médecine et santé;2017;2016-17;2016;2016;3;0;3;9;5;4;3;1;2;;;;;AdU8Q
224;École doctorale Cognition, langage, interaction;;6;Sciences humaines et humanités;2017;2016-17;2016;2016;40;23;17;153;92;61;24;12;12;;;;;7v43e
224;École doctorale Cognition, langage, interaction;;9;Sciences et technologies de l'information et de la communication;2017;2016-17;2016;2016;0;0;0;6;1;5;2;1;1;;;;;7v43e
227;École doctorale Sciences de la nature et de l'homme;;4;Chimie;2017;2016-17;2016;2016;1;0;1;4;2;2;2;2;0;;;;;xiDA5
242;École doctorale Économie - Gestion - Normandie;;7;Sciences de la société;2017;2016-17;2016;2016;16;10;6;84;43;41;10;5;5;;;;;z35ku
250;École doctorale Sciences chimiques;;4;Chimie;2017;2016-17;2016;2016;24;7;17;83;34;49;34;16;18;;;;;O0Fav
251;École doctorale Sciences de l'environnement;;8;Sciences pour l'ingénieur;2017;2016-17;2016;2016;7;4;3;17;9;8;5;4;1;;;;;VR28y
254;École doctorale Sciences de la matière;;2;Physique;2017;2016-17;2016;2016;17;5;12;62;13;49;16;4;12;;;;;365F2
254;École doctorale Sciences de la matière;;4;Chimie;2017;2016-17;2016;2016;54;27;27;155;66;89;39;24;15;;;;;365F2
261;École doctorale Cognition, comportements, conduites humaines;3CH;6;Sciences humaines et humanités;2017;2016-17;2016;2016;38;26;12;144;108;36;36;28;8;;;;;KOLCy
265;École doctorale Langues, littératures et sociétés du monde;;6;Sciences humaines et humanités;2017;2016-17;2016;2016;49;33;16;309;194;115;28;18;10;;;;;4YWGW
268;École doctorale Langage et langues : description, théorisation, transmission;;6;Sciences humaines et humanités;2017;2016-17;2016;2016;45;33;12;261;177;84;35;29;6;;;;;wAIDE
269;École doctorale Mathématiques, sciences de l'information et de l'ingénieur;MSII;9;Sciences et technologies de l'information et de la communication;2017;2016-17;2016;2016;35;7;28;145;24;121;12;1;11;;;;;5E625
270;École doctorale Théologie et sciences religieuses;;6;Sciences humaines et humanités;2017;2016-17;2016;2016;9;4;5;120;31;89;16;3;13;;;;;BRKC1
284;École doctorale Droit et Science Politique;DSP;7;Sciences de la société;2017;2016-17;2016;2016;2;1;1;28;17;11;0;0;0;;;;;ahH92
305;École doctorale Énergie et environnement;E2;1;Mathématiques et leurs interactions;2017;2016-17;2016;2016;3;3;0;7;6;1;1;0;1;;;;;Kbt8I
305;École doctorale Énergie et environnement;E2;2;Physique;2017;2016-17;2016;2016;2;0;2;15;3;12;3;0;3;;;;;Kbt8I
305;École doctorale Énergie et environnement;E2;3;Sciences de la terre et de l'univers, espace;2017;2016-17;2016;2016;1;1;0;13;5;8;4;2;2;;;;;Kbt8I
305;École doctorale Énergie et environnement;E2;5;Biologie, médecine et santé;2017;2016-17;2016;2016;5;4;1;23;13;10;3;1;2;;;;;Kbt8I
323;École doctorale Génie électrique, électronique et télécommunications;GEET;9;Sciences et technologies de l'information et de la communication;2017;2016-17;2016;2016;12;2;10;47;10;37;15;2;13;;;;;arcz6
353;École doctorale Sciences pour l'ingénieur : mécanique, physique, micro et nanoélectronique;;9;Sciences et technologies de l'information et de la communication;2017;2016-17;2016;2016;6;2;4;36;2;34;8;2;6;;;;;vk5Kp
359;École doctorale Mathématiques, télécommunications, informatique, signal, systèmes, électronique;MATISSE;1;Mathématiques et leurs interactions;2017;2016-17;2016;2016;17;4;13;68;17;51;13;6;7;;;;;Y0r76
361;École doctorale Sciences et Technologies;ED ST;9;Sciences et technologies de l'information et de la communication;2017;2016-17;2016;2016;22;6;16;113;38;75;20;7;13;;;;;cOUmL
364;École doctorale Sciences fondamentales et appliquées;EDSFA;1;Mathématiques et leurs interactions;2017;2016-17;2016;2016;22;5;17;55;18;37;18;5;13;;;;;E483q
373;École doctorale Santé, information/communications et mathématiques, matière;SICMA;2;Physique;2017;2016-17;2016;2016;6;3;3;6;3;3;3;1;2;;;;;hTJF5
377;École doctorale Environnement et société;;4;Chimie;2017;2016-17;2016;2016;1;1;0;11;8;3;2;2;0;;;;;ZMG5u
377;École doctorale Environnement et société;;6;Sciences humaines et humanités;2017;2016-17;2016;2016;8;5;3;53;36;17;4;1;3;;;;;ZMG5u
378;École doctorale Sciences de l'homme et de la société;SHS;7;Sciences de la société;2017;2016-17;2016;2016;20;8;12;94;35;59;14;4;10;;;;;3XKuF
393;École doctorale Pierre Louis de Santé Publique : Épidémiologie et Sciences de l'information biomédicale;PLSP;5;Biologie, médecine et santé;2017;2016-17;2016;2016;46;25;21;134;66;68;39;25;14;;;;;69445
401;École doctorale Sciences sociales;;9;Sciences et technologies de l'information et de la communication;2017;2016-17;2016;2016;10;1;9;36;11;25;4;1;3;;;;;raQ7K
402;École doctorale Sciences de la vie et de la santé;SVS;2;Physique;2017;2016-17;2016;2016;0;0;0;1;0;1;0;0;0;;;;;YKgsU
409;École doctorale Énergie, mécanique, matériaux;EMMA;2;Physique;2017;2016-17;2016;2016;5;3;2;18;6;12;6;1;5;;;;;KXlbK
409;École doctorale Énergie, mécanique, matériaux;EMMA;8;Sciences pour l'ingénieur;2017;2016-17;2016;2016;33;5;28;118;27;91;27;2;25;;;;;KXlbK
411;École doctorale Humanités nouvelles : Fernand Braudel;;9;Sciences et technologies de l'information et de la communication;2017;2016-17;2016;2016;6;2;4;21;13;8;2;0;2;;;;;l2rFh
413;École doctorale Sciences de la terre et de l'environnement;STE;3;Sciences de la terre et de l'univers, espace;2017;2016-17;2016;2016;12;7;5;59;26;33;15;8;7;;;;;u9BA9
446;École doctorale Biologie - Santé;EDBSL;6;Sciences humaines et humanités;2017;2016-17;2016;2016;1;1;0;9;4;5;3;2;1;;;;;4iEUF
455;École doctorale Économie, Gestion, Information et Communication;EGIC;9;Sciences et technologies de l'information et de la communication;2017;2016-17;2016;2016;0;0;0;1;0;1;0;0;0;;;;;qCOg3
461;École doctorale Droit et science politique;;7;Sciences de la société;2017;2016-17;2016;2016;71;37;34;254;137;117;35;23;12;;;;;QGArN
463;École doctorale Sciences du mouvement humain;SMH;7;Sciences de la société;2017;2016-17;2016;2016;2;0;2;3;0;3;0;0;0;;;;;UbtlY
463;École doctorale Sciences du mouvement humain;SMH;8;Sciences pour l'ingénieur;2017;2016-17;2016;2016;9;4;5;27;9;18;3;0;3;;;;;UbtlY
465;École doctorale Économie Panthéon Sorbonne;EPS;1;Mathématiques et leurs interactions;2017;2016-17;2016;2016;3;0;3;20;5;15;5;1;4;;;;;MV68S
467;École doctorale Aéronautique, astronautique;AA;1;Mathématiques et leurs interactions;2017;2016-17;2016;2016;3;0;3;15;1;14;2;0;2;;;;;U7l45
467;École doctorale Aéronautique, astronautique;AA;3;Sciences de la terre et de l'univers, espace;2017;2016-17;2016;2016;2;0;2;3;0;3;0;0;0;;;;;U7l45
467;École doctorale Aéronautique, astronautique;AA;9;Sciences et technologies de l'information et de la communication;2017;2016-17;2016;2016;1;1;0;5;3;2;0;0;0;;;;;U7l45
468;École doctorale Mécanique, énergétique, génie civil, procédés;MEGEP;8;Sciences pour l'ingénieur;2017;2016-17;2016;2016;136;32;104;475;136;339;127;41;86;;;;;4XUTB
469;École doctorale du Pacifique;EDP;3;Sciences de la terre et de l'univers, espace;2017;2016-17;2016;2016;1;1;0;11;6;5;2;1;1;;;;;t9Z2n
469;École doctorale du Pacifique;EDP;6;Sciences humaines et humanités;2017;2016-17;2016;2016;7;4;3;18;8;10;2;1;1;;;;;t9Z2n
469;École doctorale du Pacifique;EDP;10;Sciences agronomiques et écologiques;2017;2016-17;2016;2016;6;4;2;21;10;11;7;2;5;;;;;t9Z2n
472;École doctorale de l'EPHE;;10;Sciences agronomiques et écologiques;2017;2016-17;2016;2016;14;7;7;36;20;16;8;4;4;;;;;27zK4
474;École doctorale Interdisciplinaire européenne frontières du vivant;FDV;3;Sciences de la terre et de l'univers, espace;2017;2016-17;2016;2016;0;0;0;3;2;1;1;1;0;;;;;E727j
479;École doctorale Sciences juridiques et politiques;;7;Sciences de la société;2017;2016-17;2016;2016;66;41;25;379;191;188;50;20;30;;;;;34mid
486;École doctorale Sciences économiques et de gestion;SEG;7;Sciences de la société;2017;2016-17;2016;2016;39;16;23;183;83;100;26;14;12;;;;;h1GZ3
488;École doctorale Sciences, ingénierie, santé;SIS;8;Sciences pour l'ingénieur;2017;2016-17;2016;2016;26;9;17;96;28;68;19;7;12;;;;;Fy2lK
489;École doctorale Sciences et ingénierie des systèmes, de l'environnement et des organisations;SISEO;4;Chimie;2017;2016-17;2016;2016;2;0;2;5;2;3;0;0;0;;;;;6pT77
491;École doctorale Langages, idées, sociétés, institutions, territoires;LISIT;6;Sciences humaines et humanités;2017;2016-17;2016;2016;0;0;0;0;0;0;37;21;16;;;;;iB25j
493;École doctorale Erasme;;6;Sciences humaines et humanités;2017;2016-17;2016;2016;27;17;10;126;83;43;17;13;4;;;;;FPW4T
495;École doctorale Végétal, environnement, nutrition, agroalimentaire, mer;VENAM;3;Sciences de la terre et de l'univers, espace;2017;2016-17;2016;2016;2;0;2;7;0;7;1;0;1;;;;;HL495
495;École doctorale Végétal, environnement, nutrition, agroalimentaire, mer;VENAM;10;Sciences agronomiques et écologiques;2017;2016-17;2016;2016;28;17;11;101;52;49;34;24;10;;;;;HL495
500;École doctorale Matière, molécules, matériaux en Pays de Loire;3MPL;2;Physique;2017;2016-17;2016;2016;16;8;8;84;33;51;25;10;15;;;;;822tM
500;École doctorale Matière, molécules, matériaux en Pays de Loire;3MPL;4;Chimie;2017;2016-17;2016;2016;35;13;22;114;50;64;37;14;23;;;;;822tM
501;École doctorale Droit, économie-gestion, sociétés, territoires;;3;Sciences de la terre et de l'univers, espace;2017;2016-17;2016;2016;5;2;3;23;6;17;3;1;2;;;;;wE7WM
501;École doctorale Droit, économie-gestion, sociétés, territoires;;6;Sciences humaines et humanités;2017;2016-17;2016;2016;16;10;6;77;37;40;10;5;5;;;;;wE7WM
504;École doctorale Cognition, éducation, interactions;CEI;6;Sciences humaines et humanités;2017;2016-17;2016;2016;31;21;10;199;127;72;32;16;16;;;;;39naT
510;École doctorale Ingénierie - Matériaux, mécanique, environnement, énergétique, procédés, production;IMEP2;9;Sciences et technologies de l'information et de la communication;2017;2016-17;2016;2016;0;0;0;5;0;5;0;0;0;;;;;Ce7NF
520;École doctorale Humanités;;7;Sciences de la société;2017;2016-17;2016;2016;0;0;0;2;0;2;0;0;0;;;;;rI175
522;École doctorale Sciences et ingénierie en matériaux, mécanique, énergétique et aéronautique;SI-MMEA;2;Physique;2017;2016-17;2016;2016;12;2;10;36;9;27;12;3;9;;;;;82F19
522;École doctorale Sciences et ingénierie en matériaux, mécanique, énergétique et aéronautique;SI-MMEA;4;Chimie;2017;2016-17;2016;2016;16;7;9;44;19;25;8;3;5;;;;;82F19
525;"École doctorale Lettres, pensée, arts et histoire, ""Civilisation de l'antiquité à nos jours""";LPAH;6;Sciences humaines et humanités;2017;2016-17;2016;2016;81;46;35;300;180;120;34;18;16;;;;;19Rpr
530;École doctorale Organisations, marchés, institutions;OMI;1;Mathématiques et leurs interactions;2017;2016-17;2016;2016;3;2;1;3;2;1;1;1;0;;;;;4htv7
530;École doctorale Organisations, marchés, institutions;OMI;5;Biologie, médecine et santé;2017;2016-17;2016;2016;1;0;1;4;2;2;0;0;0;;;;;4htv7
530;École doctorale Organisations, marchés, institutions;OMI;6;Sciences humaines et humanités;2017;2016-17;2016;2016;30;13;17;115;60;55;16;12;4;;;;;4htv7
530;École doctorale Organisations, marchés, institutions;OMI;9;Sciences et technologies de l'information et de la communication;2017;2016-17;2016;2016;1;1;0;2;2;0;0;0;0;;;;;4htv7
531;École doctorale Sciences, ingénierie et environnement;SIE;1;Mathématiques et leurs interactions;2017;2016-17;2016;2016;3;1;2;3;1;2;0;0;0;;;;;b5BYq
531;École doctorale Sciences, ingénierie et environnement;SIE;4;Chimie;2017;2016-17;2016;2016;8;5;3;40;21;19;19;6;13;;;;;b5BYq
532;École doctorale Mathématiques et sciences et technologies de l'information et de la communication;MSTIC;1;Mathématiques et leurs interactions;2017;2016-17;2016;2016;14;3;11;66;18;48;19;5;14;;;;;t43KM
536;École doctorale Sciences et agrosciences;;5;Biologie, médecine et santé;2017;2016-17;2016;2016;0;0;0;5;1;4;4;2;2;;;;;pHfqe
537;École doctorale Culture et patrimoine;C&P;7;Sciences de la société;2017;2016-17;2016;2016;10;6;4;26;15;11;5;3;2;;;;;GxI4a
540;"École doctorale École transdisciplinaire ""lettres/sciences""";;7;Sciences de la société;2017;2016-17;2016;2016;3;2;1;5;4;1;0;0;0;;;;;tWWw7
540;"École doctorale École transdisciplinaire ""lettres/sciences""";;8;Sciences pour l'ingénieur;2017;2016-17;2016;2016;0;0;0;2;0;2;0;0;0;;;;;tWWw7
542;École doctorale de sciences de La Réunion;STS;4;Chimie;2017;2016-17;2016;2016;0;0;0;19;7;12;5;3;2;;;;;2pAql
542;École doctorale de sciences de La Réunion;STS;5;Biologie, médecine et santé;2017;2016-17;2016;2016;6;2;4;14;9;5;2;2;0;;;;;2pAql
542;École doctorale de sciences de La Réunion;STS;8;Sciences pour l'ingénieur;2017;2016-17;2016;2016;6;3;3;15;3;12;0;0;0;;;;;2pAql
542;École doctorale de sciences de La Réunion;STS;9;Sciences et technologies de l'information et de la communication;2017;2016-17;2016;2016;0;0;0;0;0;0;2;0;2;;;;;2pAql
545;École doctorale Sociétés, politique et santé publique;SP2;7;Sciences de la société;2017;2016-17;2016;2016;18;8;10;86;48;38;20;9;11;;;;;IAKR4
546;École doctorale Abbé Grégoire;;6;Sciences humaines et humanités;2017;2016-17;2016;2016;29;14;15;152;91;61;18;9;9;;;;;ZSn7q
547;École doctorale Sciences, Technologie, Santé;EDSTS;5;Biologie, médecine et santé;2017;2016-17;2016;2016;21;14;7;85;52;33;12;4;8;;;;;wEdn2
549;École doctorale Santé, Sciences Biologiques et Chimie du Vivant;SSBCV;4;Chimie;2017;2016-17;2016;2016;13;4;9;49;15;34;14;9;5;;;;;B9ggO
549;École doctorale Santé, Sciences Biologiques et Chimie du Vivant;SSBCV;6;Sciences humaines et humanités;2017;2016-17;2016;2016;1;1;0;9;5;4;1;1;0;;;;;B9ggO
551;École doctorale Mathématiques, Informatique, Physique Théorique et Ingénierie des Systèmes;MIPTIS;2;Physique;2017;2016-17;2016;2016;2;0;2;6;0;6;1;0;1;;;;;Mpudz
552;École doctorale Énergie - Matériaux - Sciences de la Terre et de l'Univers;EMTSU;4;Chimie;2017;2016-17;2016;2016;12;5;7;49;19;30;17;7;10;;;;;NTZhw
554;École doctorale Environnements - Santé;E-S;5;Biologie, médecine et santé;2017;2016-17;2016;2016;55;28;27;199;116;83;37;21;16;;;;;ElyFU
563;École doctorale Médicament - Toxicologie - Chimie - Imageries;MTCI;4;Chimie;2017;2016-17;2016;2016;12;7;5;41;21;20;14;7;7;;;;;j8uk1
566;École doctorale Sciences du Sport, de la Motricité et du Mouvement Humain;SMMH;5;Biologie, médecine et santé;2017;2016-17;2016;2016;13;6;7;57;26;31;13;5;8;;;;;3iv8y
568;École doctorale Signalisations et Réseaux Intégratifs en Biologie;BIOSIGNE;5;Biologie, médecine et santé;2017;2016-17;2016;2016;27;18;9;133;85;48;28;20;8;;;;;CGttG
569;École doctorale Innovation thérapeutique : du fondamental à l'appliqué;;4;Chimie;2017;2016-17;2016;2016;7;5;2;37;22;15;10;6;4;;;;;jx8ET
569;École doctorale Innovation thérapeutique : du fondamental à l'appliqué;;5;Biologie, médecine et santé;2017;2016-17;2016;2016;61;32;29;268;144;124;47;27;20;;;;;jx8ET
572;École doctorale Ondes et matière;EDOM;1;Mathématiques et leurs interactions;2017;2016-17;2016;2016;1;0;1;1;0;1;0;0;0;;;;;etSIi
572;École doctorale Ondes et matière;EDOM;2;Physique;2017;2016-17;2016;2016;61;13;48;248;63;185;68;19;49;;;;;etSIi
572;École doctorale Ondes et matière;EDOM;9;Sciences et technologies de l'information et de la communication;2017;2016-17;2016;2016;0;0;0;1;0;1;0;0;0;;;;;etSIi
576;École doctorale Particules, Hadrons, Énergie, Noyau, Instrumentation, Imagerie, Cosmos et Simulation;PHENIICS;1;Mathématiques et leurs interactions;2017;2016-17;2016;2016;1;0;1;2;0;2;0;0;0;;;;;qC4rf
576;École doctorale Particules, Hadrons, Énergie, Noyau, Instrumentation, Imagerie, Cosmos et Simulation;PHENIICS;2;Physique;2017;2016-17;2016;2016;58;23;35;214;65;149;40;11;29;;;;;qC4rf
577;École doctorale Structure et dynamique des systèmes vivants;SDSV;2;Physique;2017;2016-17;2016;2016;0;0;0;1;0;1;0;0;0;;;;;4bsxJ
577;École doctorale Structure et dynamique des systèmes vivants;SDSV;10;Sciences agronomiques et écologiques;2017;2016-17;2016;2016;1;0;1;3;2;1;0;0;0;;;;;4bsxJ
578;École doctorale Sciences de l'Homme et de la Société;ED SHS;7;Sciences de la société;2017;2016-17;2016;2016;102;49;53;582;277;305;114;56;58;;;;;Ud43O
579;École doctorale Sciences mécaniques et energétiques, matériaux et géosciences;SMEMaG;5;Biologie, médecine et santé;2017;2016-17;2016;2016;4;3;1;5;4;1;1;1;0;;;;;atMj7
580;École doctorale Sciences et technologies de l'information et de la communication;STIC;2;Physique;2017;2016-17;2016;2016;0;0;0;3;0;3;2;0;2;;;;;AzCC0
581;École doctorale Agriculture, alimentation, biologie, environnement, santé;ABIES;9;Sciences et technologies de l'information et de la communication;2017;2016-17;2016;2016;0;0;0;3;0;3;1;0;1;;;;;c1x56
582;École doctorale Cancérologie, Biologie, Médecine, Santé;CBMS;5;Biologie, médecine et santé;2017;2016-17;2016;2016;49;29;20;225;145;80;41;29;12;;;;;75bj4
584;École doctorale Biodiversité, Agriculture, Alimentation, Environnement, Terre, Eau;GAIA;8;Sciences pour l'ingénieur;2017;2016-17;2016;2016;17;9;8;69;35;34;9;3;6;;;;;F1h5f
585;École doctorale Sciences, Technologie,  Sante;EDSTS;10;Sciences agronomiques et écologiques;2017;2016-17;2016;2016;0;0;0;33;15;18;11;4;7;;;;;NM3Dl
587;École doctorale Diversites, santé et développement en Amazonie;;6;Sciences humaines et humanités;2017;2016-17;2016;2016;5;5;0;13;9;4;2;1;1;;;;;V14tj
588;École doctorale Milieu insulaire tropical : dynamiques de développement, sociétés, patrimoine et culture dans l'espace Caraïbes-Amériques;;6;Sciences humaines et humanités;2017;2016-17;2016;2016;34;17;17;151;97;54;8;6;2;;;;;4W5IO
590;École doctorale Mathematiques, Information, Ingenierie des Systemes;MIIS;2;Physique;2017;2016-17;2016;2016;1;0;1;1;0;1;0;0;0;;;;;L20t5
591;École doctorale Physique, Sciences de l'Ingenieur, Materiaux, Énergie;PSIME;2;Physique;2017;2016-17;2016;2016;29;9;20;100;24;76;0;0;0;;;;;Hn5Om
8;École doctorale Histoire du droit, philosophie du droit et sociologie du droit;;7;Sciences de la société;2016;2015-16;2015;2015;18;7;11;88;37;51;6;3;3;;;;;pGSed
31;École doctorale Pratiques et théories du sens;;6;Sciences humaines et humanités;2016;2015-16;2015;2015;75;48;27;466;261;205;66;35;31;;;;;1S466
34;École doctorale Matériaux;;3;Sciences de la terre et de l'univers, espace;2016;2015-16;2015;2015;0;0;0;5;2;3;0;0;0;;;;;1Iufh
38;École doctorale Langages, espaces, temps, sociétés;;9;Sciences et technologies de l'information et de la communication;2016;2015-16;2015;2015;3;1;2;8;4;4;0;0;0;;;;;pGgDX
40;École doctorale Sciences chimiques;EDSC;4;Chimie;2016;2015-16;2015;2015;94;37;57;302;129;173;75;38;37;;;;;wde3D
50;École doctorale Langues, littératures et sciences humaines;LLSH;6;Sciences humaines et humanités;2016;2015-16;2015;2015;37;23;14;246;159;87;33;22;11;;;;;8THzQ
65;École doctorale Sciences de la Vie, Santé, Agronomie, Environnement;;10;Sciences agronomiques et écologiques;2016;2015-16;2015;2015;17;10;7;59;35;24;22;6;16;;;;;MAOG4
73;École doctorale Sciences économiques, sociales, de l'aménagement et du management;SESAM;6;Sciences humaines et humanités;2016;2015-16;2015;2015;5;4;1;22;10;12;1;0;1;;;;;IQ0Hk
92;École doctorale Vie -  Agro - Santé;;5;Biologie, médecine et santé;2016;2015-16;2015;2015;65;30;35;230;112;118;58;24;34;;;;;RjvXY
98;École doctorale Droit-Normandie;EDDN;7;Sciences de la société;2016;2015-16;2015;2015;27;15;12;147;70;77;12;4;8;;;;;9fYyW
104;École doctorale Sciences de la matière, du rayonnement et de l'environnement;SMRE;2;Physique;2016;2015-16;2015;2015;21;9;12;70;23;47;7;2;5;;;;;Q5iFz
104;École doctorale Sciences de la matière, du rayonnement et de l'environnement;SMRE;10;Sciences agronomiques et écologiques;2016;2015-16;2015;2015;19;9;10;71;35;36;24;13;11;;;;;Q5iFz
120;École doctorale Littérature française et comparée;;6;Sciences humaines et humanités;2016;2015-16;2015;2015;48;38;10;265;190;75;43;33;10;;;;;3ULpe
124;École doctorale Histoire de l'art et archéologie;;6;Sciences humaines et humanités;2016;2015-16;2015;2015;34;26;8;205;137;68;36;26;10;;;;;MBN4L
139;École doctorale Connaissance, langage, modélisation;CLM;6;Sciences humaines et humanités;2016;2015-16;2015;2015;62;39;23;290;192;98;47;26;21;;;;;1lxGH
139;École doctorale Connaissance, langage, modélisation;CLM;8;Sciences pour l'ingénieur;2016;2015-16;2015;2015;7;1;6;23;5;18;7;0;7;;;;;1lxGH
142;École doctorale Mathématiques de la région Paris-Sud;;1;Mathématiques et leurs interactions;2016;2015-16;2015;2015;0;0;0;0;0;0;21;4;17;;;;;5XlH9
146;École doctorale Galilée;GALILEE;2;Physique;2016;2015-16;2015;2015;16;8;8;32;10;22;7;4;3;;;;;71hqm
146;École doctorale Galilée;GALILEE;4;Chimie;2016;2015-16;2015;2015;3;1;2;12;3;9;9;6;3;;;;;71hqm
146;École doctorale Galilée;GALILEE;5;Biologie, médecine et santé;2016;2015-16;2015;2015;15;10;5;57;38;19;16;12;4;;;;;71hqm
146;École doctorale Galilée;GALILEE;9;Sciences et technologies de l'information et de la communication;2016;2015-16;2015;2015;10;3;7;44;13;31;11;7;4;;;;;71hqm
160;École doctorale Électronique, électrotechnique, automatique;EEA;9;Sciences et technologies de l'information et de la communication;2016;2015-16;2015;2015;24;3;21;101;31;70;33;7;26;;;;;EgfMQ
166;École doctorale Information, structures et systèmes;I2S;1;Mathématiques et leurs interactions;2016;2015-16;2015;2015;13;3;10;54;15;39;14;5;9;;;;;2uO68
166;École doctorale Information, structures et systèmes;I2S;2;Physique;2016;2015-16;2015;2015;19;8;11;66;28;38;24;5;19;;;;;2uO68
173;École doctorale Sciences de l'univers, de l'environnement et de l'espace;SDU2E;3;Sciences de la terre et de l'univers, espace;2016;2015-16;2015;2015;73;29;44;288;110;178;62;23;39;;;;;R0Z9c
178;École doctorale Sciences fondamentales;;3;Sciences de la terre et de l'univers, espace;2016;2015-16;2015;2015;11;6;5;32;15;17;8;4;4;;;;;1AiR7
181;École doctorale Structure, informations, matière et matériaux;Simem;1;Mathématiques et leurs interactions;2016;2015-16;2015;2015;2;0;2;14;5;9;6;3;3;;;;;c1D6f
209;École doctorale Sciences physiques et de L'ingénieur;SPI;8;Sciences pour l'ingénieur;2016;2015-16;2015;2015;23;9;14;90;22;68;15;3;12;;;;;tZcIZ
209;École doctorale Sciences physiques et de L'ingénieur;SPI;9;Sciences et technologies de l'information et de la communication;2016;2015-16;2015;2015;37;13;24;131;33;98;42;6;36;;;;;tZcIZ
211;École doctorale Sciences exactes et leurs applications;ED SEA;2;Physique;2016;2015-16;2015;2015;4;2;2;13;4;9;5;1;4;;;;;1G1iC
211;École doctorale Sciences exactes et leurs applications;ED SEA;3;Sciences de la terre et de l'univers, espace;2016;2015-16;2015;2015;1;0;1;8;2;6;4;4;0;;;;;1G1iC
211;École doctorale Sciences exactes et leurs applications;ED SEA;4;Chimie;2016;2015-16;2015;2015;11;4;7;63;34;29;20;11;9;;;;;1G1iC
211;École doctorale Sciences exactes et leurs applications;ED SEA;5;Biologie, médecine et santé;2016;2015-16;2015;2015;1;1;0;16;11;5;4;4;0;;;;;1G1iC
211;École doctorale Sciences exactes et leurs applications;ED SEA;8;Sciences pour l'ingénieur;2016;2015-16;2015;2015;10;1;9;44;8;36;9;3;6;;;;;1G1iC
211;École doctorale Sciences exactes et leurs applications;ED SEA;9;Sciences et technologies de l'information et de la communication;2016;2015-16;2015;2015;4;1;3;18;7;11;5;1;4;;;;;1G1iC
216;École doctorale Ingénierie pour la santé, la cognition, l'environnement;EDISCE;3;Sciences de la terre et de l'univers, espace;2016;2015-16;2015;2015;0;0;0;1;0;1;0;0;0;;;;;fPs1t
220;École doctorale Électronique, électrotechnique, automatique, traitement du signal;EEATS;2;Physique;2016;2015-16;2015;2015;16;3;13;34;8;26;2;0;2;;;;;IxEaw
220;École doctorale Électronique, électrotechnique, automatique, traitement du signal;EEATS;8;Sciences pour l'ingénieur;2016;2015-16;2015;2015;69;14;55;189;37;152;40;11;29;;;;;IxEaw
221;École doctorale Augustin Cournot - Sciences économiques et de gestion - Sciences, technologies et sociétés;EDAC;6;Sciences humaines et humanités;2016;2015-16;2015;2015;2;0;2;11;4;7;1;0;1;;;;;5z9rW
221;École doctorale Augustin Cournot - Sciences économiques et de gestion - Sciences, technologies et sociétés;EDAC;7;Sciences de la société;2016;2015-16;2015;2015;23;13;10;85;44;41;10;4;6;;;;;5z9rW
222;École doctorale Sciences chimiques;EDSC;5;Biologie, médecine et santé;2016;2015-16;2015;2015;1;0;1;3;2;1;0;0;0;;;;;AdU8Q
222;École doctorale Sciences chimiques;EDSC;8;Sciences pour l'ingénieur;2016;2015-16;2015;2015;1;1;0;1;1;0;3;2;1;;;;;AdU8Q
227;École doctorale Sciences de la nature et de l'homme;;5;Biologie, médecine et santé;2016;2015-16;2015;2015;24;10;14;90;53;37;21;16;5;;;;;xiDA5
227;École doctorale Sciences de la nature et de l'homme;;10;Sciences agronomiques et écologiques;2016;2015-16;2015;2015;37;24;13;105;62;43;15;11;4;;;;;xiDA5
245;École doctorale Sciences économiques, juridiques, politiques et de gestion;;7;Sciences de la société;2016;2015-16;2015;2015;32;16;16;176;76;100;28;7;21;;;;;ShLUg
251;École doctorale Sciences de l'environnement;;3;Sciences de la terre et de l'univers, espace;2016;2015-16;2015;2015;24;14;10;102;52;50;31;15;16;;;;;VR28y
251;École doctorale Sciences de l'environnement;;5;Biologie, médecine et santé;2016;2015-16;2015;2015;0;0;0;6;3;3;4;1;3;;;;;VR28y
254;École doctorale Sciences de la matière;;2;Physique;2016;2015-16;2015;2015;16;3;13;67;11;56;18;6;12;;;;;365F2
254;École doctorale Sciences de la matière;;4;Chimie;2016;2015-16;2015;2015;43;15;28;146;66;80;46;26;20;;;;;365F2
260;École doctorale pluridisciplinaire;;2;Physique;2016;2015-16;2015;2015;0;0;0;0;0;0;1;1;0;;;;;sCk1f
260;École doctorale pluridisciplinaire;;4;Chimie;2016;2015-16;2015;2015;0;0;0;0;0;0;4;1;3;;;;;sCk1f
265;École doctorale Langues, littératures et sociétés du monde;;6;Sciences humaines et humanités;2016;2015-16;2015;2015;44;26;18;255;162;93;21;12;9;;;;;4YWGW
267;École doctorale Arts et médias;;6;Sciences humaines et humanités;2016;2015-16;2015;2015;47;37;10;322;211;111;36;27;9;;;;;eCF5C
275;École doctorale Sciences de gestion;EDSG;7;Sciences de la société;2016;2015-16;2015;2015;13;8;5;75;37;38;11;4;7;;;;;6QC4I
280;École doctorale Philosophie;;6;Sciences humaines et humanités;2016;2015-16;2015;2015;52;21;31;261;106;155;39;15;24;;;;;kJxnm
285;École doctorale Sciences pratiques;;7;Sciences de la société;2016;2015-16;2015;2015;0;0;0;0;0;0;2;1;1;;;;;Jd3t2
287;École doctorale Sciences pour l'ingénieur;;1;Mathématiques et leurs interactions;2016;2015-16;2015;2015;0;0;0;0;0;0;5;0;5;;;;;48Q1j
287;École doctorale Sciences pour l'ingénieur;;4;Chimie;2016;2015-16;2015;2015;0;0;0;0;0;0;4;3;1;;;;;48Q1j
287;École doctorale Sciences pour l'ingénieur;;9;Sciences et technologies de l'information et de la communication;2016;2015-16;2015;2015;0;0;0;0;0;0;10;4;6;;;;;48Q1j
304;École doctorale Sciences et environnements;;3;Sciences de la terre et de l'univers, espace;2016;2015-16;2015;2015;7;4;3;28;18;10;12;8;4;;;;;2ywZn
309;École doctorale Systèmes;EDSYS;8;Sciences pour l'ingénieur;2016;2015-16;2015;2015;15;7;8;67;27;40;19;6;13;;;;;8TT4b
327;École doctorale Temps, espaces, sociétés, cultures;TESC;6;Sciences humaines et humanités;2016;2015-16;2015;2015;64;37;27;274;148;126;40;29;11;;;;;IjgiJ
327;École doctorale Temps, espaces, sociétés, cultures;TESC;7;Sciences de la société;2016;2015-16;2015;2015;16;7;9;123;63;60;23;14;9;;;;;IjgiJ
353;École doctorale Sciences pour l'ingénieur : mécanique, physique, micro et nanoélectronique;;4;Chimie;2016;2015-16;2015;2015;2;1;1;5;3;2;0;0;0;;;;;vk5Kp
354;École doctorale Langues, lettres et arts;LLA;6;Sciences humaines et humanités;2016;2015-16;2015;2015;53;34;19;204;138;66;27;16;11;;;;;RwcSv
359;École doctorale Mathématiques, télécommunications, informatique, signal, systèmes, électronique;MATISSE;8;Sciences pour l'ingénieur;2016;2015-16;2015;2015;0;0;0;2;1;1;1;0;1;;;;;Y0r76
361;École doctorale Sciences et Technologies;ED ST;8;Sciences pour l'ingénieur;2016;2015-16;2015;2015;12;4;8;48;10;38;10;3;7;;;;;cOUmL
372;École doctorale Sciences économiques et de gestion;;7;Sciences de la société;2016;2015-16;2015;2015;34;15;19;181;84;97;43;16;27;;;;;JK63A
373;École doctorale Santé, information/communications et mathématiques, matière;SICMA;10;Sciences agronomiques et écologiques;2016;2015-16;2015;2015;3;3;0;15;12;3;5;3;2;;;;;hTJF5
377;École doctorale Environnement et société;;3;Sciences de la terre et de l'univers, espace;2016;2015-16;2015;2015;0;0;0;1;0;1;0;0;0;;;;;ZMG5u
377;École doctorale Environnement et société;;10;Sciences agronomiques et écologiques;2016;2015-16;2015;2015;2;1;1;19;11;8;4;2;2;;;;;ZMG5u
391;École doctorale Sciences mécaniques, acoustique et électronique et robotique de Paris;SMAER;8;Sciences pour l'ingénieur;2016;2015-16;2015;2015;47;13;34;217;49;168;67;19;48;;;;;k0eue
400;École doctorale Savoirs scientifiques : épistémologie, histoire des sciences, didactique des disciplines;;3;Sciences de la terre et de l'univers, espace;2016;2015-16;2015;2015;0;0;0;1;0;1;0;0;0;;;;;nRax3
402;École doctorale Sciences de la vie et de la santé;SVS;5;Biologie, médecine et santé;2016;2015-16;2015;2015;32;19;13;111;64;47;21;10;11;;;;;YKgsU
402;École doctorale Sciences de la vie et de la santé;SVS;7;Sciences de la société;2016;2015-16;2015;2015;0;0;0;1;1;0;0;0;0;;;;;YKgsU
412;École doctorale Lorraine de chimie et physique moléculaires : synthèses, expériences, simulations, applications : de la molécule aux édifices supramoléculaires;SESAMES;2;Physique;2016;2015-16;2015;2015;4;0;4;17;6;11;4;2;2;;;;;mvHX2
414;École doctorale Sciences de la vie et de la santé;;5;Biologie, médecine et santé;2016;2015-16;2015;2015;123;56;67;521;281;240;91;51;40;;;;;YI4xS
414;École doctorale Sciences de la vie et de la santé;;10;Sciences agronomiques et écologiques;2016;2015-16;2015;2015;1;1;0;12;7;5;3;2;1;;;;;YI4xS
417;École doctorale Sciences et Ingénierie;S&I;8;Sciences pour l'ingénieur;2016;2015-16;2015;2015;10;6;4;41;15;26;16;4;12;;;;;SSBvE
422;École doctorale Sciences et technologies de l'information, des télécommunications et des systèmes;;9;Sciences et technologies de l'information et de la communication;2016;2015-16;2015;2015;0;0;0;0;0;0;28;8;20;;;;;998UM
425;École doctorale Innovation thérapeutique : du fondamental à l'appliqué;;4;Chimie;2016;2015-16;2015;2015;0;0;0;0;0;0;6;2;4;;;;;DkgNy
432;École doctorale Sciences des métiers de l'ingénieur;SMI;8;Sciences pour l'ingénieur;2016;2015-16;2015;2015;132;39;93;512;128;384;125;25;100;;;;;nSsHB
435;École doctorale Agriculture, alimentation, biologie, environnement et santé;;1;Mathématiques et leurs interactions;2016;2015-16;2015;2015;0;0;0;0;0;0;1;0;1;;;;;mC35U
447;École doctorale de l'école polytechnique;;5;Biologie, médecine et santé;2016;2015-16;2015;2015;0;0;0;0;0;0;3;0;3;;;;;zgCCh
467;École doctorale Aéronautique, astronautique;AA;1;Mathématiques et leurs interactions;2016;2015-16;2015;2015;5;1;4;17;1;16;1;0;1;;;;;U7l45
467;École doctorale Aéronautique, astronautique;AA;3;Sciences de la terre et de l'univers, espace;2016;2015-16;2015;2015;1;0;1;1;0;1;1;1;0;;;;;U7l45
467;École doctorale Aéronautique, astronautique;AA;10;Sciences agronomiques et écologiques;2016;2015-16;2015;2015;0;0;0;0;0;0;1;0;1;;;;;U7l45
469;École doctorale du Pacifique;EDP;1;Mathématiques et leurs interactions;2016;2015-16;2015;2015;0;0;0;1;0;1;0;0;0;;;;;t9Z2n
469;École doctorale du Pacifique;EDP;4;Chimie;2016;2015-16;2015;2015;0;0;0;2;2;0;0;0;0;;;;;t9Z2n
472;École doctorale de l'EPHE;;6;Sciences humaines et humanités;2016;2015-16;2015;2015;108;56;52;497;268;229;70;39;31;;;;;27zK4
472;École doctorale de l'EPHE;;9;Sciences et technologies de l'information et de la communication;2016;2015-16;2015;2015;1;0;1;6;0;6;0;0;0;;;;;27zK4
474;École doctorale Interdisciplinaire européenne frontières du vivant;FDV;1;Mathématiques et leurs interactions;2016;2015-16;2015;2015;3;2;1;5;3;2;0;0;0;;;;;E727j
474;École doctorale Interdisciplinaire européenne frontières du vivant;FDV;10;Sciences agronomiques et écologiques;2016;2015-16;2015;2015;3;2;1;3;2;1;0;0;0;;;;;E727j
480;École doctorale Montaigne-humanités;;2;Physique;2016;2015-16;2015;2015;1;1;0;5;3;2;2;1;1;;;;;f3SeZ
481;École doctorale Sciences sociales et humanités;SSH;6;Sciences humaines et humanités;2016;2015-16;2015;2015;26;15;11;152;95;57;11;8;3;;;;;E3z5j
483;École doctorale Histoire, géographie, aménagement, urbanisme, archéologie, science politique, sociologie, anthropologie;SCSO;6;Sciences humaines et humanités;2016;2015-16;2015;2015;72;38;34;518;244;274;57;31;26;;;;;hc6u4
486;École doctorale Sciences économiques et de gestion;SEG;7;Sciences de la société;2016;2015-16;2015;2015;44;20;24;182;79;103;25;14;11;;;;;h1GZ3
488;École doctorale Sciences, ingénierie, santé;SIS;8;Sciences pour l'ingénieur;2016;2015-16;2015;2015;22;6;16;93;26;67;19;10;9;;;;;Fy2lK
489;École doctorale Sciences et ingénierie des systèmes, de l'environnement et des organisations;SISEO;6;Sciences humaines et humanités;2016;2015-16;2015;2015;7;6;1;21;15;6;2;1;1;;;;;6pT77
489;École doctorale Sciences et ingénierie des systèmes, de l'environnement et des organisations;SISEO;9;Sciences et technologies de l'information et de la communication;2016;2015-16;2015;2015;6;3;3;21;10;11;11;3;8;;;;;6pT77
492;École doctorale Droit;;7;Sciences de la société;2016;2015-16;2015;2015;73;37;36;326;165;161;41;22;19;;;;;kOQsX
496;École doctorale Sociétés, cultures, échanges;SCE;7;Sciences de la société;2016;2015-16;2015;2015;0;0;0;2;0;2;0;0;0;;;;;633tC
497;École doctorale Normande de Biologie Intégrative, Santé, Environnement;Ed NBISE;3;Sciences de la terre et de l'univers, espace;2016;2015-16;2015;2015;3;1;2;16;7;9;4;2;2;;;;;0D9Je
497;École doctorale Normande de Biologie Intégrative, Santé, Environnement;Ed NBISE;10;Sciences agronomiques et écologiques;2016;2015-16;2015;2015;8;3;5;36;17;19;10;4;6;;;;;0D9Je
500;École doctorale Matière, molécules, matériaux en Pays de Loire;3MPL;2;Physique;2016;2015-16;2015;2015;21;8;13;95;34;61;19;4;15;;;;;822tM
500;École doctorale Matière, molécules, matériaux en Pays de Loire;3MPL;8;Sciences pour l'ingénieur;2016;2015-16;2015;2015;2;0;2;8;0;8;4;0;4;;;;;822tM
502;École doctorale Biologie - Santé;;5;Biologie, médecine et santé;2016;2015-16;2015;2015;83;40;43;322;175;147;79;44;35;;;;;JCFV7
502;École doctorale Biologie - Santé;;10;Sciences agronomiques et écologiques;2016;2015-16;2015;2015;0;0;0;2;0;2;1;0;1;;;;;JCFV7
503;École doctorale Sciences et technologies de l'information et de mathématiques;STIM;6;Sciences humaines et humanités;2016;2015-16;2015;2015;0;0;0;8;4;4;1;0;1;;;;;JQevP
503;École doctorale Sciences et technologies de l'information et de mathématiques;STIM;8;Sciences pour l'ingénieur;2016;2015-16;2015;2015;4;2;2;19;4;15;8;1;7;;;;;JQevP
510;École doctorale Ingénierie - Matériaux, mécanique, environnement, énergétique, procédés, production;IMEP2;4;Chimie;2016;2015-16;2015;2015;15;3;12;66;27;39;20;14;6;;;;;Ce7NF
511;École doctorale Sciences et ingénierie;S&I;1;Mathématiques et leurs interactions;2016;2015-16;2015;2015;0;0;0;0;0;0;3;1;2;;;;;7aXuB
511;École doctorale Sciences et ingénierie;S&I;9;Sciences et technologies de l'information et de la communication;2016;2015-16;2015;2015;0;0;0;0;0;0;9;2;7;;;;;7aXuB
512;École doctorale Informatique et mathématiques;InfoMaths;1;Mathématiques et leurs interactions;2016;2015-16;2015;2015;30;6;24;122;33;89;27;4;23;;;;;t86bi
521;École doctorale Sciences et ingénierie pour l'information, mathématiques;S2I;8;Sciences pour l'ingénieur;2016;2015-16;2015;2015;13;2;11;57;14;43;11;3;8;;;;;V6i83
522;École doctorale Sciences et ingénierie en matériaux, mécanique, énergétique et aéronautique;SI-MMEA;2;Physique;2016;2015-16;2015;2015;12;3;9;28;7;21;5;4;1;;;;;82F19
522;École doctorale Sciences et ingénierie en matériaux, mécanique, énergétique et aéronautique;SI-MMEA;4;Chimie;2016;2015-16;2015;2015;21;5;16;58;26;32;16;6;10;;;;;82F19
525;"École doctorale Lettres, pensée, arts et histoire, ""Civilisation de l'antiquité à nos jours""";LPAH;6;Sciences humaines et humanités;2016;2015-16;2015;2015;69;45;24;280;165;115;48;27;21;;;;;19Rpr
528;École doctorale Ville, transports et territoires;VTT;6;Sciences humaines et humanités;2016;2015-16;2015;2015;16;7;9;115;56;59;27;20;7;;;;;68zCc
529;École doctorale Cultures et sociétés;CS;6;Sciences humaines et humanités;2016;2015-16;2015;2015;53;30;23;252;143;109;20;9;11;;;;;XU9tb
530;École doctorale Organisations, marchés, institutions;OMI;1;Mathématiques et leurs interactions;2016;2015-16;2015;2015;0;0;0;1;1;0;0;0;0;;;;;4htv7
530;École doctorale Organisations, marchés, institutions;OMI;6;Sciences humaines et humanités;2016;2015-16;2015;2015;19;13;6;111;62;49;9;2;7;;;;;4htv7
530;École doctorale Organisations, marchés, institutions;OMI;7;Sciences de la société;2016;2015-16;2015;2015;22;9;13;146;72;74;17;5;12;;;;;4htv7
532;École doctorale Mathématiques et sciences et technologies de l'information et de la communication;MSTIC;3;Sciences de la terre et de l'univers, espace;2016;2015-16;2015;2015;3;0;3;11;2;9;1;0;1;;;;;t43KM
539;École doctorale Sciences et technologies de Versailles;;3;Sciences de la terre et de l'univers, espace;2016;2015-16;2015;2015;0;0;0;0;0;0;1;0;1;;;;;nv3h8
542;École doctorale de sciences de La Réunion;STS;1;Mathématiques et leurs interactions;2016;2015-16;2015;2015;6;1;5;21;11;10;11;5;6;;;;;2pAql
542;École doctorale de sciences de La Réunion;STS;3;Sciences de la terre et de l'univers, espace;2016;2015-16;2015;2015;0;0;0;13;0;13;7;3;4;;;;;2pAql
542;École doctorale de sciences de La Réunion;STS;4;Chimie;2016;2015-16;2015;2015;7;7;0;24;10;14;0;0;0;;;;;2pAql
543;École doctorale de Dauphine;;7;Sciences de la société;2016;2015-16;2015;2015;68;40;28;291;154;137;59;29;30;;;;;u8w6A
547;École doctorale Sciences, Technologie, Santé;EDSTS;3;Sciences de la terre et de l'univers, espace;2016;2015-16;2015;2015;2;1;1;6;2;4;0;0;0;;;;;wEdn2
548;École doctorale Mer et Sciences;;1;Mathématiques et leurs interactions;2016;2015-16;2015;2015;5;2;3;16;5;11;2;0;2;;;;;QX0fS
548;École doctorale Mer et Sciences;;2;Physique;2016;2015-16;2015;2015;3;1;2;6;3;3;2;0;2;;;;;QX0fS
548;École doctorale Mer et Sciences;;8;Sciences pour l'ingénieur;2016;2015-16;2015;2015;2;2;0;6;2;4;0;0;0;;;;;QX0fS
549;École doctorale Santé, Sciences Biologiques et Chimie du Vivant;SSBCV;5;Biologie, médecine et santé;2016;2015-16;2015;2015;58;36;22;174;102;72;52;37;15;;;;;B9ggO
551;École doctorale Mathématiques, Informatique, Physique Théorique et Ingénierie des Systèmes;MIPTIS;1;Mathématiques et leurs interactions;2016;2015-16;2015;2015;8;4;4;28;9;19;5;1;4;;;;;Mpudz
551;École doctorale Mathématiques, Informatique, Physique Théorique et Ingénierie des Systèmes;MIPTIS;9;Sciences et technologies de l'information et de la communication;2016;2015-16;2015;2015;16;5;11;67;14;53;20;6;14;;;;;Mpudz
552;École doctorale Énergie - Matériaux - Sciences de la Terre et de l'Univers;EMTSU;4;Chimie;2016;2015-16;2015;2015;11;2;9;51;20;31;12;3;9;;;;;NTZhw
552;École doctorale Énergie - Matériaux - Sciences de la Terre et de l'Univers;EMTSU;5;Biologie, médecine et santé;2016;2015-16;2015;2015;1;0;1;8;3;5;5;2;3;;;;;NTZhw
553;École doctorale Carnot - Pasteur;;3;Sciences de la terre et de l'univers, espace;2016;2015-16;2015;2015;0;0;0;4;0;4;2;0;2;;;;;6h4Z7
554;École doctorale Environnements - Santé;E-S;2;Physique;2016;2015-16;2015;2015;1;0;1;1;0;1;0;0;0;;;;;ElyFU
558;École doctorale Histoire, Mémoire, Patrimoine, Langage;HMPL;6;Sciences humaines et humanités;2016;2015-16;2015;2015;66;35;31;358;195;163;47;23;24;;;;;uX3jT
559;École doctorale Management Panthéon-Sorbonne;;9;Sciences et technologies de l'information et de la communication;2016;2015-16;2015;2015;11;5;6;25;12;13;2;1;1;;;;;4SP7k
560;École doctorale Sciences de la terre et de l'environnement et Physique de l'univers, Paris;STEP'UP;3;Sciences de la terre et de l'univers, espace;2016;2015-16;2015;2015;44;19;25;213;88;125;40;13;27;;;;;Z2VI9
563;École doctorale Médicament - Toxicologie - Chimie - Imageries;MTCI;4;Chimie;2016;2015-16;2015;2015;14;7;7;46;21;25;11;7;4;;;;;j8uk1
567;École doctorale Sciences du Végétal : du gène à l'écosystème;;10;Sciences agronomiques et écologiques;2016;2015-16;2015;2015;5;2;3;33;18;15;5;4;1;;;;;tuDkA
573;École doctorale Interfaces : Approches Interdisciplinaires, Fondements, Applications et Innovation;ED INTERFACES;4;Chimie;2016;2015-16;2015;2015;12;7;5;39;22;17;2;2;0;;;;;gG820
573;École doctorale Interfaces : Approches Interdisciplinaires, Fondements, Applications et Innovation;ED INTERFACES;8;Sciences pour l'ingénieur;2016;2015-16;2015;2015;15;4;11;72;28;44;3;2;1;;;;;gG820
573;École doctorale Interfaces : Approches Interdisciplinaires, Fondements, Applications et Innovation;ED INTERFACES;9;Sciences et technologies de l'information et de la communication;2016;2015-16;2015;2015;11;3;8;29;7;22;0;0;0;;;;;gG820
575;École doctorale Electrical, Optical, Bio : Physics and Engineering;EOBE;9;Sciences et technologies de l'information et de la communication;2016;2015-16;2015;2015;10;4;6;32;6;26;0;0;0;;;;;dfhyn
577;École doctorale Structure et dynamique des systèmes vivants;SDSV;4;Chimie;2016;2015-16;2015;2015;0;0;0;3;2;1;0;0;0;;;;;4bsxJ
579;École doctorale Sciences mécaniques et energétiques, matériaux et géosciences;SMEMaG;4;Chimie;2016;2015-16;2015;2015;3;0;3;11;4;7;1;1;0;;;;;atMj7
580;École doctorale Sciences et technologies de l'information et de la communication;STIC;2;Physique;2016;2015-16;2015;2015;1;0;1;3;0;3;0;0;0;;;;;AzCC0
583;École doctorale Risques et Société;;6;Sciences humaines et humanités;2016;2015-16;2015;2015;4;1;3;11;5;6;0;0;0;;;;;wUBi9
585;École doctorale Sciences, Technologie,  Sante;EDSTS;2;Physique;2016;2015-16;2015;2015;3;1;2;15;8;7;0;0;0;;;;;NM3Dl
585;École doctorale Sciences, Technologie,  Sante;EDSTS;4;Chimie;2016;2015-16;2015;2015;14;5;9;43;14;29;6;1;5;;;;;NM3Dl
585;École doctorale Sciences, Technologie,  Sante;EDSTS;8;Sciences pour l'ingénieur;2016;2015-16;2015;2015;6;2;4;26;9;17;2;0;2;;;;;NM3Dl
586;École doctorale Sciences Humaines et Sociales;EDSHS;7;Sciences de la société;2016;2015-16;2015;2015;17;6;11;93;40;53;2;0;2;;;;;0RKVX
587;École doctorale Diversites, santé et développement en Amazonie;;3;Sciences de la terre et de l'univers, espace;2016;2015-16;2015;2015;1;0;1;6;2;4;0;0;0;;;;;V14tj
589;École doctorale Milieu insulaire tropical à risques : protection, valorisation , santé et développement;;10;Sciences agronomiques et écologiques;2016;2015-16;2015;2015;2;2;0;9;7;2;2;2;0;;;;;2cqi3
22;École doctorale Mondes anciens et médiévaux;;6;Sciences humaines et humanités;2012;2011-12;2011;2011;42;24;18;220;136;84;37;23;14;;;;;fqCbl
31;École doctorale Pratiques et théories du sens;;7;Sciences de la société;2012;2011-12;2011;2011;6;4;2;35;16;19;4;1;3;;;;;1S466
34;École doctorale Matériaux;;3;Sciences de la terre et de l'univers, espace;2012;2011-12;2011;2011;9;6;3;59;31;28;13;8;5;;;;;1Iufh
34;École doctorale Matériaux;;8;Sciences pour l'ingénieur;2012;2011-12;2011;2011;31;10;21;150;54;96;8;2;6;;;;;1Iufh
37;École doctorale Sciences physiques pour l'ingénieur et microtechniques;SPIM;9;Sciences et technologies de l'information et de la communication;2012;2011-12;2011;2011;17;2;15;74;14;60;14;1;13;;;;;F7G1B
38;École doctorale Langages, espaces, temps, sociétés;;6;Sciences humaines et humanités;2012;2011-12;2011;2011;65;35;30;316;173;143;56;25;31;;;;;pGgDX
39;École doctorale Mathématiques et Informatique;EDMIB;1;Mathématiques et leurs interactions;2012;2011-12;2011;2011;21;2;19;83;10;73;10;3;7;;;;;TBj2X
39;École doctorale Mathématiques et Informatique;EDMIB;9;Sciences et technologies de l'information et de la communication;2012;2011-12;2011;2011;33;9;24;127;21;106;33;7;26;;;;;TBj2X
41;École doctorale Droit;;7;Sciences de la société;2012;2011-12;2011;2011;74;39;35;317;152;165;19;4;15;;;;;KnOQK
60;École doctorale Territoires, temps, sociétés et développement;TTSD;7;Sciences de la société;2012;2011-12;2011;2011;19;10;9;82;45;37;17;7;10;;;;;fkIh6
68;École doctorale Littératures, cultures et sciences sociales;;7;Sciences de la société;2012;2011-12;2011;2011;16;11;5;42;25;17;1;0;1;;;;;NZuM2
70;École doctorale Sciences pour l'ingénieur;EDSPI;8;Sciences pour l'ingénieur;2012;2011-12;2011;2011;14;2;12;61;10;51;10;1;9;;;;;G413P
73;École doctorale Sciences économiques, sociales, de l'aménagement et du management;SESAM;6;Sciences humaines et humanités;2012;2011-12;2011;2011;1;0;1;9;1;8;2;1;1;;;;;IQ0Hk
74;École doctorale Sciences juridiques, politique et de gestion;SJPG;7;Sciences de la société;2012;2011-12;2011;2011;59;30;29;336;181;155;21;7;14;;;;;3A2RY
78;École doctorale Sociétés, langages, temps, connaissances;STLC;7;Sciences de la société;2012;2011-12;2011;2011;5;2;3;18;8;10;2;1;1;;;;;vLU3i
88;École doctorale Droit et science politique;DSP;7;Sciences de la société;2012;2011-12;2011;2011;62;32;30;364;157;207;40;14;26;;;;;elnAJ
92;École doctorale Vie -  Agro - Santé;;5;Biologie, médecine et santé;2012;2011-12;2011;2011;46;20;26;202;95;107;48;19;29;;;;;RjvXY
92;École doctorale Vie -  Agro - Santé;;10;Sciences agronomiques et écologiques;2012;2011-12;2011;2011;33;13;20;114;60;54;42;22;20;;;;;RjvXY
102;École doctorale Santé, sciences, technologies;;3;Sciences de la terre et de l'univers, espace;2012;2011-12;2011;2011;4;2;2;4;2;2;5;3;2;;;;;4h65n
102;École doctorale Santé, sciences, technologies;;8;Sciences pour l'ingénieur;2012;2011-12;2011;2011;2;0;2;24;5;19;0;0;0;;;;;4h65n
104;École doctorale Sciences de la matière, du rayonnement et de l'environnement;SMRE;2;Physique;2012;2011-12;2011;2011;13;1;12;64;21;43;18;5;13;;;;;Q5iFz
104;École doctorale Sciences de la matière, du rayonnement et de l'environnement;SMRE;4;Chimie;2012;2011-12;2011;2011;73;23;50;236;83;153;55;28;27;;;;;Q5iFz
109;École doctorale Sciences de la terre;;3;Sciences de la terre et de l'univers, espace;2012;2011-12;2011;2011;30;12;18;136;55;81;30;13;17;;;;;BQNt6
113;École doctorale Histoire;;6;Sciences humaines et humanités;2012;2011-12;2011;2011;72;36;36;435;195;240;50;24;26;;;;;G5wHs
119;École doctorale Science politique;;7;Sciences de la société;2012;2011-12;2011;2011;25;11;14;140;70;70;16;8;8;;;;;eyibb
120;École doctorale Littérature française et comparée;;6;Sciences humaines et humanités;2012;2011-12;2011;2011;46;31;15;297;219;78;43;30;13;;;;;3ULpe
138;École doctorale Lettres, langues, spectacles;LLS;6;Sciences humaines et humanités;2012;2011-12;2011;2011;71;42;29;288;163;125;40;22;18;;;;;y9O3k
139;École doctorale Connaissance, langage, modélisation;CLM;5;Biologie, médecine et santé;2012;2011-12;2011;2011;1;0;1;5;3;2;0;0;0;;;;;1lxGH
142;École doctorale Mathématiques de la région Paris-Sud;;1;Mathématiques et leurs interactions;2012;2011-12;2011;2011;25;5;20;105;20;85;27;6;21;;;;;5XlH9
158;École doctorale Cerveau, cognition, comportement;3C;5;Biologie, médecine et santé;2012;2011-12;2011;2011;82;52;30;316;183;133;83;48;35;;;;;Il62F
160;École doctorale Électronique, électrotechnique, automatique;EEA;5;Biologie, médecine et santé;2012;2011-12;2011;2011;2;1;1;16;4;12;2;0;2;;;;;EgfMQ
162;École doctorale Mécanique, énergétique, génie civil, acoustique;MEGA;8;Sciences pour l'ingénieur;2012;2011-12;2011;2011;87;21;66;376;78;298;92;18;74;;;;;7wCke
166;École doctorale Information, structures et systèmes;I2S;5;Biologie, médecine et santé;2012;2011-12;2011;2011;2;1;1;6;2;4;1;1;0;;;;;2uO68
173;École doctorale Sciences de l'univers, de l'environnement et de l'espace;SDU2E;8;Sciences pour l'ingénieur;2012;2011-12;2011;2011;1;1;0;17;5;12;1;0;1;;;;;R0Z9c
173;École doctorale Sciences de l'univers, de l'environnement et de l'espace;SDU2E;10;Sciences agronomiques et écologiques;2012;2011-12;2011;2011;8;2;6;24;14;10;3;1;2;;;;;R0Z9c
178;École doctorale Sciences fondamentales;;3;Sciences de la terre et de l'univers, espace;2012;2011-12;2011;2011;10;2;8;39;19;20;10;4;6;;;;;1AiR7
180;École doctorale Sciences humaines et sociales : cultures, individus, sociétés;SHS;6;Sciences humaines et humanités;2012;2011-12;2011;2011;28;19;9;97;70;27;21;14;7;;;;;D2BT3
181;École doctorale Structure, informations, matière et matériaux;Simem;3;Sciences de la terre et de l'univers, espace;2012;2011-12;2011;2011;3;0;3;11;4;7;3;0;3;;;;;c1D6f
181;École doctorale Structure, informations, matière et matériaux;Simem;9;Sciences et technologies de l'information et de la communication;2012;2011-12;2011;2011;11;2;9;53;13;40;23;8;15;;;;;c1D6f
211;École doctorale Sciences exactes et leurs applications;ED SEA;3;Sciences de la terre et de l'univers, espace;2012;2011-12;2011;2011;3;2;1;7;4;3;2;0;2;;;;;1G1iC
211;École doctorale Sciences exactes et leurs applications;ED SEA;4;Chimie;2012;2011-12;2011;2011;16;9;7;59;28;31;10;4;6;;;;;1G1iC
211;École doctorale Sciences exactes et leurs applications;ED SEA;6;Sciences humaines et humanités;2012;2011-12;2011;2011;0;0;0;2;0;2;1;0;1;;;;;1G1iC
211;École doctorale Sciences exactes et leurs applications;ED SEA;9;Sciences et technologies de l'information et de la communication;2012;2011-12;2011;2011;2;1;1;19;4;15;4;0;4;;;;;1G1iC
217;École doctorale Mathématiques, sciences et technologies de l'information, informatique;MSTII;9;Sciences et technologies de l'information et de la communication;2012;2011-12;2011;2011;71;11;60;298;57;241;57;9;48;;;;;Ehx7v
222;École doctorale Sciences chimiques;EDSC;4;Chimie;2012;2011-12;2011;2011;58;30;28;240;109;131;59;29;30;;;;;AdU8Q
224;École doctorale Cognition, langage, interaction;;8;Sciences pour l'ingénieur;2012;2011-12;2011;2011;2;1;1;10;6;4;0;0;0;;;;;7v43e
238;École doctorale Sciences humaines et sociales;;7;Sciences de la société;2012;2011-12;2011;2011;25;10;15;128;58;70;15;7;8;;;;;lr2wn
242;École doctorale Économie - Gestion - Normandie;;9;Sciences et technologies de l'information et de la communication;2012;2011-12;2011;2011;6;2;4;12;5;7;2;0;2;;;;;z35ku
251;École doctorale Sciences de l'environnement;;4;Chimie;2012;2011-12;2011;2011;5;3;2;20;12;8;4;1;3;;;;;VR28y
251;École doctorale Sciences de l'environnement;;6;Sciences humaines et humanités;2012;2011-12;2011;2011;4;3;1;12;8;4;4;3;1;;;;;VR28y
251;École doctorale Sciences de l'environnement;;8;Sciences pour l'ingénieur;2012;2011-12;2011;2011;7;4;3;17;11;6;5;4;1;;;;;VR28y
254;École doctorale Sciences de la matière;;2;Physique;2012;2011-12;2011;2011;24;7;17;73;20;53;10;1;9;;;;;365F2
260;École doctorale pluridisciplinaire;;5;Biologie, médecine et santé;2012;2011-12;2011;2011;16;7;9;67;30;37;0;0;0;;;;;sCk1f
260;École doctorale pluridisciplinaire;;9;Sciences et technologies de l'information et de la communication;2012;2011-12;2011;2011;0;0;0;6;6;0;3;1;2;;;;;sCk1f
280;École doctorale Philosophie;;6;Sciences humaines et humanités;2012;2011-12;2011;2011;54;16;38;245;105;140;32;10;22;;;;;kJxnm
284;École doctorale Droit et Science Politique;DSP;7;Sciences de la société;2012;2011-12;2011;2011;15;10;5;66;30;36;4;0;4;;;;;ahH92
285;École doctorale Sciences pratiques;;2;Physique;2012;2011-12;2011;2011;8;2;6;28;14;14;5;2;3;;;;;Jd3t2
285;École doctorale Sciences pratiques;;3;Sciences de la terre et de l'univers, espace;2012;2011-12;2011;2011;0;0;0;1;1;0;0;0;0;;;;;Jd3t2
285;École doctorale Sciences pratiques;;9;Sciences et technologies de l'information et de la communication;2012;2011-12;2011;2011;4;1;3;24;4;20;4;1;3;;;;;Jd3t2
287;École doctorale Sciences pour l'ingénieur;;8;Sciences pour l'ingénieur;2012;2011-12;2011;2011;23;7;16;141;50;91;37;7;30;;;;;48Q1j
304;École doctorale Sciences et environnements;;10;Sciences agronomiques et écologiques;2012;2011-12;2011;2011;7;3;4;32;11;21;8;4;4;;;;;2ywZn
306;École doctorale Sciences des procédés, sciences des aliments;;10;Sciences agronomiques et écologiques;2012;2011-12;2011;2011;6;5;1;41;27;14;8;8;0;;;;;adF7W
351;École doctorale Sciences physiques, mathématiques et de l'information pour l'ingénieur;SPMII;9;Sciences et technologies de l'information et de la communication;2012;2011-12;2011;2011;27;8;19;112;29;83;29;5;24;;;;;rY4EP
353;École doctorale Sciences pour l'ingénieur : mécanique, physique, micro et nanoélectronique;;5;Biologie, médecine et santé;2012;2011-12;2011;2011;4;0;4;10;2;8;2;1;1;;;;;vk5Kp
356;École doctorale Cognition, langage, éducation;;6;Sciences humaines et humanités;2012;2011-12;2011;2011;73;38;35;371;210;161;62;36;26;;;;;55Cpz
358;École doctorale Sciences, technologies, santé;;4;Chimie;2012;2011-12;2011;2011;7;3;4;41;23;18;9;3;6;;;;;OZA3U
358;École doctorale Sciences, technologies, santé;;8;Sciences pour l'ingénieur;2012;2011-12;2011;2011;15;2;13;47;12;35;5;2;3;;;;;OZA3U
364;École doctorale Sciences fondamentales et appliquées;EDSFA;1;Mathématiques et leurs interactions;2012;2011-12;2011;2011;16;5;11;68;16;52;16;3;13;;;;;E483q
368;École doctorale Sciences et santé;;4;Chimie;2012;2011-12;2011;2011;10;4;6;47;18;29;14;6;8;;;;;4L0a1
369;École doctorale Homme, environnement, santé;;5;Biologie, médecine et santé;2012;2011-12;2011;2011;23;10;13;95;50;45;15;9;6;;;;;uZ8W7
369;École doctorale Homme, environnement, santé;;10;Sciences agronomiques et écologiques;2012;2011-12;2011;2011;7;6;1;34;20;14;7;4;3;;;;;uZ8W7
370;École doctorale Lettres, sciences humaines et sociales;LSHS;7;Sciences de la société;2012;2011-12;2011;2011;0;0;0;4;3;1;0;0;0;;;;;xAXXx
371;École doctorale Louis Pasteur;;1;Mathématiques et leurs interactions;2012;2011-12;2011;2011;6;0;6;19;3;16;7;1;6;;;;;2tr4F
373;École doctorale Santé, information/communications et mathématiques, matière;SICMA;1;Mathématiques et leurs interactions;2012;2011-12;2011;2011;6;3;3;23;8;15;6;2;4;;;;;hTJF5
373;École doctorale Santé, information/communications et mathématiques, matière;SICMA;5;Biologie, médecine et santé;2012;2011-12;2011;2011;15;9;6;60;30;30;19;11;8;;;;;hTJF5
377;École doctorale Environnement et société;;3;Sciences de la terre et de l'univers, espace;2012;2011-12;2011;2011;3;1;2;11;6;5;1;1;0;;;;;ZMG5u
377;École doctorale Environnement et société;;6;Sciences humaines et humanités;2012;2011-12;2011;2011;20;13;7;67;43;24;10;6;4;;;;;ZMG5u
377;École doctorale Environnement et société;;9;Sciences et technologies de l'information et de la communication;2012;2011-12;2011;2011;1;0;1;9;0;9;1;1;0;;;;;ZMG5u
386;École doctorale Sciences mathématiques de Paris centre;SMPC;1;Mathématiques et leurs interactions;2012;2011-12;2011;2011;114;22;92;496;111;385;94;23;71;;;;;wMj98
387;École doctorale Interdisciplinaire pour le vivant;I-ViV;2;Physique;2012;2011-12;2011;2011;4;2;2;22;12;10;8;3;5;;;;;06uKM
388;École doctorale Chimie physique et chimie analytique de Paris centre;CPCA;4;Chimie;2012;2011-12;2011;2011;57;26;31;219;110;109;56;24;32;;;;;M0Hnd
395;École doctorale Milieux, cultures et sociétés du passé et du présent;MCSPP;6;Sciences humaines et humanités;2012;2011-12;2011;2011;74;53;21;486;320;166;48;30;18;;;;;2quEb
398;École doctorale Géosciences, ressources naturelles et environnement;GRNE;3;Sciences de la terre et de l'univers, espace;2012;2011-12;2011;2011;27;13;14;145;60;85;24;11;13;;;;;Zi4Zf
400;École doctorale Savoirs scientifiques : épistémologie, histoire des sciences, didactique des disciplines;;1;Mathématiques et leurs interactions;2012;2011-12;2011;2011;11;4;7;34;14;20;3;2;1;;;;;nRax3
400;École doctorale Savoirs scientifiques : épistémologie, histoire des sciences, didactique des disciplines;;2;Physique;2012;2011-12;2011;2011;3;1;2;5;1;4;0;0;0;;;;;nRax3
400;École doctorale Savoirs scientifiques : épistémologie, histoire des sciences, didactique des disciplines;;6;Sciences humaines et humanités;2012;2011-12;2011;2011;2;2;0;25;10;15;0;0;0;;;;;nRax3
400;École doctorale Savoirs scientifiques : épistémologie, histoire des sciences, didactique des disciplines;;7;Sciences de la société;2012;2011-12;2011;2011;7;3;4;22;11;11;2;1;1;;;;;nRax3
409;École doctorale Énergie, mécanique, matériaux;EMMA;2;Physique;2012;2011-12;2011;2011;5;1;4;32;6;26;10;2;8;;;;;KXlbK
409;École doctorale Énergie, mécanique, matériaux;EMMA;4;Chimie;2012;2011-12;2011;2011;33;11;22;104;36;68;35;8;27;;;;;KXlbK
411;École doctorale Humanités nouvelles : Fernand Braudel;;7;Sciences de la société;2012;2011-12;2011;2011;8;4;4;76;44;32;4;2;2;;;;;l2rFh
413;École doctorale Sciences de la terre et de l'environnement;STE;6;Sciences humaines et humanités;2012;2011-12;2011;2011;6;2;4;19;6;13;1;1;0;;;;;u9BA9
414;École doctorale Sciences de la vie et de la santé;;2;Physique;2012;2011-12;2011;2011;0;0;0;1;0;1;1;0;1;;;;;YI4xS
415;"École doctorale Interdisciplinaire ""Arts et métiers""";;7;Sciences de la société;2012;2011-12;2011;2011;0;0;0;0;0;0;17;8;9;;;;;B3z99
417;École doctorale Sciences et Ingénierie;S&I;5;Biologie, médecine et santé;2012;2011-12;2011;2011;3;2;1;8;4;4;2;1;1;;;;;SSBvE
420;École doctorale Santé publique Paris 11 - Paris 5;;5;Biologie, médecine et santé;2012;2011-12;2011;2011;38;23;15;126;82;44;20;12;8;;;;;3BNdi
422;École doctorale Sciences et technologies de l'information, des télécommunications et des systèmes;;9;Sciences et technologies de l'information et de la communication;2012;2011-12;2011;2011;77;19;58;304;75;229;50;12;38;;;;;998UM
423;École doctorale Des génomes aux organismes;;1;Mathématiques et leurs interactions;2012;2011-12;2011;2011;0;0;0;4;1;3;0;0;0;;;;;VguHK
423;École doctorale Des génomes aux organismes;;2;Physique;2012;2011-12;2011;2011;1;0;1;2;0;2;0;0;0;;;;;VguHK
433;École doctorale Concepts et langages;;9;Sciences et technologies de l'information et de la communication;2012;2011-12;2011;2011;9;3;6;35;22;13;5;3;2;;;;;v8q34
434;École doctorale Géographie de Paris - Espaces, sociétés, aménagement;EDGP;6;Sciences humaines et humanités;2012;2011-12;2011;2011;63;38;25;308;167;141;37;20;17;;;;;1FmLX
446;École doctorale Biologie - Santé;EDBSL;5;Biologie, médecine et santé;2012;2011-12;2011;2011;98;44;54;301;156;145;75;36;39;;;;;4iEUF
447;École doctorale de l'école polytechnique;;1;Mathématiques et leurs interactions;2012;2011-12;2011;2011;16;2;14;84;13;71;18;2;16;;;;;zgCCh
454;École doctorale Sciences de l'homme, du politique et du territoire;SHPT;7;Sciences de la société;2012;2011-12;2011;2011;29;16;13;133;64;69;15;8;7;;;;;Opv31
459;École doctorale Sciences chimiques Balard;;4;Chimie;2012;2011-12;2011;2011;70;29;41;224;106;118;60;20;40;;;;;YFs2W
461;École doctorale Droit et science politique;;7;Sciences de la société;2012;2011-12;2011;2011;92;57;35;386;225;161;48;29;19;;;;;QGArN
462;École doctorale Sciences de l'homme et de la société;;6;Sciences humaines et humanités;2012;2011-12;2011;2011;12;3;9;80;26;54;20;10;10;;;;;KsM6i
462;École doctorale Sciences de l'homme et de la société;;7;Sciences de la société;2012;2011-12;2011;2011;42;24;18;141;76;65;11;7;4;;;;;KsM6i
465;École doctorale Économie Panthéon Sorbonne;EPS;1;Mathématiques et leurs interactions;2012;2011-12;2011;2011;13;5;8;40;16;24;7;1;6;;;;;MV68S
465;École doctorale Économie Panthéon Sorbonne;EPS;7;Sciences de la société;2012;2011-12;2011;2011;86;40;46;320;131;189;55;21;34;;;;;MV68S
467;École doctorale Aéronautique, astronautique;AA;6;Sciences humaines et humanités;2012;2011-12;2011;2011;1;0;1;5;1;4;3;1;2;;;;;U7l45
467;École doctorale Aéronautique, astronautique;AA;7;Sciences de la société;2012;2011-12;2011;2011;0;0;0;3;3;0;3;0;3;;;;;U7l45
467;École doctorale Aéronautique, astronautique;AA;9;Sciences et technologies de l'information et de la communication;2012;2011-12;2011;2011;1;0;1;5;1;4;3;0;3;;;;;U7l45
469;École doctorale du Pacifique;EDP;7;Sciences de la société;2012;2011-12;2011;2011;8;4;4;18;8;10;1;0;1;;;;;t9Z2n
469;École doctorale du Pacifique;EDP;10;Sciences agronomiques et écologiques;2012;2011-12;2011;2011;2;2;0;15;8;7;1;1;0;;;;;t9Z2n
474;École doctorale Interdisciplinaire européenne frontières du vivant;FDV;9;Sciences et technologies de l'information et de la communication;2012;2011-12;2011;2011;0;0;0;3;1;2;1;1;0;;;;;E727j
475;École doctorale Mathématiques, informatique, télécommunications de Toulouse;MITT;9;Sciences et technologies de l'information et de la communication;2012;2011-12;2011;2011;92;22;70;379;90;289;53;12;41;;;;;xcp2r
477;École doctorale Systèmes intégrés en biologie, agronomie, géosciences, hydrosciences, environnement;SIBAGHE;8;Sciences pour l'ingénieur;2012;2011-12;2011;2011;0;0;0;3;1;2;0;0;0;;;;;zfN3N
480;École doctorale Montaigne-humanités;;3;Sciences de la terre et de l'univers, espace;2012;2011-12;2011;2011;7;2;5;17;7;10;5;0;5;;;;;f3SeZ
481;École doctorale Sciences sociales et humanités;SSH;6;Sciences humaines et humanités;2012;2011-12;2011;2011;20;14;6;100;67;33;12;7;5;;;;;E3z5j
484;École doctorale Lettres, langues, linguistique, arts;3LA;6;Sciences humaines et humanités;2012;2011-12;2011;2011;118;64;54;550;333;217;58;38;20;;;;;BlCQD
485;École doctorale Éducation, Psychologie, Information et Communication;EPIC;6;Sciences humaines et humanités;2012;2011-12;2011;2011;74;48;26;318;193;125;47;28;19;;;;;O82eL
486;École doctorale Sciences économiques et de gestion;SEG;9;Sciences et technologies de l'information et de la communication;2012;2011-12;2011;2011;0;0;0;2;2;0;0;0;0;;;;;h1GZ3
487;École doctorale Philosophie;PHCR;6;Sciences humaines et humanités;2012;2011-12;2011;2011;36;13;23;181;78;103;19;7;12;;;;;3BRzJ
488;École doctorale Sciences, ingénierie, santé;SIS;4;Chimie;2012;2011-12;2011;2011;4;2;2;17;8;9;7;2;5;;;;;Fy2lK
489;École doctorale Sciences et ingénierie des systèmes, de l'environnement et des organisations;SISEO;3;Sciences de la terre et de l'univers, espace;2012;2011-12;2011;2011;7;5;2;27;13;14;3;2;1;;;;;6pT77
490;École doctorale Environnement - Santé/STIC;E2S;5;Biologie, médecine et santé;2012;2011-12;2011;2011;28;13;15;118;52;66;28;11;17;;;;;sYTua
490;École doctorale Environnement - Santé/STIC;E2S;6;Sciences humaines et humanités;2012;2011-12;2011;2011;8;7;1;31;17;14;10;6;4;;;;;sYTua
491;École doctorale Langages, idées, sociétés, institutions, territoires;LISIT;7;Sciences de la société;2012;2011-12;2011;2011;39;17;22;225;107;118;39;17;22;;;;;iB25j
493;École doctorale Erasme;;7;Sciences de la société;2012;2011-12;2011;2011;38;25;13;146;96;50;27;17;10;;;;;FPW4T
493;École doctorale Erasme;;9;Sciences et technologies de l'information et de la communication;2012;2011-12;2011;2011;5;3;2;23;14;9;3;2;1;;;;;FPW4T
494;École doctorale Jean-Henri Lambert;;10;Sciences agronomiques et écologiques;2012;2011-12;2011;2011;1;0;1;4;2;2;2;2;0;;;;;A3m51
498;École doctorale Sciences pour l'ingénieur, géosciences, architecture;SPIGA;8;Sciences pour l'ingénieur;2012;2011-12;2011;2011;83;19;64;356;100;256;78;20;58;;;;;0vlKH
500;École doctorale Matière, molécules, matériaux en Pays de Loire;3MPL;8;Sciences pour l'ingénieur;2012;2011-12;2011;2011;4;1;3;13;2;11;3;0;3;;;;;822tM
503;École doctorale Sciences et technologies de l'information et de mathématiques;STIM;6;Sciences humaines et humanités;2012;2011-12;2011;2011;3;1;2;3;1;2;0;0;0;;;;;JQevP
508;École doctorale Normande de chimie;EDNC;4;Chimie;2012;2011-12;2011;2011;39;22;17;155;80;75;31;13;18;;;;;E52OO
509;École doctorale Civilisations et sociétés euro-méditerranéennes et comparées;;7;Sciences de la société;2012;2011-12;2011;2011;21;10;11;109;49;60;6;1;5;;;;;9tbyG
511;École doctorale Sciences et ingénierie;S&I;1;Mathématiques et leurs interactions;2012;2011-12;2011;2011;4;1;3;11;3;8;3;2;1;;;;;7aXuB
511;École doctorale Sciences et ingénierie;S&I;9;Sciences et technologies de l'information et de la communication;2012;2011-12;2011;2011;22;3;19;76;20;56;21;3;18;;;;;7aXuB
512;École doctorale Informatique et mathématiques;InfoMaths;9;Sciences et technologies de l'information et de la communication;2012;2011-12;2011;2011;50;14;36;227;60;167;44;13;31;;;;;t86bi
522;École doctorale Sciences et ingénierie en matériaux, mécanique, énergétique et aéronautique;SI-MMEA;2;Physique;2012;2011-12;2011;2011;4;0;4;17;3;14;8;2;6;;;;;82F19
523;École doctorale Sciences pour l'environnement - Gay Lussac;;8;Sciences pour l'ingénieur;2012;2011-12;2011;2011;14;4;10;67;18;49;13;2;11;;;;;6xD69
526;École doctorale Sociétés et organisations;SORG;6;Sciences humaines et humanités;2012;2011-12;2011;2011;23;12;11;106;47;59;13;11;2;;;;;5F3Fd
526;École doctorale Sociétés et organisations;SORG;7;Sciences de la société;2012;2011-12;2011;2011;9;5;4;40;17;23;9;2;7;;;;;5F3Fd
527;École doctorale Cognition, comportement, langage(s);CCL;6;Sciences humaines et humanités;2012;2011-12;2011;2011;27;13;14;90;44;46;8;4;4;;;;;MvpY8
528;École doctorale Ville, transports et territoires;VTT;7;Sciences de la société;2012;2011-12;2011;2011;10;7;3;20;13;7;1;1;0;;;;;68zCc
528;École doctorale Ville, transports et territoires;VTT;8;Sciences pour l'ingénieur;2012;2011-12;2011;2011;3;2;1;7;2;5;0;0;0;;;;;68zCc
529;École doctorale Cultures et sociétés;CS;9;Sciences et technologies de l'information et de la communication;2012;2011-12;2011;2011;4;3;1;19;10;9;3;2;1;;;;;XU9tb
531;École doctorale Sciences, ingénierie et environnement;SIE;2;Physique;2012;2011-12;2011;2011;5;3;2;22;8;14;8;1;7;;;;;b5BYq
531;École doctorale Sciences, ingénierie et environnement;SIE;10;Sciences agronomiques et écologiques;2012;2011-12;2011;2011;3;1;2;7;4;3;1;1;0;;;;;b5BYq
536;École doctorale Sciences et agrosciences;;3;Sciences de la terre et de l'univers, espace;2012;2011-12;2011;2011;2;1;1;13;6;7;0;0;0;;;;;pHfqe
539;École doctorale Sciences et technologies de Versailles;;4;Chimie;2012;2011-12;2011;2011;10;6;4;33;17;16;9;4;5;;;;;nv3h8
539;École doctorale Sciences et technologies de Versailles;;8;Sciences pour l'ingénieur;2012;2011-12;2011;2011;9;2;7;42;13;29;2;0;2;;;;;nv3h8
541;École doctorale de sciences humaines et sociales de La Réunion;SHS;7;Sciences de la société;2012;2011-12;2011;2011;16;11;5;59;27;32;3;2;1;;;;;21SpE
542;École doctorale de sciences de La Réunion;STS;3;Sciences de la terre et de l'univers, espace;2012;2011-12;2011;2011;1;1;0;11;6;5;6;3;3;;;;;2pAql
542;École doctorale de sciences de La Réunion;STS;9;Sciences et technologies de l'information et de la communication;2012;2011-12;2011;2011;6;4;2;11;8;3;0;0;0;;;;;2pAql
543;École doctorale de Dauphine;;9;Sciences et technologies de l'information et de la communication;2012;2011-12;2011;2011;4;1;3;33;10;23;8;3;5;;;;;u8w6A
545;École doctorale Sociétés, politique et santé publique;SP2;7;Sciences de la société;2012;2011-12;2011;2011;31;15;16;137;78;59;26;13;13;;;;;IAKR4
546;École doctorale Abbé Grégoire;;6;Sciences humaines et humanités;2012;2011-12;2011;2011;25;16;9;30;18;12;5;2;3;;;;;ZSn7q
20;École doctorale Civilisations, cultures, littératures et sociétés;;6;Sciences humaines et humanités;2011;2010-11;2010;2010;52;43;9;219;157;62;31;17;14;;;;;agjNi
31;École doctorale Pratiques et théories du sens;;6;Sciences humaines et humanités;2011;2010-11;2010;2010;140;75;65;666;380;286;56;30;26;;;;;1S466
34;École doctorale Matériaux;;2;Physique;2011;2010-11;2010;2010;13;2;11;74;23;51;10;0;10;;;;;1Iufh
34;École doctorale Matériaux;;3;Sciences de la terre et de l'univers, espace;2011;2010-11;2010;2010;20;8;12;72;27;45;10;4;6;;;;;1Iufh
34;École doctorale Matériaux;;4;Chimie;2011;2010-11;2010;2010;25;11;14;111;48;63;22;10;12;;;;;1Iufh
34;École doctorale Matériaux;;8;Sciences pour l'ingénieur;2011;2010-11;2010;2010;10;9;1;12;9;3;4;2;2;;;;;1Iufh
39;École doctorale Mathématiques et Informatique;EDMIB;1;Mathématiques et leurs interactions;2011;2010-11;2010;2010;29;4;25;87;17;70;21;6;15;;;;;TBj2X
41;École doctorale Droit;;7;Sciences de la société;2011;2010-11;2010;2010;51;25;26;279;133;146;27;15;12;;;;;KnOQK
52;École doctorale Physique et astrophysique de Lyon;PHAST;3;Sciences de la terre et de l'univers, espace;2011;2010-11;2010;2010;2;1;1;15;4;11;0;0;0;;;;;61XPb
65;École doctorale Sciences de la Vie, Santé, Agronomie, Environnement;;10;Sciences agronomiques et écologiques;2011;2010-11;2010;2010;22;14;8;103;59;44;22;15;7;;;;;MAOG4
67;École doctorale Sciences juridiques et politiques;;7;Sciences de la société;2011;2010-11;2010;2010;165;79;86;705;365;340;71;35;36;;;;;qrOj1
70;École doctorale Sciences pour l'ingénieur;EDSPI;9;Sciences et technologies de l'information et de la communication;2011;2010-11;2010;2010;45;5;40;155;20;135;27;5;22;;;;;G413P
71;École doctorale Sciences pour l'ingénieur;;8;Sciences pour l'ingénieur;2011;2010-11;2010;2010;44;18;26;179;70;109;37;13;24;;;;;H6UYp
74;École doctorale Sciences juridiques, politique et de gestion;SJPG;7;Sciences de la société;2011;2010-11;2010;2010;49;26;23;320;171;149;28;12;16;;;;;3A2RY
77;École doctorale Informatique, automatique, électronique, électrotechnique, mathématiques;IAEM;6;Sciences humaines et humanités;2011;2010-11;2010;2010;1;0;1;7;3;4;2;0;2;;;;;TCHTA
77;École doctorale Informatique, automatique, électronique, électrotechnique, mathématiques;IAEM;8;Sciences pour l'ingénieur;2011;2010-11;2010;2010;5;1;4;34;5;29;9;0;9;;;;;TCHTA
92;École doctorale Vie -  Agro - Santé;;1;Mathématiques et leurs interactions;2011;2010-11;2010;2010;0;0;0;2;0;2;2;1;1;;;;;RjvXY
102;École doctorale Santé, sciences, technologies;;8;Sciences pour l'ingénieur;2011;2010-11;2010;2010;9;2;7;15;3;12;2;0;2;;;;;4h65n
102;École doctorale Santé, sciences, technologies;;9;Sciences et technologies de l'information et de la communication;2011;2010-11;2010;2010;10;1;9;44;4;40;10;1;9;;;;;4h65n
102;École doctorale Santé, sciences, technologies;;10;Sciences agronomiques et écologiques;2011;2010-11;2010;2010;3;0;3;15;6;9;2;1;1;;;;;4h65n
104;École doctorale Sciences de la matière, du rayonnement et de l'environnement;SMRE;2;Physique;2011;2010-11;2010;2010;18;6;12;65;20;45;12;5;7;;;;;Q5iFz
119;École doctorale Science politique;;7;Sciences de la société;2011;2010-11;2010;2010;22;10;12;158;86;72;15;7;8;;;;;eyibb
124;École doctorale Histoire de l'art et archéologie;;6;Sciences humaines et humanités;2011;2010-11;2010;2010;48;39;9;260;191;69;37;25;12;;;;;MBN4L
127;École doctorale Astronomie et astrophysique d'Ile de France;A&A;3;Sciences de la terre et de l'univers, espace;2011;2010-11;2010;2010;56;21;35;166;67;99;55;20;35;;;;;cPXrq
129;École doctorale Sciences de l'environnement d'Ile de France;SEIF;4;Chimie;2011;2010-11;2010;2010;5;1;4;18;6;12;2;1;1;;;;;TnAPh
131;École doctorale Langue, littérature, image, civilisations et sciences humaines (domaines francophone et anglophone);LLI;6;Sciences humaines et humanités;2011;2010-11;2010;2010;51;33;18;323;218;105;25;19;6;;;;;a47aW
132;École doctorale Sciences du langage;;6;Sciences humaines et humanités;2011;2010-11;2010;2010;19;13;6;109;71;38;16;11;5;;;;;5AUF1
139;École doctorale Connaissance, langage, modélisation;CLM;6;Sciences humaines et humanités;2011;2010-11;2010;2010;67;45;22;385;208;177;66;36;30;;;;;1lxGH
139;École doctorale Connaissance, langage, modélisation;CLM;9;Sciences et technologies de l'information et de la communication;2011;2010-11;2010;2010;1;1;0;5;1;4;2;1;1;;;;;1lxGH
146;École doctorale Galilée;GALILEE;5;Biologie, médecine et santé;2011;2010-11;2010;2010;19;12;7;58;32;26;10;5;5;;;;;71hqm
146;École doctorale Galilée;GALILEE;8;Sciences pour l'ingénieur;2011;2010-11;2010;2010;9;3;6;31;11;20;6;2;4;;;;;71hqm
149;École doctorale Carnot;;4;Chimie;2011;2010-11;2010;2010;21;4;17;80;27;53;18;10;8;;;;;zuThw
149;École doctorale Carnot;;8;Sciences pour l'ingénieur;2011;2010-11;2010;2010;4;0;4;23;5;18;2;0;2;;;;;zuThw
151;École doctorale Biologie, santé, biotechnologies;;5;Biologie, médecine et santé;2011;2010-11;2010;2010;79;40;39;338;195;143;93;61;32;;;;;yP8w4
156;École doctorale Sciences de la mer;;5;Biologie, médecine et santé;2011;2010-11;2010;2010;17;8;9;62;34;28;9;7;2;;;;;EGY9P
156;École doctorale Sciences de la mer;;6;Sciences humaines et humanités;2011;2010-11;2010;2010;2;0;2;12;6;6;1;0;1;;;;;EGY9P
157;École doctorale Génétique, cellulaire, immunologie, infectiologie et développement;GC2ID;5;Biologie, médecine et santé;2011;2010-11;2010;2010;71;46;25;264;179;85;65;36;29;;;;;Sl3l2
158;École doctorale Cerveau, cognition, comportement;3C;5;Biologie, médecine et santé;2011;2010-11;2010;2010;71;36;35;337;183;154;84;48;36;;;;;Il62F
166;École doctorale Information, structures et systèmes;I2S;3;Sciences de la terre et de l'univers, espace;2011;2010-11;2010;2010;3;1;2;8;2;6;6;2;4;;;;;2uO68
166;École doctorale Information, structures et systèmes;I2S;6;Sciences humaines et humanités;2011;2010-11;2010;2010;0;0;0;4;4;0;0;0;0;;;;;2uO68
166;École doctorale Information, structures et systèmes;I2S;9;Sciences et technologies de l'information et de la communication;2011;2010-11;2010;2010;51;13;38;196;44;152;50;10;40;;;;;2uO68
173;École doctorale Sciences de l'univers, de l'environnement et de l'espace;SDU2E;8;Sciences pour l'ingénieur;2011;2010-11;2010;2010;2;1;1;16;4;12;3;0;3;;;;;R0Z9c
177;École doctorale Sciences et technologies de l'université d'Orléans;;4;Chimie;2011;2010-11;2010;2010;21;10;11;69;32;37;14;8;6;;;;;JI65m
177;École doctorale Sciences et technologies de l'université d'Orléans;;10;Sciences agronomiques et écologiques;2011;2010-11;2010;2010;0;0;0;2;1;1;0;0;0;;;;;JI65m
181;École doctorale Structure, informations, matière et matériaux;Simem;8;Sciences pour l'ingénieur;2011;2010-11;2010;2010;4;0;4;14;1;13;0;0;0;;;;;c1D6f
184;École doctorale Mathématiques et informatique de Marseille;;9;Sciences et technologies de l'information et de la communication;2011;2010-11;2010;2010;20;8;12;71;14;57;13;1;12;;;;;DDObG
209;École doctorale Sciences physiques et de L'ingénieur;SPI;9;Sciences et technologies de l'information et de la communication;2011;2010-11;2010;2010;31;5;26;139;30;109;25;7;18;;;;;tZcIZ
211;École doctorale Sciences exactes et leurs applications;ED SEA;1;Mathématiques et leurs interactions;2011;2010-11;2010;2010;9;3;6;22;6;16;5;3;2;;;;;1G1iC
211;École doctorale Sciences exactes et leurs applications;ED SEA;3;Sciences de la terre et de l'univers, espace;2011;2010-11;2010;2010;2;1;1;6;2;4;1;0;1;;;;;1G1iC
211;École doctorale Sciences exactes et leurs applications;ED SEA;5;Biologie, médecine et santé;2011;2010-11;2010;2010;3;1;2;8;5;3;4;2;2;;;;;1G1iC
217;École doctorale Mathématiques, sciences et technologies de l'information, informatique;MSTII;9;Sciences et technologies de l'information et de la communication;2011;2010-11;2010;2010;75;16;59;302;62;240;79;14;65;;;;;Ehx7v
218;École doctorale Chimie et sciences du vivant;EDCSV;4;Chimie;2011;2010-11;2010;2010;20;10;10;96;44;52;21;8;13;;;;;8bcJh
220;École doctorale Électronique, électrotechnique, automatique, traitement du signal;EEATS;8;Sciences pour l'ingénieur;2011;2010-11;2010;2010;26;6;20;111;24;87;26;4;22;;;;;IxEaw
220;École doctorale Électronique, électrotechnique, automatique, traitement du signal;EEATS;9;Sciences et technologies de l'information et de la communication;2011;2010-11;2010;2010;101;29;72;406;94;312;86;18;68;;;;;IxEaw
222;École doctorale Sciences chimiques;EDSC;2;Physique;2011;2010-11;2010;2010;3;2;1;17;7;10;0;0;0;;;;;AdU8Q
222;École doctorale Sciences chimiques;EDSC;4;Chimie;2011;2010-11;2010;2010;56;25;31;223;99;124;73;30;43;;;;;AdU8Q
227;École doctorale Sciences de la nature et de l'homme;;3;Sciences de la terre et de l'univers, espace;2011;2010-11;2010;2010;0;0;0;5;2;3;3;0;3;;;;;xiDA5
227;École doctorale Sciences de la nature et de l'homme;;10;Sciences agronomiques et écologiques;2011;2010-11;2010;2010;6;1;5;27;12;15;5;3;2;;;;;xiDA5
234;École doctorale de Sciences Po;;7;Sciences de la société;2011;2010-11;2010;2010;99;48;51;492;257;235;86;46;40;;;;;ux756
250;École doctorale Sciences chimiques;;4;Chimie;2011;2010-11;2010;2010;34;14;20;117;50;67;38;10;28;;;;;O0Fav
251;École doctorale Sciences de l'environnement;;5;Biologie, médecine et santé;2011;2010-11;2010;2010;6;4;2;22;11;11;11;5;6;;;;;VR28y
254;École doctorale Sciences de la matière;;8;Sciences pour l'ingénieur;2011;2010-11;2010;2010;10;1;9;60;11;49;12;2;10;;;;;365F2
260;École doctorale pluridisciplinaire;;4;Chimie;2011;2010-11;2010;2010;5;2;3;15;10;5;2;2;0;;;;;sCk1f
260;École doctorale pluridisciplinaire;;5;Biologie, médecine et santé;2011;2010-11;2010;2010;6;5;1;27;17;10;5;3;2;;;;;sCk1f
268;École doctorale Langage et langues : description, théorisation, transmission;;6;Sciences humaines et humanités;2011;2010-11;2010;2010;50;36;14;338;246;92;35;23;12;;;;;wAIDE
270;École doctorale Théologie et sciences religieuses;;6;Sciences humaines et humanités;2011;2010-11;2010;2010;28;8;20;156;33;123;14;1;13;;;;;BRKC1
285;École doctorale Sciences pratiques;;9;Sciences et technologies de l'information et de la communication;2011;2010-11;2010;2010;10;2;8;28;6;22;6;0;6;;;;;Jd3t2
286;École doctorale de l'Ehess;;7;Sciences de la société;2011;2010-11;2010;2010;108;67;41;384;214;170;66;40;26;;;;;2S146
288;École doctorale Ondes et matière;EDOM;2;Physique;2011;2010-11;2010;2010;40;10;30;174;46;128;35;12;23;;;;;kJrcx
303;École doctorale Sciences sociales : société, santé, décision;;6;Sciences humaines et humanités;2011;2010-11;2010;2010;33;19;14;116;64;52;26;14;12;;;;;s3X5X
305;École doctorale Énergie et environnement;E2;4;Chimie;2011;2010-11;2010;2010;2;0;2;12;4;8;3;1;2;;;;;Kbt8I
306;École doctorale Sciences des procédés, sciences des aliments;;5;Biologie, médecine et santé;2011;2010-11;2010;2010;7;5;2;19;12;7;9;5;4;;;;;adF7W
323;École doctorale Génie électrique, électronique et télécommunications;GEET;9;Sciences et technologies de l'information et de la communication;2011;2010-11;2010;2010;35;6;29;154;32;122;41;7;34;;;;;arcz6
352;École doctorale Physique et sciences de la matière;;5;Biologie, médecine et santé;2011;2010-11;2010;2010;0;0;0;3;1;2;0;0;0;;;;;fb5YC
353;École doctorale Sciences pour l'ingénieur : mécanique, physique, micro et nanoélectronique;;4;Chimie;2011;2010-11;2010;2010;1;1;0;2;2;0;1;1;0;;;;;vk5Kp
353;École doctorale Sciences pour l'ingénieur : mécanique, physique, micro et nanoélectronique;;8;Sciences pour l'ingénieur;2011;2010-11;2010;2010;38;10;28;155;28;127;30;4;26;;;;;vk5Kp
353;École doctorale Sciences pour l'ingénieur : mécanique, physique, micro et nanoélectronique;;9;Sciences et technologies de l'information et de la communication;2011;2010-11;2010;2010;3;0;3;13;1;12;3;1;2;;;;;vk5Kp
356;École doctorale Cognition, langage, éducation;;6;Sciences humaines et humanités;2011;2010-11;2010;2010;87;57;30;383;217;166;62;39;23;;;;;55Cpz
358;École doctorale Sciences, technologies, santé;;3;Sciences de la terre et de l'univers, espace;2011;2010-11;2010;2010;0;0;0;3;2;1;0;0;0;;;;;OZA3U
358;École doctorale Sciences, technologies, santé;;8;Sciences pour l'ingénieur;2011;2010-11;2010;2010;12;6;6;41;10;31;9;0;9;;;;;OZA3U
359;École doctorale Mathématiques, télécommunications, informatique, signal, systèmes, électronique;MATISSE;9;Sciences et technologies de l'information et de la communication;2011;2010-11;2010;2010;139;24;115;450;88;362;130;22;108;;;;;Y0r76
368;École doctorale Sciences et santé;;9;Sciences et technologies de l'information et de la communication;2011;2010-11;2010;2010;5;2;3;26;8;18;6;1;5;;;;;4L0a1
371;École doctorale Louis Pasteur;;2;Physique;2011;2010-11;2010;2010;4;3;1;14;6;8;7;1;6;;;;;2tr4F
373;École doctorale Santé, information/communications et mathématiques, matière;SICMA;5;Biologie, médecine et santé;2011;2010-11;2010;2010;20;12;8;78;37;41;20;11;9;;;;;hTJF5
378;École doctorale Sciences de l'homme et de la société;SHS;7;Sciences de la société;2011;2010-11;2010;2010;21;11;10;100;51;49;14;3;11;;;;;3XKuF
382;École doctorale Économie, espaces, sociétés, civilisations : pensée critique, politique et pratique sociale;EESC;6;Sciences humaines et humanités;2011;2010-11;2010;2010;23;12;11;119;68;51;10;5;5;;;;;9NI1W
386;École doctorale Sciences mathématiques de Paris centre;SMPC;1;Mathématiques et leurs interactions;2011;2010-11;2010;2010;103;27;76;399;99;300;61;13;48;;;;;wMj98
387;École doctorale Interdisciplinaire pour le vivant;I-ViV;5;Biologie, médecine et santé;2011;2010-11;2010;2010;28;18;10;107;57;50;24;13;11;;;;;06uKM
400;École doctorale Savoirs scientifiques : épistémologie, histoire des sciences, didactique des disciplines;;1;Mathématiques et leurs interactions;2011;2010-11;2010;2010;9;6;3;36;16;20;7;3;4;;;;;nRax3
400;École doctorale Savoirs scientifiques : épistémologie, histoire des sciences, didactique des disciplines;;6;Sciences humaines et humanités;2011;2010-11;2010;2010;3;3;0;20;11;9;0;0;0;;;;;nRax3
401;École doctorale Sciences sociales;;6;Sciences humaines et humanités;2011;2010-11;2010;2010;44;17;27;227;98;129;32;17;15;;;;;raQ7K
409;École doctorale Énergie, mécanique, matériaux;EMMA;9;Sciences et technologies de l'information et de la communication;2011;2010-11;2010;2010;1;0;1;1;0;1;1;0;1;;;;;KXlbK
410;École doctorale Sciences et ingénierie des ressources, procédés, produits, environnement;RP2E;10;Sciences agronomiques et écologiques;2011;2010-11;2010;2010;36;20;16;178;91;87;33;15;18;;;;;Q5fxV
412;École doctorale Lorraine de chimie et physique moléculaires : synthèses, expériences, simulations, applications : de la molécule aux édifices supramoléculaires;SESAMES;2;Physique;2011;2010-11;2010;2010;5;0;5;26;13;13;2;1;1;;;;;mvHX2
415;"École doctorale Interdisciplinaire ""Arts et métiers""";;6;Sciences humaines et humanités;2011;2010-11;2010;2010;18;12;6;18;12;6;3;1;2;;;;;B3z99
415;"École doctorale Interdisciplinaire ""Arts et métiers""";;9;Sciences et technologies de l'information et de la communication;2011;2010-11;2010;2010;0;0;0;0;0;0;1;0;1;;;;;B3z99
420;École doctorale Santé publique Paris 11 - Paris 5;;5;Biologie, médecine et santé;2011;2010-11;2010;2010;33;21;12;122;81;41;18;12;6;;;;;3BNdi
423;École doctorale Des génomes aux organismes;;4;Chimie;2011;2010-11;2010;2010;2;0;2;7;2;5;2;0;2;;;;;VguHK
427;École doctorale Informatique Paris-sud;;9;Sciences et technologies de l'information et de la communication;2011;2010-11;2010;2010;42;8;34;195;50;145;48;11;37;;;;;u0T33
432;École doctorale Sciences des métiers de l'ingénieur;SMI;8;Sciences pour l'ingénieur;2011;2010-11;2010;2010;109;26;83;478;118;360;113;28;85;;;;;nSsHB
435;École doctorale Agriculture, alimentation, biologie, environnement et santé;;6;Sciences humaines et humanités;2011;2010-11;2010;2010;11;7;4;27;16;11;4;4;0;;;;;mC35U
436;École doctorale Médicament, toxicologie, chimie, environnement;MTCE;4;Chimie;2011;2010-11;2010;2010;20;9;11;50;28;22;11;6;5;;;;;dPsg3
446;École doctorale Biologie - Santé;EDBSL;5;Biologie, médecine et santé;2011;2010-11;2010;2010;88;48;40;303;166;137;85;54;31;;;;;4iEUF
447;École doctorale de l'école polytechnique;;1;Mathématiques et leurs interactions;2011;2010-11;2010;2010;32;5;27;98;13;85;21;3;18;;;;;zgCCh
447;École doctorale de l'école polytechnique;;4;Chimie;2011;2010-11;2010;2010;16;6;10;59;28;31;18;7;11;;;;;zgCCh
460;École doctorale Sciences juridiques;SJ;7;Sciences de la société;2011;2010-11;2010;2010;32;16;16;173;86;87;16;5;11;;;;;ZB5I5
469;École doctorale du Pacifique;EDP;6;Sciences humaines et humanités;2011;2010-11;2010;2010;5;4;1;21;14;7;4;2;2;;;;;t9Z2n
472;École doctorale de l'EPHE;;5;Biologie, médecine et santé;2011;2010-11;2010;2010;15;10;5;41;22;19;12;11;1;;;;;27zK4
474;École doctorale Interdisciplinaire européenne frontières du vivant;FDV;5;Biologie, médecine et santé;2011;2010-11;2010;2010;17;8;9;64;26;38;7;3;4;;;;;E727j
475;École doctorale Mathématiques, informatique, télécommunications de Toulouse;MITT;1;Mathématiques et leurs interactions;2011;2010-11;2010;2010;133;35;98;483;120;363;94;17;77;;;;;xcp2r
477;École doctorale Systèmes intégrés en biologie, agronomie, géosciences, hydrosciences, environnement;SIBAGHE;5;Biologie, médecine et santé;2011;2010-11;2010;2010;15;10;5;123;61;62;42;21;21;;;;;zfN3N
478;École doctorale Sciences de Gestion;;7;Sciences de la société;2011;2010-11;2010;2010;9;4;5;86;48;38;13;9;4;;;;;q34kB
483;École doctorale Histoire, géographie, aménagement, urbanisme, archéologie, science politique, sociologie, anthropologie;SCSO;3;Sciences de la terre et de l'univers, espace;2011;2010-11;2010;2010;12;10;2;63;30;33;4;2;2;;;;;hc6u4
486;École doctorale Sciences économiques et de gestion;SEG;9;Sciences et technologies de l'information et de la communication;2011;2010-11;2010;2010;0;0;0;3;2;1;2;1;1;;;;;h1GZ3
487;École doctorale Philosophie;PHCR;6;Sciences humaines et humanités;2011;2010-11;2010;2010;56;23;33;181;86;95;13;6;7;;;;;3BRzJ
488;École doctorale Sciences, ingénierie, santé;SIS;9;Sciences et technologies de l'information et de la communication;2011;2010-11;2010;2010;45;15;30;139;42;97;26;6;20;;;;;Fy2lK
490;École doctorale Environnement - Santé/STIC;E2S;10;Sciences agronomiques et écologiques;2011;2010-11;2010;2010;27;17;10;117;77;40;26;18;8;;;;;sYTua
493;École doctorale Erasme;;9;Sciences et technologies de l'information et de la communication;2011;2010-11;2010;2010;8;4;4;28;16;12;5;1;4;;;;;FPW4T
495;École doctorale Végétal, environnement, nutrition, agroalimentaire, mer;VENAM;10;Sciences agronomiques et écologiques;2011;2010-11;2010;2010;39;21;18;160;91;69;18;13;5;;;;;HL495
502;École doctorale Biologie - Santé;;5;Biologie, médecine et santé;2011;2010-11;2010;2010;97;54;43;312;172;140;74;47;27;;;;;JCFV7
509;École doctorale Civilisations et sociétés euro-méditerranéennes et comparées;;7;Sciences de la société;2011;2010-11;2010;2010;31;13;18;124;55;69;6;3;3;;;;;9tbyG
511;École doctorale Sciences et ingénierie;S&I;8;Sciences pour l'ingénieur;2011;2010-11;2010;2010;8;5;3;35;14;21;15;1;14;;;;;7aXuB
512;École doctorale Informatique et mathématiques;InfoMaths;1;Mathématiques et leurs interactions;2011;2010-11;2010;2010;22;6;16;94;18;76;14;3;11;;;;;t86bi
513;École doctorale Droit et sciences politiques, économiques et de gestion;DESPEG;7;Sciences de la société;2011;2010-11;2010;2010;110;53;57;452;240;212;45;25;20;;;;;aVHGU
516;École doctorale Biochimie, biothérapies, biologie moléculaire, infectiologie;B3MI;5;Biologie, médecine et santé;2011;2010-11;2010;2010;75;46;29;288;176;112;84;52;32;;;;;aQTO2
519;École doctorale Sciences humaines et sociales - Perspectives européennes;SHS-PE;9;Sciences et technologies de l'information et de la communication;2011;2010-11;2010;2010;0;0;0;1;1;0;0;0;0;;;;;2f5qs
520;École doctorale Humanités;;7;Sciences de la société;2011;2010-11;2010;2010;2;0;2;8;2;6;1;0;1;;;;;rI175
520;École doctorale Humanités;;9;Sciences et technologies de l'information et de la communication;2011;2010-11;2010;2010;3;2;1;10;7;3;1;1;0;;;;;rI175
521;École doctorale Sciences et ingénierie pour l'information, mathématiques;S2I;8;Sciences pour l'ingénieur;2011;2010-11;2010;2010;0;0;0;3;0;3;3;0;3;;;;;V6i83
522;École doctorale Sciences et ingénierie en matériaux, mécanique, énergétique et aéronautique;SI-MMEA;4;Chimie;2011;2010-11;2010;2010;12;3;9;40;14;26;10;5;5;;;;;82F19
527;École doctorale Cognition, comportement, langage(s);CCL;6;Sciences humaines et humanités;2011;2010-11;2010;2010;13;10;3;76;45;31;13;8;5;;;;;MvpY8
531;École doctorale Sciences, ingénierie et environnement;SIE;5;Biologie, médecine et santé;2011;2010-11;2010;2010;1;1;0;5;2;3;1;0;1;;;;;b5BYq
535;École doctorale Sciences de la société;SDS;6;Sciences humaines et humanités;2011;2010-11;2010;2010;10;4;6;25;11;14;2;0;2;;;;;iEUOV
536;École doctorale Sciences et agrosciences;;3;Sciences de la terre et de l'univers, espace;2011;2010-11;2010;2010;3;1;2;8;2;6;0;0;0;;;;;pHfqe
536;École doctorale Sciences et agrosciences;;5;Biologie, médecine et santé;2011;2010-11;2010;2010;3;1;2;8;3;5;0;0;0;;;;;pHfqe
539;École doctorale Sciences et technologies de Versailles;;1;Mathématiques et leurs interactions;2011;2010-11;2010;2010;3;1;2;7;1;6;6;0;6;;;;;nv3h8
543;École doctorale de Dauphine;;7;Sciences de la société;2011;2010-11;2010;2010;103;50;53;392;196;196;38;19;19;;;;;u8w6A
542;École doctorale de sciences de La Réunion;STS;0;;2011;2010-11;2010;2010;9;0;0;44;0;0;5;0;0;;;;;2pAql
19;École doctorale Littératures françaises et comparée;;6;Sciences humaines et humanités;2018;2017-18;2017;2017;55;39;16;273;181;92;41;15;26;;;;;13M43
22;École doctorale Mondes anciens et médiévaux;;6;Sciences humaines et humanités;2018;2017-18;2017;2017;39;21;18;183;99;84;44;26;18;;;;;fqCbl
31;École doctorale Pratiques et théories du sens;;7;Sciences de la société;2018;2017-18;2017;2017;4;3;1;22;12;10;4;1;3;;;;;1S466
41;École doctorale Droit;;6;Sciences humaines et humanités;2018;2017-18;2017;2017;50;25;25;329;154;175;37;10;27;;;;;KnOQK
42;École doctorale Entreprise, économie, société;EES;7;Sciences de la société;2018;2017-18;2017;2017;32;13;19;120;44;76;17;7;10;;;;;uO01d
47;École doctorale Physique;;3;Sciences de la terre et de l'univers, espace;2018;2017-18;2017;2017;3;1;2;6;1;5;3;0;3;;;;;8kNpd
47;École doctorale Physique;;8;Sciences pour l'ingénieur;2018;2017-18;2017;2017;3;1;2;10;2;8;4;0;4;;;;;8kNpd
47;École doctorale Physique;;9;Sciences et technologies de l'information et de la communication;2018;2017-18;2017;2017;0;0;0;1;1;0;0;0;0;;;;;8kNpd
60;École doctorale Territoires, temps, sociétés et développement;TTSD;6;Sciences humaines et humanités;2018;2017-18;2017;2017;42;22;20;191;111;80;32;16;16;;;;;fkIh6
62;École doctorale Sciences de la vie et de la santé;;2;Physique;2018;2017-18;2017;2017;2;1;1;2;1;1;0;0;0;;;;;vZzE7
62;École doctorale Sciences de la vie et de la santé;;3;Sciences de la terre et de l'univers, espace;2018;2017-18;2017;2017;1;1;0;1;1;0;0;0;0;;;;;vZzE7
62;École doctorale Sciences de la vie et de la santé;;6;Sciences humaines et humanités;2018;2017-18;2017;2017;1;0;1;2;1;1;0;0;0;;;;;vZzE7
71;École doctorale Sciences pour l'ingénieur;;9;Sciences et technologies de l'information et de la communication;2018;2017-18;2017;2017;17;5;12;63;19;44;16;5;11;;;;;H6UYp
73;École doctorale Sciences économiques, sociales, de l'aménagement et du management;SESAM;1;Mathématiques et leurs interactions;2018;2017-18;2017;2017;0;0;0;2;0;2;3;0;3;;;;;IQ0Hk
74;École doctorale Sciences juridiques, politique et de gestion;SJPG;7;Sciences de la société;2018;2017-18;2017;2017;59;28;31;264;137;127;31;13;18;;;;;3A2RY
77;École doctorale Informatique, automatique, électronique, électrotechnique, mathématiques;IAEM;8;Sciences pour l'ingénieur;2018;2017-18;2017;2017;10;2;8;30;4;26;8;1;7;;;;;TCHTA
78;École doctorale Sociétés, langages, temps, connaissances;STLC;6;Sciences humaines et humanités;2018;2017-18;2017;2017;61;35;26;210;135;75;33;21;12;;;;;vLU3i
101;École doctorale de Sciences juridiques;;7;Sciences de la société;2018;2017-18;2017;2017;41;17;24;232;111;121;35;20;15;;;;;569G2
104;École doctorale Sciences de la matière, du rayonnement et de l'environnement;SMRE;8;Sciences pour l'ingénieur;2018;2017-18;2017;2017;1;1;0;1;1;0;0;0;0;;;;;Q5iFz
122;École doctorale Europe latine - Amérique latine;;7;Sciences de la société;2018;2017-18;2017;2017;13;6;7;44;26;18;2;2;0;;;;;z9lZY
129;École doctorale Sciences de l'environnement d'Ile de France;SEIF;2;Physique;2018;2017-18;2017;2017;0;0;0;0;0;0;3;1;2;;;;;TnAPh
146;École doctorale Galilée;GALILEE;2;Physique;2018;2017-18;2017;2017;6;2;4;22;5;17;8;0;8;;;;;71hqm
146;École doctorale Galilée;GALILEE;5;Biologie, médecine et santé;2018;2017-18;2017;2017;13;8;5;54;32;22;9;7;2;;;;;71hqm
151;École doctorale Biologie, santé, biotechnologies;;5;Biologie, médecine et santé;2018;2017-18;2017;2017;84;53;31;384;227;157;85;46;39;;;;;yP8w4
158;École doctorale Cerveau, cognition, comportement;3C;1;Mathématiques et leurs interactions;2018;2017-18;2017;2017;0;0;0;1;0;1;0;0;0;;;;;Il62F
158;École doctorale Cerveau, cognition, comportement;3C;5;Biologie, médecine et santé;2018;2017-18;2017;2017;97;58;39;354;208;146;95;55;40;;;;;Il62F
166;École doctorale Information, structures et systèmes;I2S;2;Physique;2018;2017-18;2017;2017;19;6;13;68;21;47;16;7;9;;;;;2uO68
166;École doctorale Information, structures et systèmes;I2S;9;Sciences et technologies de l'information et de la communication;2018;2017-18;2017;2017;20;5;15;114;25;89;29;7;22;;;;;2uO68
178;École doctorale Sciences fondamentales;;3;Sciences de la terre et de l'univers, espace;2018;2017-18;2017;2017;8;3;5;34;15;19;9;5;4;;;;;1AiR7
180;École doctorale Sciences humaines et sociales : cultures, individus, sociétés;SHS;6;Sciences humaines et humanités;2018;2017-18;2017;2017;16;13;3;98;74;24;23;16;7;;;;;D2BT3
182;École doctorale Physique et chimie-physique;;9;Sciences et technologies de l'information et de la communication;2018;2017-18;2017;2017;0;0;0;3;1;2;0;0;0;;;;;3My6I
184;École doctorale Mathématiques et informatique de Marseille;;9;Sciences et technologies de l'information et de la communication;2018;2017-18;2017;2017;6;1;5;38;12;26;13;8;5;;;;;DDObG
209;École doctorale Sciences physiques et de L'ingénieur;SPI;3;Sciences de la terre et de l'univers, espace;2018;2017-18;2017;2017;6;1;5;10;2;8;1;1;0;;;;;tZcIZ
211;École doctorale Sciences exactes et leurs applications;ED SEA;8;Sciences pour l'ingénieur;2018;2017-18;2017;2017;19;6;13;65;20;45;14;2;12;;;;;1G1iC
216;École doctorale Ingénierie pour la santé, la cognition, l'environnement;EDISCE;3;Sciences de la terre et de l'univers, espace;2018;2017-18;2017;2017;1;0;1;1;0;1;1;0;1;;;;;fPs1t
216;École doctorale Ingénierie pour la santé, la cognition, l'environnement;EDISCE;5;Biologie, médecine et santé;2018;2017-18;2017;2017;30;18;12;123;52;71;28;11;17;;;;;fPs1t
216;École doctorale Ingénierie pour la santé, la cognition, l'environnement;EDISCE;6;Sciences humaines et humanités;2018;2017-18;2017;2017;9;5;4;49;31;18;6;5;1;;;;;fPs1t
216;École doctorale Ingénierie pour la santé, la cognition, l'environnement;EDISCE;7;Sciences de la société;2018;2017-18;2017;2017;2;2;0;5;5;0;3;2;1;;;;;fPs1t
216;École doctorale Ingénierie pour la santé, la cognition, l'environnement;EDISCE;10;Sciences agronomiques et écologiques;2018;2017-18;2017;2017;0;0;0;4;2;2;1;1;0;;;;;fPs1t
218;École doctorale Chimie et sciences du vivant;EDCSV;10;Sciences agronomiques et écologiques;2018;2017-18;2017;2017;5;3;2;16;5;11;2;2;0;;;;;8bcJh
220;École doctorale Électronique, électrotechnique, automatique, traitement du signal;EEATS;3;Sciences de la terre et de l'univers, espace;2018;2017-18;2017;2017;0;0;0;1;0;1;0;0;0;;;;;IxEaw
222;École doctorale Sciences chimiques;EDSC;5;Biologie, médecine et santé;2018;2017-18;2017;2017;4;2;2;9;3;6;1;1;0;;;;;AdU8Q
222;École doctorale Sciences chimiques;EDSC;8;Sciences pour l'ingénieur;2018;2017-18;2017;2017;0;0;0;2;2;0;0;0;0;;;;;AdU8Q
227;École doctorale Sciences de la nature et de l'homme;;8;Sciences pour l'ingénieur;2018;2017-18;2017;2017;3;3;0;3;3;0;0;0;0;;;;;xiDA5
240;École doctorale Sciences de l'homme et de la société;SHS;7;Sciences de la société;2018;2017-18;2017;2017;22;11;11;77;35;42;15;7;8;;;;;j345k
250;École doctorale Sciences chimiques;;4;Chimie;2018;2017-18;2017;2017;30;12;18;88;33;55;20;10;10;;;;;O0Fav
251;École doctorale Sciences de l'environnement;;8;Sciences pour l'ingénieur;2018;2017-18;2017;2017;4;2;2;18;8;10;4;3;1;;;;;VR28y
254;École doctorale Sciences de la matière;;3;Sciences de la terre et de l'univers, espace;2018;2017-18;2017;2017;0;0;0;0;0;0;9;3;6;;;;;365F2
262;École doctorale Sciences juridiques, politiques, économiques et de gestion;DEG;7;Sciences de la société;2018;2017-18;2017;2017;33;17;16;178;81;97;19;9;10;;;;;H7GyL
275;École doctorale Sciences de gestion;EDSG;7;Sciences de la société;2018;2017-18;2017;2017;10;2;8;70;42;28;13;7;6;;;;;6QC4I
286;École doctorale de l'Ehess;;6;Sciences humaines et humanités;2018;2017-18;2017;2017;94;39;55;545;265;280;59;26;33;;;;;2S146
304;École doctorale Sciences et environnements;;3;Sciences de la terre et de l'univers, espace;2018;2017-18;2017;2017;6;2;4;20;12;8;5;3;2;;;;;2ywZn
304;École doctorale Sciences et environnements;;6;Sciences humaines et humanités;2018;2017-18;2017;2017;4;3;1;11;7;4;7;3;4;;;;;2ywZn
305;École doctorale Énergie et environnement;E2;8;Sciences pour l'ingénieur;2018;2017-18;2017;2017;9;4;5;38;13;25;16;6;10;;;;;Kbt8I
309;École doctorale Systèmes;EDSYS;8;Sciences pour l'ingénieur;2018;2017-18;2017;2017;26;11;15;78;32;46;17;9;8;;;;;8TT4b
327;École doctorale Temps, espaces, sociétés, cultures;TESC;9;Sciences et technologies de l'information et de la communication;2018;2017-18;2017;2017;0;0;0;1;1;0;0;0;0;;;;;IjgiJ
328;École doctorale Arts, lettres, langues, philosophie et communication;ALLPH@;9;Sciences et technologies de l'information et de la communication;2018;2017-18;2017;2017;10;4;6;34;23;11;8;6;2;;;;;xLxMh
341;École doctorale Évolution, écosystèmes, microbiologie, modélisation;E2M2;3;Sciences de la terre et de l'univers, espace;2018;2017-18;2017;2017;3;1;2;7;3;4;2;1;1;;;;;J83I0
353;École doctorale Sciences pour l'ingénieur : mécanique, physique, micro et nanoélectronique;;8;Sciences pour l'ingénieur;2018;2017-18;2017;2017;49;12;37;131;27;104;37;5;32;;;;;vk5Kp
353;École doctorale Sciences pour l'ingénieur : mécanique, physique, micro et nanoélectronique;;9;Sciences et technologies de l'information et de la communication;2018;2017-18;2017;2017;0;0;0;33;2;31;3;0;3;;;;;vk5Kp
355;École doctorale Espaces, cultures, sociétés;;3;Sciences de la terre et de l'univers, espace;2018;2017-18;2017;2017;1;0;1;5;1;4;0;0;0;;;;;2kMf5
359;École doctorale Mathématiques, télécommunications, informatique, signal, systèmes, électronique;MATISSE;1;Mathématiques et leurs interactions;2018;2017-18;2017;2017;0;0;0;0;0;0;7;1;6;;;;;Y0r76
364;École doctorale Sciences fondamentales et appliquées;EDSFA;1;Mathématiques et leurs interactions;2018;2017-18;2017;2017;25;2;23;68;18;50;12;5;7;;;;;E483q
364;École doctorale Sciences fondamentales et appliquées;EDSFA;3;Sciences de la terre et de l'univers, espace;2018;2017-18;2017;2017;17;1;16;54;12;42;19;3;16;;;;;E483q
364;École doctorale Sciences fondamentales et appliquées;EDSFA;10;Sciences agronomiques et écologiques;2018;2017-18;2017;2017;1;0;1;8;4;4;6;4;2;;;;;E483q
370;École doctorale Lettres, sciences humaines et sociales;LSHS;6;Sciences humaines et humanités;2018;2017-18;2017;2017;39;21;18;207;111;96;29;16;13;;;;;xAXXx
377;École doctorale Environnement et société;;1;Mathématiques et leurs interactions;2018;2017-18;2017;2017;0;0;0;2;1;1;1;1;0;;;;;ZMG5u
377;École doctorale Environnement et société;;3;Sciences de la terre et de l'univers, espace;2018;2017-18;2017;2017;2;2;0;3;2;1;0;0;0;;;;;ZMG5u
377;École doctorale Environnement et société;;9;Sciences et technologies de l'information et de la communication;2018;2017-18;2017;2017;1;0;1;9;1;8;1;0;1;;;;;ZMG5u
378;École doctorale Sciences de l'homme et de la société;SHS;6;Sciences humaines et humanités;2018;2017-18;2017;2017;14;6;8;72;36;36;6;4;2;;;;;3XKuF
378;École doctorale Sciences de l'homme et de la société;SHS;7;Sciences de la société;2018;2017-18;2017;2017;21;10;11;83;33;50;13;4;9;;;;;3XKuF
382;École doctorale Économie, espaces, sociétés, civilisations : pensée critique, politique et pratique sociale;EESC;7;Sciences de la société;2018;2017-18;2017;2017;22;15;7;137;72;65;16;11;5;;;;;9NI1W
386;École doctorale Sciences mathématiques de Paris centre;SMPC;1;Mathématiques et leurs interactions;2018;2017-18;2017;2017;120;22;98;479;84;395;106;19;87;;;;;wMj98
401;École doctorale Sciences sociales;;9;Sciences et technologies de l'information et de la communication;2018;2017-18;2017;2017;4;0;4;29;8;21;6;2;4;;;;;raQ7K
405;École doctorale Économie, management,mathématiques et physique de Cergy;EM2C;7;Sciences de la société;2018;2017-18;2017;2017;23;9;14;88;36;52;13;6;7;;;;;QbwSB
406;École doctorale Chimie moléculaire de Paris centre;;4;Chimie;2018;2017-18;2017;2017;40;18;22;120;48;72;36;15;21;;;;;a5dKy
409;École doctorale Énergie, mécanique, matériaux;EMMA;2;Physique;2018;2017-18;2017;2017;21;5;16;36;10;26;4;2;2;;;;;KXlbK
410;École doctorale Sciences et ingénierie des ressources, procédés, produits, environnement;RP2E;8;Sciences pour l'ingénieur;2018;2017-18;2017;2017;28;10;18;130;50;80;36;15;21;;;;;Q5fxV
414;École doctorale Sciences de la vie et de la santé;;2;Physique;2018;2017-18;2017;2017;0;0;0;0;0;0;1;0;1;;;;;YI4xS
441;École doctorale Histoire de l'art;;6;Sciences humaines et humanités;2018;2017-18;2017;2017;28;21;7;189;136;53;25;14;11;;;;;d5W3U
446;École doctorale Biologie - Santé;EDBSL;2;Physique;2018;2017-18;2017;2017;0;0;0;0;0;0;2;1;1;;;;;4iEUF
450;École doctorale Recherches en psychanalyse et psychopathologie;PSY²;6;Sciences humaines et humanités;2018;2017-18;2017;2017;53;35;18;212;132;80;28;22;6;;;;;8jI3f
455;École doctorale Économie, Gestion, Information et Communication;EGIC;7;Sciences de la société;2018;2017-18;2017;2017;36;22;14;141;75;66;18;11;7;;;;;qCOg3
463;École doctorale Sciences du mouvement humain;SMH;5;Biologie, médecine et santé;2018;2017-18;2017;2017;10;4;6;60;28;32;13;4;9;;;;;UbtlY
467;École doctorale Aéronautique, astronautique;AA;2;Physique;2018;2017-18;2017;2017;0;0;0;5;2;3;2;0;2;;;;;U7l45
467;École doctorale Aéronautique, astronautique;AA;6;Sciences humaines et humanités;2018;2017-18;2017;2017;2;2;0;11;3;8;1;0;1;;;;;U7l45
467;École doctorale Aéronautique, astronautique;AA;8;Sciences pour l'ingénieur;2018;2017-18;2017;2017;8;1;7;19;2;17;6;1;5;;;;;U7l45
467;École doctorale Aéronautique, astronautique;AA;10;Sciences agronomiques et écologiques;2018;2017-18;2017;2017;0;0;0;1;0;1;0;0;0;;;;;U7l45
469;École doctorale du Pacifique;EDP;2;Physique;2018;2017-18;2017;2017;0;0;0;1;0;1;0;0;0;;;;;t9Z2n
469;École doctorale du Pacifique;EDP;5;Biologie, médecine et santé;2018;2017-18;2017;2017;12;7;5;40;20;20;12;7;5;;;;;t9Z2n
469;École doctorale du Pacifique;EDP;8;Sciences pour l'ingénieur;2018;2017-18;2017;2017;2;0;2;2;0;2;0;0;0;;;;;t9Z2n
469;École doctorale du Pacifique;EDP;10;Sciences agronomiques et écologiques;2018;2017-18;2017;2017;1;0;1;1;0;1;0;0;0;;;;;t9Z2n
472;École doctorale de l'EPHE;;6;Sciences humaines et humanités;2018;2017-18;2017;2017;89;44;45;487;258;229;53;29;24;;;;;27zK4
474;École doctorale Interdisciplinaire européenne frontières du vivant;FDV;2;Physique;2018;2017-18;2017;2017;5;4;1;21;10;11;5;1;4;;;;;E727j
474;École doctorale Interdisciplinaire européenne frontières du vivant;FDV;10;Sciences agronomiques et écologiques;2018;2017-18;2017;2017;1;0;1;6;2;4;0;0;0;;;;;E727j
475;École doctorale Mathématiques, informatique, télécommunications de Toulouse;MITT;9;Sciences et technologies de l'information et de la communication;2018;2017-18;2017;2017;76;22;54;306;82;224;90;30;60;;;;;xcp2r
476;École doctorale Neurosciences et cognition;NSCO;5;Biologie, médecine et santé;2018;2017-18;2017;2017;28;15;13;114;63;51;25;16;9;;;;;B1H0x
478;École doctorale Sciences de Gestion;;7;Sciences de la société;2018;2017-18;2017;2017;14;10;4;59;39;20;7;3;4;;;;;q34kB
480;École doctorale Montaigne-humanités;;6;Sciences humaines et humanités;2018;2017-18;2017;2017;125;72;53;592;369;223;58;41;17;;;;;f3SeZ
482;École doctorale Sciences de la matière;SDM;2;Physique;2018;2017-18;2017;2017;27;12;15;89;28;61;25;10;15;;;;;kmeZ4
482;École doctorale Sciences de la matière;SDM;8;Sciences pour l'ingénieur;2018;2017-18;2017;2017;13;0;13;58;18;40;13;5;8;;;;;kmeZ4
484;École doctorale Lettres, langues, linguistique, arts;3LA;6;Sciences humaines et humanités;2018;2017-18;2017;2017;95;68;27;500;320;180;63;35;28;;;;;BlCQD
485;École doctorale Éducation, Psychologie, Information et Communication;EPIC;6;Sciences humaines et humanités;2018;2017-18;2017;2017;55;34;21;239;157;82;46;29;17;;;;;O82eL
485;École doctorale Éducation, Psychologie, Information et Communication;EPIC;9;Sciences et technologies de l'information et de la communication;2018;2017-18;2017;2017;1;0;1;7;2;5;0;0;0;;;;;O82eL
486;École doctorale Sciences économiques et de gestion;SEG;7;Sciences de la société;2018;2017-18;2017;2017;43;18;25;188;80;108;32;16;16;;;;;h1GZ3
488;École doctorale Sciences, ingénierie, santé;SIS;5;Biologie, médecine et santé;2018;2017-18;2017;2017;23;9;14;75;31;44;15;6;9;;;;;Fy2lK
489;École doctorale Sciences et ingénierie des systèmes, de l'environnement et des organisations;SISEO;8;Sciences pour l'ingénieur;2018;2017-18;2017;2017;17;5;12;63;16;47;12;5;7;;;;;6pT77
495;École doctorale Végétal, environnement, nutrition, agroalimentaire, mer;VENAM;10;Sciences agronomiques et écologiques;2018;2017-18;2017;2017;0;0;0;0;0;0;13;6;7;;;;;HL495
497;École doctorale Normande de Biologie Intégrative, Santé, Environnement;Ed NBISE;3;Sciences de la terre et de l'univers, espace;2018;2017-18;2017;2017;4;1;3;18;7;11;2;1;1;;;;;0D9Je
497;École doctorale Normande de Biologie Intégrative, Santé, Environnement;Ed NBISE;6;Sciences humaines et humanités;2018;2017-18;2017;2017;0;0;0;0;0;0;2;1;1;;;;;0D9Je
500;École doctorale Matière, molécules, matériaux en Pays de Loire;3MPL;2;Physique;2018;2017-18;2017;2017;0;0;0;0;0;0;12;6;6;;;;;822tM
503;École doctorale Sciences et technologies de l'information et de mathématiques;STIM;1;Mathématiques et leurs interactions;2018;2017-18;2017;2017;0;0;0;0;0;0;5;1;4;;;;;JQevP
503;École doctorale Sciences et technologies de l'information et de mathématiques;STIM;9;Sciences et technologies de l'information et de la communication;2018;2017-18;2017;2017;0;0;0;0;0;0;25;3;22;;;;;JQevP
508;École doctorale Normande de chimie;EDNC;4;Chimie;2018;2017-18;2017;2017;42;17;25;156;74;82;39;17;22;;;;;E52OO
515;École doctorale Complexité du vivant;CdV;5;Biologie, médecine et santé;2018;2017-18;2017;2017;86;55;31;297;179;118;83;44;39;;;;;CbV9s
520;École doctorale Humanités;;7;Sciences de la société;2018;2017-18;2017;2017;0;0;0;1;0;1;1;0;1;;;;;rI175
522;École doctorale Sciences et ingénierie en matériaux, mécanique, énergétique et aéronautique;SI-MMEA;4;Chimie;2018;2017-18;2017;2017;12;6;6;46;17;29;14;9;5;;;;;82F19
523;École doctorale Sciences pour l'environnement - Gay Lussac;;10;Sciences agronomiques et écologiques;2018;2017-18;2017;2017;17;9;8;59;27;32;14;8;6;;;;;6xD69
529;École doctorale Cultures et sociétés;CS;6;Sciences humaines et humanités;2018;2017-18;2017;2017;32;16;16;207;110;97;33;17;16;;;;;XU9tb
530;École doctorale Organisations, marchés, institutions;OMI;8;Sciences pour l'ingénieur;2018;2017-18;2017;2017;0;0;0;0;0;0;1;1;0;;;;;4htv7
531;École doctorale Sciences, ingénierie et environnement;SIE;3;Sciences de la terre et de l'univers, espace;2018;2017-18;2017;2017;7;4;3;29;16;13;10;4;6;;;;;b5BYq
536;École doctorale Sciences et agrosciences;;3;Sciences de la terre et de l'univers, espace;2018;2017-18;2017;2017;4;1;3;17;7;10;3;3;0;;;;;pHfqe
540;"École doctorale École transdisciplinaire ""lettres/sciences""";;2;Physique;2018;2017-18;2017;2017;0;0;0;1;0;1;1;1;0;;;;;tWWw7
540;"École doctorale École transdisciplinaire ""lettres/sciences""";;7;Sciences de la société;2018;2017-18;2017;2017;2;0;2;6;3;3;1;1;0;;;;;tWWw7
541;École doctorale de sciences humaines et sociales de La Réunion;SHS;6;Sciences humaines et humanités;2018;2017-18;2017;2017;31;15;16;144;77;67;20;11;9;;;;;21SpE
542;École doctorale de sciences de La Réunion;STS;1;Mathématiques et leurs interactions;2018;2017-18;2017;2017;2;1;1;29;12;17;5;1;4;;;;;2pAql
542;École doctorale de sciences de La Réunion;STS;4;Chimie;2018;2017-18;2017;2017;2;0;2;8;6;2;4;1;3;;;;;2pAql
542;École doctorale de sciences de La Réunion;STS;5;Biologie, médecine et santé;2018;2017-18;2017;2017;19;8;11;34;14;20;6;4;2;;;;;2pAql
542;École doctorale de sciences de La Réunion;STS;9;Sciences et technologies de l'information et de la communication;2018;2017-18;2017;2017;0;0;0;0;0;0;1;1;0;;;;;2pAql
542;École doctorale de sciences de La Réunion;STS;10;Sciences agronomiques et écologiques;2018;2017-18;2017;2017;4;1;3;7;1;6;6;5;1;;;;;2pAql
543;École doctorale de Dauphine;;7;Sciences de la société;2018;2017-18;2017;2017;39;18;21;220;102;118;64;33;31;;;;;u8w6A
547;École doctorale Sciences, Technologie, Santé;EDSTS;4;Chimie;2018;2017-18;2017;2017;9;5;4;27;10;17;6;3;3;;;;;wEdn2
547;École doctorale Sciences, Technologie, Santé;EDSTS;9;Sciences et technologies de l'information et de la communication;2018;2017-18;2017;2017;7;1;6;51;7;44;8;1;7;;;;;wEdn2
547;École doctorale Sciences, Technologie, Santé;EDSTS;10;Sciences agronomiques et écologiques;2018;2017-18;2017;2017;8;5;3;35;14;21;6;3;3;;;;;wEdn2
548;École doctorale Mer et Sciences;;3;Sciences de la terre et de l'univers, espace;2018;2017-18;2017;2017;2;0;2;6;3;3;2;2;0;;;;;QX0fS
549;École doctorale Santé, Sciences Biologiques et Chimie du Vivant;SSBCV;2;Physique;2018;2017-18;2017;2017;1;1;0;3;2;1;1;0;1;;;;;B9ggO
549;École doctorale Santé, Sciences Biologiques et Chimie du Vivant;SSBCV;5;Biologie, médecine et santé;2018;2017-18;2017;2017;64;43;21;209;130;79;44;28;16;;;;;B9ggO
552;École doctorale Énergie - Matériaux - Sciences de la Terre et de l'Univers;EMTSU;8;Sciences pour l'ingénieur;2018;2017-18;2017;2017;14;4;10;99;22;77;19;2;17;;;;;NTZhw
554;École doctorale Environnements - Santé;E-S;3;Sciences de la terre et de l'univers, espace;2018;2017-18;2017;2017;3;2;1;19;6;13;5;1;4;;;;;ElyFU
554;École doctorale Environnements - Santé;E-S;9;Sciences et technologies de l'information et de la communication;2018;2017-18;2017;2017;0;0;0;1;0;1;1;0;1;;;;;ElyFU
573;École doctorale Interfaces : Approches Interdisciplinaires, Fondements, Applications et Innovation;ED INTERFACES;4;Chimie;2018;2017-18;2017;2017;7;1;6;39;17;22;14;7;7;;;;;gG820
576;École doctorale Particules, Hadrons, Énergie, Noyau, Instrumentation, Imagerie, Cosmos et Simulation;PHENIICS;1;Mathématiques et leurs interactions;2018;2017-18;2017;2017;0;0;0;2;0;2;0;0;0;;;;;qC4rf
576;École doctorale Particules, Hadrons, Énergie, Noyau, Instrumentation, Imagerie, Cosmos et Simulation;PHENIICS;4;Chimie;2018;2017-18;2017;2017;1;0;1;7;2;5;2;2;0;;;;;qC4rf
576;École doctorale Particules, Hadrons, Énergie, Noyau, Instrumentation, Imagerie, Cosmos et Simulation;PHENIICS;8;Sciences pour l'ingénieur;2018;2017-18;2017;2017;0;0;0;5;3;2;0;0;0;;;;;qC4rf
577;École doctorale Structure et dynamique des systèmes vivants;SDSV;1;Mathématiques et leurs interactions;2018;2017-18;2017;2017;2;1;1;4;2;2;1;1;0;;;;;4bsxJ
577;École doctorale Structure et dynamique des systèmes vivants;SDSV;2;Physique;2018;2017-18;2017;2017;0;0;0;1;0;1;0;0;0;;;;;4bsxJ
577;École doctorale Structure et dynamique des systèmes vivants;SDSV;5;Biologie, médecine et santé;2018;2017-18;2017;2017;47;25;22;228;132;96;54;29;25;;;;;4bsxJ
577;École doctorale Structure et dynamique des systèmes vivants;SDSV;10;Sciences agronomiques et écologiques;2018;2017-18;2017;2017;0;0;0;2;2;0;2;2;0;;;;;4bsxJ
578;École doctorale Sciences de l'Homme et de la Société;ED SHS;7;Sciences de la société;2018;2017-18;2017;2017;90;38;52;556;252;304;70;33;37;;;;;Ud43O
579;École doctorale Sciences mécaniques et energétiques, matériaux et géosciences;SMEMaG;4;Chimie;2018;2017-18;2017;2017;3;1;2;9;2;7;3;2;1;;;;;atMj7
580;École doctorale Sciences et technologies de l'information et de la communication;STIC;8;Sciences pour l'ingénieur;2018;2017-18;2017;2017;4;1;3;14;5;9;5;1;4;;;;;AzCC0
581;École doctorale Agriculture, alimentation, biologie, environnement, santé;ABIES;1;Mathématiques et leurs interactions;2018;2017-18;2017;2017;1;0;1;5;0;5;2;2;0;;;;;c1x56
581;École doctorale Agriculture, alimentation, biologie, environnement, santé;ABIES;5;Biologie, médecine et santé;2018;2017-18;2017;2017;19;14;5;86;57;29;22;19;3;;;;;c1x56
581;École doctorale Agriculture, alimentation, biologie, environnement, santé;ABIES;9;Sciences et technologies de l'information et de la communication;2018;2017-18;2017;2017;2;2;0;4;3;1;0;0;0;;;;;c1x56
583;École doctorale Risques et Société;;6;Sciences humaines et humanités;2018;2017-18;2017;2017;3;3;0;8;4;4;2;2;0;;;;;wUBi9
583;École doctorale Risques et Société;;8;Sciences pour l'ingénieur;2018;2017-18;2017;2017;0;0;0;2;1;1;0;0;0;;;;;wUBi9
585;École doctorale Sciences, Technologie,  Sante;EDSTS;5;Biologie, médecine et santé;2018;2017-18;2017;2017;26;12;14;85;38;47;19;11;8;;;;;NM3Dl
585;École doctorale Sciences, Technologie,  Sante;EDSTS;9;Sciences et technologies de l'information et de la communication;2018;2017-18;2017;2017;7;1;6;22;4;18;6;3;3;;;;;NM3Dl
586;École doctorale Sciences Humaines et Sociales;EDSHS;7;Sciences de la société;2018;2017-18;2017;2017;18;12;6;85;42;43;3;1;2;;;;;0RKVX
589;École doctorale Milieu insulaire tropical à risques : protection, valorisation , santé et développement;;1;Mathématiques et leurs interactions;2018;2017-18;2017;2017;1;0;1;11;6;5;2;2;0;;;;;2cqi3
589;École doctorale Milieu insulaire tropical à risques : protection, valorisation , santé et développement;;2;Physique;2018;2017-18;2017;2017;0;0;0;11;1;10;1;0;1;;;;;2cqi3
589;École doctorale Milieu insulaire tropical à risques : protection, valorisation , santé et développement;;5;Biologie, médecine et santé;2018;2017-18;2017;2017;11;5;6;40;23;17;10;6;4;;;;;2cqi3
589;École doctorale Milieu insulaire tropical à risques : protection, valorisation , santé et développement;;10;Sciences agronomiques et écologiques;2018;2017-18;2017;2017;0;0;0;4;2;2;2;1;1;;;;;2cqi3
590;École doctorale Mathematiques, Information, Ingenierie des Systemes;MIIS;1;Mathématiques et leurs interactions;2018;2017-18;2017;2017;18;8;10;59;23;36;11;4;7;;;;;L20t5
590;École doctorale Mathematiques, Information, Ingenierie des Systemes;MIIS;8;Sciences pour l'ingénieur;2018;2017-18;2017;2017;0;0;0;2;1;1;0;0;0;;;;;L20t5
590;École doctorale Mathematiques, Information, Ingenierie des Systemes;MIIS;9;Sciences et technologies de l'information et de la communication;2018;2017-18;2017;2017;39;9;30;132;32;100;38;11;27;;;;;L20t5
591;École doctorale Physique, Sciences de l'Ingenieur, Materiaux, Énergie;PSIME;4;Chimie;2018;2017-18;2017;2017;8;4;4;28;12;16;8;1;7;;;;;Hn5Om
591;École doctorale Physique, Sciences de l'Ingenieur, Materiaux, Énergie;PSIME;8;Sciences pour l'ingénieur;2018;2017-18;2017;2017;46;14;32;169;47;122;36;5;31;;;;;Hn5Om
592;École doctorale Lettres, Communication, Langues, Arts;LECLA;9;Sciences et technologies de l'information et de la communication;2018;2017-18;2017;2017;0;0;0;2;0;2;1;0;1;;;;;sY7f3
593;École doctorale Droit, Gestion, sciences Économiques et Politique;DGEP;7;Sciences de la société;2018;2017-18;2017;2017;52;17;35;242;103;139;22;13;9;;;;;41pAm
594;École doctorale Sociétés, Espaces, Pratiques, Temps;ED SEPT;6;Sciences humaines et humanités;2018;2017-18;2017;2017;64;35;29;341;170;171;37;13;24;;;;;N85H3
596;École doctorale Matière, Molécules et Matériaux;ED 3M;2;Physique;2018;2017-18;2017;2017;38;17;21;156;51;105;30;9;21;;;;;77947
596;École doctorale Matière, Molécules et Matériaux;ED 3M;9;Sciences et technologies de l'information et de la communication;2018;2017-18;2017;2017;5;2;3;13;4;9;1;0;1;;;;;77947
598;École doctorale Sciences de La Mer et du Littoral;SML;3;Sciences de la terre et de l'univers, espace;2018;2017-18;2017;2017;19;9;10;70;31;39;15;5;10;;;;;Smen6
598;École doctorale Sciences de La Mer et du Littoral;SML;7;Sciences de la société;2018;2017-18;2017;2017;6;3;3;19;10;9;1;0;1;;;;;Smen6
600;École doctorale Écologie, Géosciences, Agronomie et Alimentation;EGAAL;3;Sciences de la terre et de l'univers, espace;2018;2017-18;2017;2017;20;9;11;55;27;28;10;2;8;;;;;urS33
600;École doctorale Écologie, Géosciences, Agronomie et Alimentation;EGAAL;4;Chimie;2018;2017-18;2017;2017;0;0;0;0;0;0;2;1;1;;;;;urS33
600;École doctorale Écologie, Géosciences, Agronomie et Alimentation;EGAAL;5;Biologie, médecine et santé;2018;2017-18;2017;2017;2;1;1;17;9;8;16;6;10;;;;;urS33
601;École doctorale Mathématiques et Sciences et Technologies de l'information et de la Communication;MathSTIC;6;Sciences humaines et humanités;2018;2017-18;2017;2017;0;0;0;0;0;0;1;0;1;;;;;3Ue20
603;École doctorale Éducation, Langages, Interactions, Cognition, Clinique, Expertise - ED 603;ELICCE;9;Sciences et technologies de l'information et de la communication;2018;2017-18;2017;2017;1;0;1;3;1;2;1;1;0;;;;;1Mzw7
604;École doctorale Sociétés, Temps, Territoires;STT;6;Sciences humaines et humanités;2018;2017-18;2017;2017;77;40;37;417;208;209;44;19;25;;;;;SZI5T
7;École doctorale Georges Vedel - Droit public interne, science administrative et science politique;;7;Sciences de la société;2022;2021-22;2021;2021;20;12;8;150;60;90;16;6;10;0;1;6;9;Dw881
20;École doctorale Civilisations, cultures, littératures et sociétés;;6;Sciences humaines et humanités;2022;2021-22;2021;2021;18;14;4;178;134;44;21;19;2;0;7;7;7;agjNi
34;École doctorale Matériaux;;4;Chimie;2022;2021-22;2021;2021;8;3;5;27;15;12;4;3;1;1;3;0;0;1Iufh
34;École doctorale Matériaux;;8;Sciences pour l'ingénieur;2022;2021-22;2021;2021;26;9;17;116;44;72;31;13;18;8;18;5;0;1Iufh
41;École doctorale Droit;;7;Sciences de la société;2022;2021-22;2021;2021;48;25;23;320;152;168;23;12;11;1;1;7;14;KnOQK
50;École doctorale Langues, littératures et sciences humaines;LLSH;6;Sciences humaines et humanités;2022;2021-22;2021;2021;20;15;5;171;131;40;16;9;7;2;5;2;7;8THzQ
52;École doctorale Physique et astrophysique de Lyon;PHAST;3;Sciences de la terre et de l'univers, espace;2022;2021-22;2021;2021;4;2;2;21;9;12;8;2;6;4;3;1;0;61XPb
60;École doctorale Territoires, temps, sociétés et développement;TTSD;10;Sciences agronomiques et écologiques;2022;2021-22;2021;2021;2;0;2;4;2;2;1;0;1;0;0;1;0;fkIh6
65;École doctorale Sciences de la Vie, Santé, Agronomie, Environnement;;5;Biologie, médecine et santé;2022;2021-22;2021;2021;60;41;19;233;145;88;41;28;13;20;16;5;0;MAOG4
67;École doctorale Sciences juridiques et politiques;;7;Sciences de la société;2022;2021-22;2021;2021;74;42;32;421;213;208;46;20;26;4;7;12;23;qrOj1
70;École doctorale Sciences pour l'ingénieur;EDSPI;8;Sciences pour l'ingénieur;2022;2021-22;2021;2021;29;5;24;125;35;90;42;13;29;18;22;2;0;G413P
71;École doctorale Sciences pour l'ingénieur;;1;Mathématiques et leurs interactions;2022;2021-22;2021;2021;1;1;0;7;5;2;4;2;2;3;1;0;0;H6UYp
71;École doctorale Sciences pour l'ingénieur;;7;Sciences de la société;2022;2021-22;2021;2021;2;1;1;3;1;2;2;2;0;0;0;1;1;H6UYp
72;École doctorale Sciences pour l'ingénieur;SPI;1;Mathématiques et leurs interactions;2022;2021-22;2021;2021;0;0;0;0;0;0;6;3;3;2;4;0;0;47QPx
73;École doctorale Sciences économiques, sociales, de l'aménagement et du management;SESAM;1;Mathématiques et leurs interactions;2022;2021-22;2021;2021;0;0;0;0;0;0;1;1;0;1;0;0;0;IQ0Hk
73;École doctorale Sciences économiques, sociales, de l'aménagement et du management;SESAM;7;Sciences de la société;2022;2021-22;2021;2021;31;18;13;151;69;82;20;7;13;4;5;8;3;IQ0Hk
77;École doctorale Informatique, automatique, électronique, électrotechnique, mathématiques;IAEM;1;Mathématiques et leurs interactions;2022;2021-22;2021;2021;11;3;8;46;6;40;13;4;9;4;7;1;1;TCHTA
86;École doctorale Sociétés, humanités, arts, lettres;LSHS;6;Sciences humaines et humanités;2022;2021-22;2021;2021;59;36;23;243;149;94;27;13;14;6;5;10;6;O8E6y
98;École doctorale Droit-Normandie;EDDN;7;Sciences de la société;2022;2021-22;2021;2021;18;7;11;113;43;70;11;7;4;0;1;2;8;9fYyW
104;École doctorale Sciences de la matière, du rayonnement et de l'environnement;SMRE;8;Sciences pour l'ingénieur;2022;2021-22;2021;2021;9;3;6;22;6;16;1;0;1;1;0;0;0;Q5iFz
129;École doctorale Sciences de l'environnement d'Ile de France;SEIF;2;Physique;2022;2021-22;2021;2021;0;0;0;4;2;2;1;1;0;1;0;0;0;TnAPh
129;École doctorale Sciences de l'environnement d'Ile de France;SEIF;3;Sciences de la terre et de l'univers, espace;2022;2021-22;2021;2021;61;34;27;259;158;101;40;21;19;21;15;4;0;TnAPh
146;École doctorale Galilée;GALILEE;4;Chimie;2022;2021-22;2021;2021;2;2;0;6;6;0;4;2;2;3;1;0;0;71hqm
146;École doctorale Galilée;GALILEE;8;Sciences pour l'ingénieur;2022;2021-22;2021;2021;5;1;4;19;5;14;7;2;5;1;5;1;0;71hqm
162;École doctorale Mécanique, énergétique, génie civil, acoustique;MEGA;5;Biologie, médecine et santé;2022;2021-22;2021;2021;7;3;4;44;17;27;9;4;5;7;2;0;0;7wCke
166;École doctorale Information, structures et systèmes;I2S;1;Mathématiques et leurs interactions;2022;2021-22;2021;2021;15;3;12;63;19;44;26;6;20;14;9;3;0;2uO68
173;École doctorale Sciences de l'univers, de l'environnement et de l'espace;SDU2E;8;Sciences pour l'ingénieur;2022;2021-22;2021;2021;2;1;1;7;1;6;3;0;3;1;1;1;0;R0Z9c
178;École doctorale Sciences fondamentales;;2;Physique;2022;2021-22;2021;2021;11;0;11;33;11;22;4;0;4;3;1;0;0;1AiR7
182;École doctorale Physique et chimie-physique;;2;Physique;2022;2021-22;2021;2021;42;13;29;175;59;116;36;11;25;24;10;2;0;3My6I
182;École doctorale Physique et chimie-physique;;5;Biologie, médecine et santé;2022;2021-22;2021;2021;1;1;0;2;1;1;2;1;1;2;0;0;0;3My6I
205;École doctorale Interdisciplinaire Sciences-Santé;EDISS;5;Biologie, médecine et santé;2022;2021-22;2021;2021;39;21;18;227;142;85;51;29;22;30;18;2;1;69W38
206;École doctorale Chimie : chimie, procédés, environnement;;5;Biologie, médecine et santé;2022;2021-22;2021;2021;0;0;0;1;0;1;0;0;0;0;0;0;0;m0UhD
209;École doctorale Sciences physiques et de L'ingénieur;SPI;2;Physique;2022;2021-22;2021;2021;24;4;20;113;24;89;27;4;23;12;11;3;1;tZcIZ
211;École doctorale Sciences exactes et leurs applications;ED SEA;1;Mathématiques et leurs interactions;2022;2021-22;2021;2021;11;3;8;36;13;23;7;1;6;6;1;0;0;1G1iC
216;École doctorale Ingénierie pour la santé, la cognition, l'environnement;EDISCE;8;Sciences pour l'ingénieur;2022;2021-22;2021;2021;6;3;3;21;11;10;2;1;1;1;1;0;0;fPs1t
217;École doctorale Mathématiques, sciences et technologies de l'information, informatique;MSTII;9;Sciences et technologies de l'information et de la communication;2022;2021-22;2021;2021;67;10;57;179;44;135;30;10;20;9;16;5;0;Ehx7v
217;École doctorale Mathématiques, sciences et technologies de l'information, informatique;MSTII;10;Sciences agronomiques et écologiques;2022;2021-22;2021;2021;0;0;0;2;0;2;0;0;0;0;0;0;0;Ehx7v
220;École doctorale Électronique, électrotechnique, automatique, traitement du signal;EEATS;2;Physique;2022;2021-22;2021;2021;10;3;7;42;11;31;11;4;7;4;6;1;0;IxEaw
220;École doctorale Électronique, électrotechnique, automatique, traitement du signal;EEATS;9;Sciences et technologies de l'information et de la communication;2022;2021-22;2021;2021;34;6;28;147;34;113;28;4;24;17;8;3;0;IxEaw
221;École doctorale Augustin Cournot - Sciences économiques et de gestion - Sciences, technologies et sociétés;EDAC;6;Sciences humaines et humanités;2022;2021-22;2021;2021;1;1;0;5;2;3;0;0;0;0;0;0;0;5z9rW
221;École doctorale Augustin Cournot - Sciences économiques et de gestion - Sciences, technologies et sociétés;EDAC;7;Sciences de la société;2022;2021-22;2021;2021;17;8;9;76;37;39;19;10;9;4;10;4;1;5z9rW
222;École doctorale Sciences chimiques;EDSC;5;Biologie, médecine et santé;2022;2021-22;2021;2021;0;0;0;1;0;1;2;0;2;1;1;0;0;AdU8Q
224;École doctorale Cognition, langage, interaction;;6;Sciences humaines et humanités;2022;2021-22;2021;2021;38;22;16;149;91;58;23;16;7;6;5;4;8;7v43e
227;École doctorale Sciences de la nature et de l'homme;;3;Sciences de la terre et de l'univers, espace;2022;2021-22;2021;2021;6;3;3;23;11;12;2;1;1;1;1;0;0;xiDA5
227;École doctorale Sciences de la nature et de l'homme;;6;Sciences humaines et humanités;2022;2021-22;2021;2021;8;3;5;32;21;11;13;9;4;7;6;0;0;xiDA5
227;École doctorale Sciences de la nature et de l'homme;;10;Sciences agronomiques et écologiques;2022;2021-22;2021;2021;14;9;5;49;25;24;5;2;3;3;2;0;0;xiDA5
231;École doctorale Économie et gestion;EDEG;7;Sciences de la société;2022;2021-22;2021;2021;47;24;23;158;83;75;35;18;17;6;12;13;4;KT720
234;École doctorale de Sciences Po;;7;Sciences de la société;2022;2021-22;2021;2021;50;26;24;281;142;139;44;26;18;3;12;23;6;ux756
269;École doctorale Mathématiques, sciences de l'information et de l'ingénieur;MSII;2;Physique;2022;2021-22;2021;2021;2;0;2;8;2;6;0;0;0;0;0;0;0;5E625
269;École doctorale Mathématiques, sciences de l'information et de l'ingénieur;MSII;7;Sciences de la société;2022;2021-22;2021;2021;0;0;0;2;2;0;0;0;0;0;0;0;0;5E625
280;École doctorale Philosophie;;6;Sciences humaines et humanités;2022;2021-22;2021;2021;36;14;22;240;100;140;24;7;17;2;6;6;10;kJxnm
284;École doctorale Droit et Science Politique;DSP;6;Sciences humaines et humanités;2022;2021-22;2021;2021;10;6;4;44;26;18;2;2;0;0;0;0;2;ahH92
286;École doctorale de l'Ehess;;6;Sciences humaines et humanités;2022;2021-22;2021;2021;57;32;25;437;234;203;51;25;26;3;13;13;22;2S146
286;École doctorale de l'Ehess;;7;Sciences de la société;2022;2021-22;2021;2021;150;86;64;879;485;394;114;61;53;9;13;36;56;2S146
304;École doctorale Sciences et environnements;;10;Sciences agronomiques et écologiques;2022;2021-22;2021;2021;16;8;8;56;27;29;10;4;6;4;6;0;0;2ywZn
305;École doctorale Énergie et environnement;E2;3;Sciences de la terre et de l'univers, espace;2022;2021-22;2021;2021;2;0;2;9;2;7;5;4;1;2;2;1;0;Kbt8I
305;École doctorale Énergie et environnement;E2;9;Sciences et technologies de l'information et de la communication;2022;2021-22;2021;2021;3;2;1;8;5;3;1;1;0;1;0;0;0;Kbt8I
323;École doctorale Génie électrique, électronique et télécommunications;GEET;8;Sciences pour l'ingénieur;2022;2021-22;2021;2021;43;9;34;157;32;125;39;9;30;9;26;3;1;arcz6
327;École doctorale Temps, espaces, sociétés, cultures;TESC;7;Sciences de la société;2022;2021-22;2021;2021;14;8;6;79;52;27;14;10;4;0;3;7;4;IjgiJ
328;École doctorale Arts, lettres, langues, philosophie et communication;ALLPH@;7;Sciences de la société;2022;2021-22;2021;2021;2;2;0;10;8;2;1;1;0;0;0;1;0;xLxMh
341;École doctorale Évolution, écosystèmes, microbiologie, modélisation;E2M2;10;Sciences agronomiques et écologiques;2022;2021-22;2021;2021;11;6;5;71;43;28;12;8;4;5;7;0;0;J83I0
361;École doctorale Sciences et Technologies;ED ST;7;Sciences de la société;2022;2021-22;2021;2021;4;1;3;15;6;9;2;1;1;0;2;0;0;cOUmL
361;École doctorale Sciences et Technologies;ED ST;9;Sciences et technologies de l'information et de la communication;2022;2021-22;2021;2021;14;5;9;79;32;47;23;9;14;12;8;2;1;cOUmL
370;École doctorale Lettres, sciences humaines et sociales;LSHS;9;Sciences et technologies de l'information et de la communication;2022;2021-22;2021;2021;0;0;0;0;0;0;1;0;1;0;0;1;0;xAXXx
377;École doctorale Environnement et société;;6;Sciences humaines et humanités;2022;2021-22;2021;2021;20;13;7;66;38;28;6;4;2;2;4;0;0;ZMG5u
377;École doctorale Environnement et société;;8;Sciences pour l'ingénieur;2022;2021-22;2021;2021;3;1;2;8;3;5;2;2;0;1;1;0;0;ZMG5u
388;École doctorale Chimie physique et chimie analytique de Paris centre;CPCA;4;Chimie;2022;2021-22;2021;2021;81;38;43;331;149;182;85;39;46;57;26;2;0;M0Hnd
402;École doctorale Sciences de la vie et de la santé;SVS;5;Biologie, médecine et santé;2022;2021-22;2021;2021;34;21;13;141;90;51;27;19;8;6;17;2;2;YKgsU
406;École doctorale Chimie moléculaire de Paris centre;;4;Chimie;2022;2021-22;2021;2021;38;20;18;126;61;65;28;13;15;18;10;0;0;a5dKy
414;École doctorale Sciences de la vie et de la santé;;10;Sciences agronomiques et écologiques;2022;2021-22;2021;2021;5;3;2;14;8;6;0;0;0;0;0;0;0;YI4xS
432;École doctorale Sciences des métiers de l'ingénieur;SMI;6;Sciences humaines et humanités;2022;2021-22;2021;2021;0;0;0;1;1;0;0;0;0;0;0;0;0;nSsHB
446;École doctorale Biologie - Santé;EDBSL;8;Sciences pour l'ingénieur;2022;2021-22;2021;2021;0;0;0;0;0;0;1;1;0;1;0;0;0;4iEUF
454;École doctorale Sciences de l'homme, du politique et du territoire;SHPT;6;Sciences humaines et humanités;2022;2021-22;2021;2021;33;17;16;176;93;83;25;15;10;0;5;15;5;Opv31
455;École doctorale Économie, Gestion, Information et Communication;EGIC;6;Sciences humaines et humanités;2022;2021-22;2021;2021;8;2;6;52;30;22;11;9;2;0;0;4;7;qCOg3
463;École doctorale Sciences du mouvement humain;SMH;5;Biologie, médecine et santé;2022;2021-22;2021;2021;18;6;12;73;34;39;11;5;6;2;5;3;1;UbtlY
467;École doctorale Aéronautique, astronautique;AA;2;Physique;2022;2021-22;2021;2021;1;1;0;5;3;2;1;1;0;1;0;0;0;U7l45
467;École doctorale Aéronautique, astronautique;AA;3;Sciences de la terre et de l'univers, espace;2022;2021-22;2021;2021;3;1;2;4;1;3;2;2;0;0;2;0;0;U7l45
467;École doctorale Aéronautique, astronautique;AA;6;Sciences humaines et humanités;2022;2021-22;2021;2021;1;0;1;7;5;2;1;0;1;1;0;0;0;U7l45
467;École doctorale Aéronautique, astronautique;AA;9;Sciences et technologies de l'information et de la communication;2022;2021-22;2021;2021;2;1;1;11;4;7;3;1;2;1;2;0;0;U7l45
474;École doctorale Interdisciplinaire européenne frontières du vivant;FDV;1;Mathématiques et leurs interactions;2022;2021-22;2021;2021;2;0;2;6;3;3;4;1;3;0;4;0;0;E727j
474;École doctorale Interdisciplinaire européenne frontières du vivant;FDV;3;Sciences de la terre et de l'univers, espace;2022;2021-22;2021;2021;5;2;3;12;9;3;5;1;4;0;5;0;0;E727j
474;École doctorale Interdisciplinaire européenne frontières du vivant;FDV;6;Sciences humaines et humanités;2022;2021-22;2021;2021;1;1;0;6;4;2;1;1;0;0;1;0;0;E727j
475;École doctorale Mathématiques, informatique, télécommunications de Toulouse;MITT;9;Sciences et technologies de l'information et de la communication;2022;2021-22;2021;2021;78;14;64;282;60;222;70;21;49;35;24;9;2;xcp2r
484;École doctorale Lettres, langues, linguistique, arts;3LA;6;Sciences humaines et humanités;2022;2021-22;2021;2021;71;42;29;444;282;162;47;27;20;3;5;21;18;BlCQD
488;École doctorale Sciences, ingénierie, santé;SIS;1;Mathématiques et leurs interactions;2022;2021-22;2021;2021;3;0;3;15;1;14;3;1;2;2;1;0;0;Fy2lK
488;École doctorale Sciences, ingénierie, santé;SIS;3;Sciences de la terre et de l'univers, espace;2022;2021-22;2021;2021;2;1;1;9;6;3;3;1;2;3;0;0;0;Fy2lK
489;École doctorale Sciences et ingénierie des systèmes, de l'environnement et des organisations;SISEO;5;Biologie, médecine et santé;2022;2021-22;2021;2021;0;0;0;0;0;0;1;0;1;0;1;0;0;6pT77
489;École doctorale Sciences et ingénierie des systèmes, de l'environnement et des organisations;SISEO;6;Sciences humaines et humanités;2022;2021-22;2021;2021;0;0;0;0;0;0;4;4;0;0;1;2;1;6pT77
489;École doctorale Sciences et ingénierie des systèmes, de l'environnement et des organisations;SISEO;7;Sciences de la société;2022;2021-22;2021;2021;0;0;0;0;0;0;1;1;0;0;0;1;0;6pT77
493;École doctorale Erasme;;7;Sciences de la société;2022;2021-22;2021;2021;19;6;13;106;46;60;20;8;12;0;7;6;7;FPW4T
497;École doctorale Normande de Biologie Intégrative, Santé, Environnement;Ed NBISE;2;Physique;2022;2021-22;2021;2021;2;0;2;3;1;2;0;0;0;0;0;0;0;0D9Je
509;École doctorale Civilisations et sociétés euro-méditerranéennes et comparées;;7;Sciences de la société;2022;2021-22;2021;2021;13;5;8;114;47;67;17;5;12;1;4;7;5;9tbyG
513;École doctorale Droit et sciences politiques, économiques et de gestion;DESPEG;7;Sciences de la société;2022;2021-22;2021;2021;36;17;19;231;110;121;28;15;13;6;7;8;7;aVHGU
528;École doctorale Ville, transports et territoires;VTT;8;Sciences pour l'ingénieur;2022;2021-22;2021;2021;1;0;1;21;6;15;3;0;3;1;1;0;1;68zCc
528;École doctorale Ville, transports et territoires;VTT;10;Sciences agronomiques et écologiques;2022;2021-22;2021;2021;1;0;1;1;0;1;0;0;0;0;0;0;0;68zCc
529;École doctorale Cultures et sociétés;CS;6;Sciences humaines et humanités;2022;2021-22;2021;2021;39;25;14;233;131;102;26;12;14;0;2;5;19;XU9tb
530;École doctorale Organisations, marchés, institutions;OMI;6;Sciences humaines et humanités;2022;2021-22;2021;2021;21;14;7;152;64;88;10;1;9;0;4;1;5;4htv7
531;École doctorale Sciences, ingénierie et environnement;SIE;3;Sciences de la terre et de l'univers, espace;2022;2021-22;2021;2021;8;3;5;31;13;18;0;0;0;0;0;0;0;b5BYq
532;École doctorale Mathématiques et sciences et technologies de l'information et de la communication;MSTIC;1;Mathématiques et leurs interactions;2022;2021-22;2021;2021;24;5;19;86;20;66;17;1;16;9;6;2;0;t43KM
532;École doctorale Mathématiques et sciences et technologies de l'information et de la communication;MSTIC;5;Biologie, médecine et santé;2022;2021-22;2021;2021;1;0;1;1;0;1;1;0;1;0;1;0;0;t43KM
536;École doctorale Sciences et agrosciences;;1;Mathématiques et leurs interactions;2022;2021-22;2021;2021;2;1;1;5;2;3;3;1;2;3;0;0;0;pHfqe
540;"École doctorale École transdisciplinaire ""lettres/sciences""";;3;Sciences de la terre et de l'univers, espace;2022;2021-22;2021;2021;0;0;0;1;1;0;0;0;0;0;0;0;0;tWWw7
540;"École doctorale École transdisciplinaire ""lettres/sciences""";;8;Sciences pour l'ingénieur;2022;2021-22;2021;2021;3;1;2;5;3;2;1;1;0;0;1;0;0;tWWw7
541;École doctorale de sciences humaines et sociales de La Réunion;SHS;6;Sciences humaines et humanités;2022;2021-22;2021;2021;11;9;2;92;62;30;8;6;2;0;0;5;3;21SpE
542;École doctorale de sciences de La Réunion;STS;1;Mathématiques et leurs interactions;2022;2021-22;2021;2021;1;0;1;3;1;2;0;0;0;0;0;0;0;2pAql
548;École doctorale Mer et Sciences;;1;Mathématiques et leurs interactions;2022;2021-22;2021;2021;3;0;3;12;5;7;5;3;2;1;2;2;0;QX0fS
548;École doctorale Mer et Sciences;;3;Sciences de la terre et de l'univers, espace;2022;2021-22;2021;2021;3;3;0;8;6;2;1;0;1;1;0;0;0;QX0fS
548;École doctorale Mer et Sciences;;6;Sciences humaines et humanités;2022;2021-22;2021;2021;1;0;1;7;2;5;3;1;2;1;2;0;0;QX0fS
549;École doctorale Santé, Sciences Biologiques et Chimie du Vivant;SSBCV;5;Biologie, médecine et santé;2022;2021-22;2021;2021;57;31;26;196;117;79;47;36;11;17;26;3;1;B9ggO
549;École doctorale Santé, Sciences Biologiques et Chimie du Vivant;SSBCV;6;Sciences humaines et humanités;2022;2021-22;2021;2021;0;0;0;6;6;0;1;0;1;1;0;0;0;B9ggO
552;École doctorale Énergie - Matériaux - Sciences de la Terre et de l'Univers;EMTSU;2;Physique;2022;2021-22;2021;2021;19;9;10;60;25;35;4;2;2;2;2;0;0;NTZhw
554;École doctorale Environnements - Santé;E-S;5;Biologie, médecine et santé;2022;2021-22;2021;2021;86;44;42;282;147;135;74;31;43;27;36;11;0;ElyFU
556;École doctorale Homme, Sociétés, Risques, Territoire;HSRT;5;Biologie, médecine et santé;2022;2021-22;2021;2021;8;7;1;18;13;5;5;3;2;2;3;0;0;5QEaX
556;École doctorale Homme, Sociétés, Risques, Territoire;HSRT;6;Sciences humaines et humanités;2022;2021-22;2021;2021;9;3;6;56;27;29;5;1;4;0;2;2;1;5QEaX
556;École doctorale Homme, Sociétés, Risques, Territoire;HSRT;7;Sciences de la société;2022;2021-22;2021;2021;40;21;19;205;109;96;20;8;12;2;8;8;2;5QEaX
562;École doctorale Bio Sorbonne Paris Cité;BioSPC;5;Biologie, médecine et santé;2022;2021-22;2021;2021;160;101;59;556;357;199;137;94;43;45;84;8;0;4Yju6
563;École doctorale Médicament - Toxicologie - Chimie - Imageries;MTCI;4;Chimie;2022;2021-22;2021;2021;13;6;7;47;24;23;14;6;8;4;10;0;0;j8uk1
564;École doctorale Physique en Ile de France;PIF;2;Physique;2022;2021-22;2021;2021;206;57;149;708;167;541;151;31;120;90;54;7;0;39AcN
565;École doctorale Droit de la Sorbonne;DS;7;Sciences de la société;2022;2021-22;2021;2021;79;38;41;656;333;323;48;23;25;5;6;14;23;aXJ7L
570;École doctorale Santé Publique;EDSP;5;Biologie, médecine et santé;2022;2021-22;2021;2021;49;32;17;158;101;57;43;28;15;22;14;6;1;9lgE4
570;École doctorale Santé Publique;EDSP;6;Sciences humaines et humanités;2022;2021-22;2021;2021;3;1;2;7;4;3;2;2;0;0;1;1;0;9lgE4
571;École doctorale Sciences Chimiques : Molécules, Matériaux, Instrumentation et Biosystemes;2MIB;5;Biologie, médecine et santé;2022;2021-22;2021;2021;0;0;0;2;1;1;0;0;0;0;0;0;0;zbi37
575;École doctorale Electrical, Optical, Bio : Physics and Engineering;EOBE;3;Sciences de la terre et de l'univers, espace;2022;2021-22;2021;2021;1;0;1;1;0;1;0;0;0;0;0;0;0;dfhyn
575;École doctorale Electrical, Optical, Bio : Physics and Engineering;EOBE;9;Sciences et technologies de l'information et de la communication;2022;2021-22;2021;2021;2;0;2;17;4;13;5;0;5;2;3;0;0;dfhyn
576;École doctorale Particules, Hadrons, Énergie, Noyau, Instrumentation, Imagerie, Cosmos et Simulation;PHENIICS;3;Sciences de la terre et de l'univers, espace;2022;2021-22;2021;2021;0;0;0;0;0;0;3;1;2;3;0;0;0;qC4rf
581;École doctorale Agriculture, alimentation, biologie, environnement, santé;ABIES;5;Biologie, médecine et santé;2022;2021-22;2021;2021;17;13;4;66;48;18;16;13;3;7;9;0;0;c1x56
581;École doctorale Agriculture, alimentation, biologie, environnement, santé;ABIES;10;Sciences agronomiques et écologiques;2022;2021-22;2021;2021;40;16;24;130;60;70;29;12;17;14;14;1;0;c1x56
583;École doctorale Risques et Société;;3;Sciences de la terre et de l'univers, espace;2022;2021-22;2021;2021;1;0;1;4;1;3;1;0;1;0;1;0;0;wUBi9
583;École doctorale Risques et Société;;9;Sciences et technologies de l'information et de la communication;2022;2021-22;2021;2021;2;0;2;4;0;4;3;2;1;0;3;0;0;wUBi9
584;École doctorale Biodiversité, Agriculture, Alimentation, Environnement, Terre, Eau;GAIA;3;Sciences de la terre et de l'univers, espace;2022;2021-22;2021;2021;32;16;16;79;36;43;22;6;16;11;11;0;0;F1h5f
584;École doctorale Biodiversité, Agriculture, Alimentation, Environnement, Terre, Eau;GAIA;5;Biologie, médecine et santé;2022;2021-22;2021;2021;47;31;16;101;66;35;14;5;9;6;8;0;0;F1h5f
585;École doctorale Sciences, Technologie,  Sante;EDSTS;1;Mathématiques et leurs interactions;2022;2021-22;2021;2021;9;5;4;35;21;14;10;2;8;4;6;0;0;NM3Dl
585;École doctorale Sciences, Technologie,  Sante;EDSTS;8;Sciences pour l'ingénieur;2022;2021-22;2021;2021;14;6;8;56;24;32;14;5;9;8;5;1;0;NM3Dl
587;École doctorale Diversites, santé et développement en Amazonie;;9;Sciences et technologies de l'information et de la communication;2022;2021-22;2021;2021;0;0;0;1;0;1;1;0;1;1;0;0;0;V14tj
589;École doctorale Milieu insulaire tropical à risques : protection, valorisation , santé et développement;;1;Mathématiques et leurs interactions;2022;2021-22;2021;2021;5;0;5;18;0;18;6;1;5;4;1;1;0;2cqi3
589;École doctorale Milieu insulaire tropical à risques : protection, valorisation , santé et développement;;4;Chimie;2022;2021-22;2021;2021;2;2;0;11;8;3;0;0;0;0;0;0;0;2cqi3
590;École doctorale Mathematiques, Information, Ingenierie des Systemes;MIIS;1;Mathématiques et leurs interactions;2022;2021-22;2021;2021;11;2;9;51;12;39;16;6;10;10;5;1;0;L20t5
591;École doctorale Physique, Sciences de l'Ingenieur, Materiaux, Énergie;PSIME;4;Chimie;2022;2021-22;2021;2021;16;4;12;66;23;43;13;6;7;8;5;0;0;Hn5Om
592;École doctorale Lettres, Communication, Langues, Arts;LECLA;6;Sciences humaines et humanités;2022;2021-22;2021;2021;40;26;14;199;125;74;21;13;8;1;6;4;10;sY7f3
597;École doctorale Sciences économiques et sciences de Gestion;EDGE;7;Sciences de la société;2022;2021-22;2021;2021;43;25;18;184;83;101;38;18;20;3;20;10;5;d8Zuu
600;École doctorale Écologie, Géosciences, Agronomie et Alimentation;EGAAL;5;Biologie, médecine et santé;2022;2021-22;2021;2021;8;3;5;26;10;16;7;4;3;2;5;0;0;urS33
607;École doctorale Sciences et Ingénierie des Ressources Naturelles;SIReNA;8;Sciences pour l'ingénieur;2022;2021-22;2021;2021;1;0;1;6;0;6;2;2;0;1;1;0;0;vi9w2
609;École doctorale Sciences et Ingénierie des Matériaux, Mécanique, Énergétique -;SIMME;4;Chimie;2022;2021-22;2021;2021;8;0;8;27;9;18;11;4;7;3;8;0;0;N4Rjy
609;École doctorale Sciences et Ingénierie des Matériaux, Mécanique, Énergétique -;SIMME;5;Biologie, médecine et santé;2022;2021-22;2021;2021;1;1;0;1;1;0;0;0;0;0;0;0;0;N4Rjy
611;École doctorale Sciences du Langage, Psychologie, Cognition, Education;SLPCE;6;Sciences humaines et humanités;2022;2021-22;2021;2021;24;14;10;89;56;33;12;3;9;2;5;5;0;z8agK
612;École doctorale Humanités;;6;Sciences humaines et humanités;2022;2021-22;2021;2021;63;33;30;275;150;125;35;16;19;5;4;13;13;v30I8
613;École doctorale Sciences de la Société, Territoires, Sciences Economiques et de Gestion;SSTSEG;6;Sciences humaines et humanités;2022;2021-22;2021;2021;9;3;6;44;23;21;5;3;2;0;1;4;0;6eLRF
614;École doctorale Chimie, Écologie, Géosciences, Agrosciences - Théodore Monod;CEGA;4;Chimie;2022;2021-22;2021;2021;19;8;11;59;30;29;19;9;10;10;8;1;0;uc10I
617;École doctorale Sciences de la Société : Territoires, Economie et Droit;SSTED;7;Sciences de la société;2022;2021-22;2021;2021;40;17;23;175;83;92;24;13;11;3;5;8;8;Kl9ZX
618;École doctorale EUCLIDE;;8;Sciences pour l'ingénieur;2022;2021-22;2021;2021;12;4;8;34;12;22;9;3;6;1;8;0;0;qveTN
619;École doctorale Sciences Fondamentales et Santé;SFS;5;Biologie, médecine et santé;2022;2021-22;2021;2021;22;15;7;79;41;38;13;9;4;3;7;2;1;JiZVW
620;École doctorale Sciences du Numérique et de l'Ingénieur;SNI;1;Mathématiques et leurs interactions;2022;2021-22;2021;2021;1;1;0;4;1;3;0;0;0;0;0;0;0;Dr40w
620;École doctorale Sciences du Numérique et de l'Ingénieur;SNI;5;Biologie, médecine et santé;2022;2021-22;2021;2021;0;0;0;0;0;0;2;2;0;1;1;0;0;Dr40w
621;École doctorale Ingénierie des Systèmes, Matériaux, Mécanique, Énergétique;ISMME;8;Sciences pour l'ingénieur;2022;2021-22;2021;2021;63;16;47;222;57;165;47;11;36;25;17;4;1;B2549
622;École doctorale Sciences du langage;SDL;7;Sciences de la société;2022;2021-22;2021;2021;0;0;0;1;0;1;2;1;1;0;0;1;1;9DsG2
624;École doctorale Sciences des Sociétés;SDS;7;Sciences de la société;2022;2021-22;2021;2021;22;13;9;166;110;56;32;16;16;3;2;18;9;cGIjW
626;École doctorale de l’Institut Polytechnique de Paris;;3;Sciences de la terre et de l'univers, espace;2022;2021-22;2021;2021;6;2;4;15;6;9;4;1;3;2;2;0;0;DL5fO
626;École doctorale de l’Institut Polytechnique de Paris;;5;Biologie, médecine et santé;2022;2021-22;2021;2021;7;3;4;26;14;12;5;1;4;3;2;0;0;DL5fO
626;École doctorale de l’Institut Polytechnique de Paris;;8;Sciences pour l'ingénieur;2022;2021-22;2021;2021;32;9;23;117;33;84;18;6;12;10;4;4;0;DL5fO
628;École doctorale Arts Humanités et Sciences sociales;AHSS;6;Sciences humaines et humanités;2022;2021-22;2021;2021;41;24;17;194;109;85;11;4;7;0;2;3;6;vwwRK
635;École doctorale Polytechnique Hauts-de-France;PHF;9;Sciences et technologies de l'information et de la communication;2022;2021-22;2021;2021;16;6;10;68;24;44;8;1;7;4;4;0;0;p2m23
9;École doctorale Droit international, droit européen, relations internationales et droit comparé;;7;Sciences de la société;2019;2018-19;2018;2018;36;17;19;242;152;90;14;8;6;;;;;v1emR
19;École doctorale Littératures françaises et comparée;;6;Sciences humaines et humanités;2019;2018-19;2018;2018;53;32;21;265;171;94;36;25;11;;;;;13M43
31;École doctorale Pratiques et théories du sens;;7;Sciences de la société;2019;2018-19;2018;2018;14;10;4;124;72;52;8;4;4;;;;;1S466
41;École doctorale Droit;;6;Sciences humaines et humanités;2019;2018-19;2018;2018;58;26;32;310;153;157;46;18;28;;;;;KnOQK
42;École doctorale Entreprise, économie, société;EES;7;Sciences de la société;2019;2018-19;2018;2018;24;8;16;115;40;75;21;11;10;;;;;uO01d
47;École doctorale Physique;;3;Sciences de la terre et de l'univers, espace;2019;2018-19;2018;2018;1;1;0;4;2;2;0;0;0;;;;;8kNpd
58;École doctorale Langues, littératures, cultures, civilisations;LLCC;6;Sciences humaines et humanités;2019;2018-19;2018;2018;83;49;34;456;283;173;60;35;25;;;;;I9ATR
60;École doctorale Territoires, temps, sociétés et développement;TTSD;7;Sciences de la société;2019;2018-19;2018;2018;20;13;7;82;49;33;3;1;2;;;;;fkIh6
62;École doctorale Sciences de la vie et de la santé;;8;Sciences pour l'ingénieur;2019;2018-19;2018;2018;0;0;0;2;0;2;0;0;0;;;;;vZzE7
62;École doctorale Sciences de la vie et de la santé;;10;Sciences agronomiques et écologiques;2019;2018-19;2018;2018;0;0;0;2;1;1;0;0;0;;;;;vZzE7
70;École doctorale Sciences pour l'ingénieur;EDSPI;8;Sciences pour l'ingénieur;2019;2018-19;2018;2018;38;7;31;148;35;113;44;6;38;;;;;G413P
72;École doctorale Sciences pour l'ingénieur;SPI;1;Mathématiques et leurs interactions;2019;2018-19;2018;2018;19;5;14;68;25;43;15;7;8;;;;;47QPx
74;École doctorale Sciences juridiques, politique et de gestion;SJPG;7;Sciences de la société;2019;2018-19;2018;2018;40;16;24;248;124;124;24;15;9;;;;;3A2RY
77;École doctorale Informatique, automatique, électronique, électrotechnique, mathématiques;IAEM;9;Sciences et technologies de l'information et de la communication;2019;2018-19;2018;2018;67;16;51;256;68;188;51;16;35;;;;;TCHTA
101;École doctorale de Sciences juridiques;;7;Sciences de la société;2019;2018-19;2018;2018;34;18;16;227;108;119;26;17;9;;;;;569G2
104;École doctorale Sciences de la matière, du rayonnement et de l'environnement;SMRE;2;Physique;2019;2018-19;2018;2018;22;7;15;71;30;41;21;5;16;;;;;Q5iFz
104;École doctorale Sciences de la matière, du rayonnement et de l'environnement;SMRE;3;Sciences de la terre et de l'univers, espace;2019;2018-19;2018;2018;19;10;9;45;20;25;10;3;7;;;;;Q5iFz
104;École doctorale Sciences de la matière, du rayonnement et de l'environnement;SMRE;6;Sciences humaines et humanités;2019;2018-19;2018;2018;0;0;0;2;1;1;2;1;1;;;;;Q5iFz
113;École doctorale Histoire;;6;Sciences humaines et humanités;2019;2018-19;2018;2018;53;25;28;282;145;137;33;16;17;;;;;G5wHs
124;École doctorale Histoire de l'art et archéologie;;6;Sciences humaines et humanités;2019;2018-19;2018;2018;16;11;5;146;100;46;28;20;8;;;;;MBN4L
127;École doctorale Astronomie et astrophysique d'Ile de France;A&A;3;Sciences de la terre et de l'univers, espace;2019;2018-19;2018;2018;47;16;31;159;46;113;43;14;29;;;;;cPXrq
146;École doctorale Galilée;GALILEE;1;Mathématiques et leurs interactions;2019;2018-19;2018;2018;13;4;9;38;9;29;11;1;10;;;;;71hqm
146;École doctorale Galilée;GALILEE;2;Physique;2019;2018-19;2018;2018;6;2;4;20;7;13;5;0;5;;;;;71hqm
151;École doctorale Biologie, santé, biotechnologies;;5;Biologie, médecine et santé;2019;2018-19;2018;2018;102;58;44;399;240;159;87;49;38;;;;;yP8w4
162;École doctorale Mécanique, énergétique, génie civil, acoustique;MEGA;1;Mathématiques et leurs interactions;2019;2018-19;2018;2018;0;0;0;1;1;0;0;0;0;;;;;7wCke
162;École doctorale Mécanique, énergétique, génie civil, acoustique;MEGA;5;Biologie, médecine et santé;2019;2018-19;2018;2018;15;5;10;27;13;14;0;0;0;;;;;7wCke
166;École doctorale Information, structures et systèmes;I2S;5;Biologie, médecine et santé;2019;2018-19;2018;2018;0;0;0;12;6;6;1;0;1;;;;;2uO68
166;École doctorale Information, structures et systèmes;I2S;8;Sciences pour l'ingénieur;2019;2018-19;2018;2018;31;4;27;120;22;98;28;8;20;;;;;2uO68
168;École doctorale Sciences chimiques et biologiques pour la santé;SCBS;5;Biologie, médecine et santé;2019;2018-19;2018;2018;118;68;50;385;217;168;101;64;37;;;;;8cEME
178;École doctorale Sciences fondamentales;;1;Mathématiques et leurs interactions;2019;2018-19;2018;2018;4;1;3;17;3;14;0;0;0;;;;;1AiR7
182;École doctorale Physique et chimie-physique;;5;Biologie, médecine et santé;2019;2018-19;2018;2018;1;0;1;1;0;1;0;0;0;;;;;3My6I
182;École doctorale Physique et chimie-physique;;8;Sciences pour l'ingénieur;2019;2018-19;2018;2018;0;0;0;4;1;3;0;0;0;;;;;3My6I
188;École doctorale Histoire moderne et contemporaine;;6;Sciences humaines et humanités;2019;2018-19;2018;2018;28;14;14;150;70;80;24;12;12;;;;;RSZ7F
205;École doctorale Interdisciplinaire Sciences-Santé;EDISS;6;Sciences humaines et humanités;2019;2018-19;2018;2018;4;2;2;15;8;7;8;5;3;;;;;69W38
205;École doctorale Interdisciplinaire Sciences-Santé;EDISS;7;Sciences de la société;2019;2018-19;2018;2018;0;0;0;1;1;0;0;0;0;;;;;69W38
209;École doctorale Sciences physiques et de L'ingénieur;SPI;2;Physique;2019;2018-19;2018;2018;32;5;27;109;16;93;26;6;20;;;;;tZcIZ
211;École doctorale Sciences exactes et leurs applications;ED SEA;5;Biologie, médecine et santé;2019;2018-19;2018;2018;6;5;1;25;18;7;3;1;2;;;;;1G1iC
216;École doctorale Ingénierie pour la santé, la cognition, l'environnement;EDISCE;8;Sciences pour l'ingénieur;2019;2018-19;2018;2018;6;3;3;12;5;7;2;1;1;;;;;fPs1t
216;École doctorale Ingénierie pour la santé, la cognition, l'environnement;EDISCE;10;Sciences agronomiques et écologiques;2019;2018-19;2018;2018;1;1;0;3;1;2;0;0;0;;;;;fPs1t
217;École doctorale Mathématiques, sciences et technologies de l'information, informatique;MSTII;1;Mathématiques et leurs interactions;2019;2018-19;2018;2018;24;6;18;93;18;75;21;1;20;;;;;Ehx7v
220;École doctorale Électronique, électrotechnique, automatique, traitement du signal;EEATS;2;Physique;2019;2018-19;2018;2018;18;3;15;67;22;45;14;4;10;;;;;IxEaw
221;École doctorale Augustin Cournot - Sciences économiques et de gestion - Sciences, technologies et sociétés;EDAC;6;Sciences humaines et humanités;2019;2018-19;2018;2018;4;0;4;15;6;9;0;0;0;;;;;5z9rW
222;École doctorale Sciences chimiques;EDSC;4;Chimie;2019;2018-19;2018;2018;62;22;40;258;98;160;74;27;47;;;;;AdU8Q
224;École doctorale Cognition, langage, interaction;;1;Mathématiques et leurs interactions;2019;2018-19;2018;2018;1;1;0;8;2;6;0;0;0;;;;;7v43e
224;École doctorale Cognition, langage, interaction;;8;Sciences pour l'ingénieur;2019;2018-19;2018;2018;5;3;2;8;5;3;2;1;1;;;;;7v43e
224;École doctorale Cognition, langage, interaction;;9;Sciences et technologies de l'information et de la communication;2019;2018-19;2018;2018;2;1;1;7;3;4;0;0;0;;;;;7v43e
227;École doctorale Sciences de la nature et de l'homme;;3;Sciences de la terre et de l'univers, espace;2019;2018-19;2018;2018;1;0;1;4;1;3;1;1;0;;;;;xiDA5
269;École doctorale Mathématiques, sciences de l'information et de l'ingénieur;MSII;9;Sciences et technologies de l'information et de la communication;2019;2018-19;2018;2018;33;10;23;145;33;112;34;8;26;;;;;5E625
275;École doctorale Sciences de gestion;EDSG;7;Sciences de la société;2019;2018-19;2018;2018;16;7;9;67;39;28;11;8;3;;;;;6QC4I
300;École doctorale Sciences Économiques;ED SE;7;Sciences de la société;2019;2018-19;2018;2018;4;3;1;33;13;20;10;1;9;;;;;5x3fM
304;École doctorale Sciences et environnements;;3;Sciences de la terre et de l'univers, espace;2019;2018-19;2018;2018;5;1;4;19;9;10;6;4;2;;;;;2ywZn
305;École doctorale Énergie et environnement;E2;4;Chimie;2019;2018-19;2018;2018;4;2;2;17;8;9;3;2;1;;;;;Kbt8I
305;École doctorale Énergie et environnement;E2;8;Sciences pour l'ingénieur;2019;2018-19;2018;2018;9;3;6;35;12;23;9;2;7;;;;;Kbt8I
326;École doctorale Comportement, langage, éducation, socialisation, cognition;CLESCO;5;Biologie, médecine et santé;2019;2018-19;2018;2018;10;5;5;10;5;5;1;0;1;;;;;nWIlG
326;École doctorale Comportement, langage, éducation, socialisation, cognition;CLESCO;7;Sciences de la société;2019;2018-19;2018;2018;2;2;0;2;2;0;1;0;1;;;;;nWIlG
327;École doctorale Temps, espaces, sociétés, cultures;TESC;8;Sciences pour l'ingénieur;2019;2018-19;2018;2018;0;0;0;4;2;2;1;1;0;;;;;IjgiJ
327;École doctorale Temps, espaces, sociétés, cultures;TESC;10;Sciences agronomiques et écologiques;2019;2018-19;2018;2018;1;1;0;4;2;2;0;0;0;;;;;IjgiJ
341;École doctorale Évolution, écosystèmes, microbiologie, modélisation;E2M2;3;Sciences de la terre et de l'univers, espace;2019;2018-19;2018;2018;0;0;0;6;3;3;0;0;0;;;;;J83I0
353;École doctorale Sciences pour l'ingénieur : mécanique, physique, micro et nanoélectronique;;1;Mathématiques et leurs interactions;2019;2018-19;2018;2018;0;0;0;1;0;1;0;0;0;;;;;vk5Kp
354;École doctorale Langues, lettres et arts;LLA;6;Sciences humaines et humanités;2019;2018-19;2018;2018;29;21;8;222;143;79;40;24;16;;;;;RwcSv
355;École doctorale Espaces, cultures, sociétés;;6;Sciences humaines et humanités;2019;2018-19;2018;2018;34;22;12;182;100;82;28;16;12;;;;;2kMf5
356;École doctorale Cognition, langage, éducation;;9;Sciences et technologies de l'information et de la communication;2019;2018-19;2018;2018;2;2;0;22;15;7;8;3;5;;;;;55Cpz
361;École doctorale Sciences et Technologies;ED ST;8;Sciences pour l'ingénieur;2019;2018-19;2018;2018;7;2;5;34;11;23;18;4;14;;;;;cOUmL
377;École doctorale Environnement et société;;3;Sciences de la terre et de l'univers, espace;2019;2018-19;2018;2018;0;0;0;3;2;1;0;0;0;;;;;ZMG5u
377;École doctorale Environnement et société;;6;Sciences humaines et humanités;2019;2018-19;2018;2018;17;6;11;59;33;26;9;7;2;;;;;ZMG5u
394;École doctorale Physiologie et physiopathologie;p2t;5;Biologie, médecine et santé;2019;2018-19;2018;2018;56;32;24;214;129;85;54;33;21;;;;;VMYmT
396;École doctorale Économie, organisations, société;EOS;7;Sciences de la société;2019;2018-19;2018;2018;47;18;29;188;80;108;38;18;20;;;;;Es5e7
400;École doctorale Savoirs scientifiques : épistémologie, histoire des sciences, didactique des disciplines;;4;Chimie;2019;2018-19;2018;2018;1;1;0;3;1;2;0;0;0;;;;;nRax3
400;École doctorale Savoirs scientifiques : épistémologie, histoire des sciences, didactique des disciplines;;6;Sciences humaines et humanités;2019;2018-19;2018;2018;3;2;1;3;2;1;2;2;0;;;;;nRax3
409;École doctorale Énergie, mécanique, matériaux;EMMA;2;Physique;2019;2018-19;2018;2018;0;0;0;0;0;0;13;1;12;;;;;KXlbK
414;École doctorale Sciences de la vie et de la santé;;5;Biologie, médecine et santé;2019;2018-19;2018;2018;109;64;45;514;287;227;130;67;63;;;;;YI4xS
417;École doctorale Sciences et Ingénierie;S&I;2;Physique;2019;2018-19;2018;2018;6;6;0;15;8;7;1;1;0;;;;;SSBvE
417;École doctorale Sciences et Ingénierie;S&I;3;Sciences de la terre et de l'univers, espace;2019;2018-19;2018;2018;3;1;2;7;2;5;2;1;1;;;;;SSBvE
432;École doctorale Sciences des métiers de l'ingénieur;SMI;4;Chimie;2019;2018-19;2018;2018;0;0;0;0;0;0;1;1;0;;;;;nSsHB
433;École doctorale Concepts et langages;;1;Mathématiques et leurs interactions;2019;2018-19;2018;2018;0;0;0;4;2;2;1;0;1;;;;;v8q34
454;École doctorale Sciences de l'homme, du politique et du territoire;SHPT;7;Sciences de la société;2019;2018-19;2018;2018;26;12;14;121;68;53;16;8;8;;;;;Opv31
460;École doctorale Sciences juridiques;SJ;7;Sciences de la société;2019;2018-19;2018;2018;13;9;4;104;55;49;9;4;5;;;;;ZB5I5
460;École doctorale Sciences juridiques;SJ;9;Sciences et technologies de l'information et de la communication;2019;2018-19;2018;2018;2;1;1;2;1;1;0;0;0;;;;;ZB5I5
467;École doctorale Aéronautique, astronautique;AA;6;Sciences humaines et humanités;2019;2018-19;2018;2018;1;0;1;7;2;5;4;1;3;;;;;U7l45
469;École doctorale du Pacifique;EDP;4;Chimie;2019;2018-19;2018;2018;2;1;1;6;4;2;1;1;0;;;;;t9Z2n
472;École doctorale de l'EPHE;;3;Sciences de la terre et de l'univers, espace;2019;2018-19;2018;2018;4;2;2;10;6;4;1;0;1;;;;;27zK4
472;École doctorale de l'EPHE;;6;Sciences humaines et humanités;2019;2018-19;2018;2018;83;46;37;457;243;214;59;32;27;;;;;27zK4
473;École doctorale Sciences de l'homme et de la société;SHS;6;Sciences humaines et humanités;2019;2018-19;2018;2018;162;98;64;722;414;308;62;36;26;;;;;8qKD9
474;École doctorale Interdisciplinaire européenne frontières du vivant;FDV;2;Physique;2019;2018-19;2018;2018;1;0;1;2;0;2;3;1;2;;;;;E727j
474;École doctorale Interdisciplinaire européenne frontières du vivant;FDV;4;Chimie;2019;2018-19;2018;2018;0;0;0;1;0;1;1;0;1;;;;;E727j
474;École doctorale Interdisciplinaire européenne frontières du vivant;FDV;7;Sciences de la société;2019;2018-19;2018;2018;3;1;2;5;3;2;0;0;0;;;;;E727j
482;École doctorale Sciences de la matière;SDM;2;Physique;2019;2018-19;2018;2018;21;6;15;84;25;59;24;5;19;;;;;kmeZ4
482;École doctorale Sciences de la matière;SDM;4;Chimie;2019;2018-19;2018;2018;47;20;27;197;89;108;60;23;37;;;;;kmeZ4
486;École doctorale Sciences économiques et de gestion;SEG;7;Sciences de la société;2019;2018-19;2018;2018;22;14;8;169;78;91;35;15;20;;;;;h1GZ3
489;École doctorale Sciences et ingénierie des systèmes, de l'environnement et des organisations;SISEO;3;Sciences de la terre et de l'univers, espace;2019;2018-19;2018;2018;1;1;0;8;4;4;0;0;0;;;;;6pT77
497;École doctorale Normande de Biologie Intégrative, Santé, Environnement;Ed NBISE;3;Sciences de la terre et de l'univers, espace;2019;2018-19;2018;2018;1;0;1;13;4;9;8;3;5;;;;;0D9Je
497;École doctorale Normande de Biologie Intégrative, Santé, Environnement;Ed NBISE;5;Biologie, médecine et santé;2019;2018-19;2018;2018;58;25;33;243;135;108;63;32;31;;;;;0D9Je
497;École doctorale Normande de Biologie Intégrative, Santé, Environnement;Ed NBISE;9;Sciences et technologies de l'information et de la communication;2019;2018-19;2018;2018;2;0;2;4;2;2;1;0;1;;;;;0D9Je
497;École doctorale Normande de Biologie Intégrative, Santé, Environnement;Ed NBISE;10;Sciences agronomiques et écologiques;2019;2018-19;2018;2018;17;8;9;54;24;30;13;6;7;;;;;0D9Je
514;École doctorale Études anglophones, germanophones et européennes;EDEAGE;6;Sciences humaines et humanités;2019;2018-19;2018;2018;17;9;8;138;102;36;15;12;3;;;;;fuIQs
519;École doctorale Sciences humaines et sociales - Perspectives européennes;SHS-PE;7;Sciences de la société;2019;2018-19;2018;2018;15;4;11;93;50;43;21;13;8;;;;;2f5qs
520;École doctorale Humanités;;6;Sciences humaines et humanités;2019;2018-19;2018;2018;54;35;19;279;171;108;48;34;14;;;;;rI175
523;École doctorale Sciences pour l'environnement - Gay Lussac;;10;Sciences agronomiques et écologiques;2019;2018-19;2018;2018;0;0;0;0;0;0;11;1;10;;;;;6xD69
526;École doctorale Sociétés et organisations;SORG;7;Sciences de la société;2019;2018-19;2018;2018;0;0;0;0;0;0;14;11;3;;;;;5F3Fd
529;École doctorale Cultures et sociétés;CS;6;Sciences humaines et humanités;2019;2018-19;2018;2018;55;22;33;228;112;116;28;17;11;;;;;XU9tb
530;École doctorale Organisations, marchés, institutions;OMI;5;Biologie, médecine et santé;2019;2018-19;2018;2018;0;0;0;3;1;2;1;1;0;;;;;4htv7
530;École doctorale Organisations, marchés, institutions;OMI;6;Sciences humaines et humanités;2019;2018-19;2018;2018;27;12;15;126;57;69;11;6;5;;;;;4htv7
530;École doctorale Organisations, marchés, institutions;OMI;9;Sciences et technologies de l'information et de la communication;2019;2018-19;2018;2018;5;5;0;5;5;0;1;1;0;;;;;4htv7
536;École doctorale Sciences et agrosciences;;3;Sciences de la terre et de l'univers, espace;2019;2018-19;2018;2018;6;5;1;19;12;7;3;0;3;;;;;pHfqe
536;École doctorale Sciences et agrosciences;;5;Biologie, médecine et santé;2019;2018-19;2018;2018;1;1;0;6;5;1;2;1;1;;;;;pHfqe
540;"École doctorale École transdisciplinaire ""lettres/sciences""";;7;Sciences de la société;2019;2018-19;2018;2018;3;2;1;9;5;4;0;0;0;;;;;tWWw7
540;"École doctorale École transdisciplinaire ""lettres/sciences""";;8;Sciences pour l'ingénieur;2019;2018-19;2018;2018;1;1;0;2;2;0;1;0;1;;;;;tWWw7
540;"École doctorale École transdisciplinaire ""lettres/sciences""";;9;Sciences et technologies de l'information et de la communication;2019;2018-19;2018;2018;2;0;2;6;2;4;0;0;0;;;;;tWWw7
542;École doctorale de sciences de La Réunion;STS;1;Mathématiques et leurs interactions;2019;2018-19;2018;2018;0;0;0;2;1;1;0;0;0;;;;;2pAql
542;École doctorale de sciences de La Réunion;STS;9;Sciences et technologies de l'information et de la communication;2019;2018-19;2018;2018;2;0;2;5;2;3;0;0;0;;;;;2pAql
548;École doctorale Mer et Sciences;;2;Physique;2019;2018-19;2018;2018;1;0;1;4;1;3;1;0;1;;;;;QX0fS
548;École doctorale Mer et Sciences;;5;Biologie, médecine et santé;2019;2018-19;2018;2018;2;1;1;6;2;4;2;0;2;;;;;QX0fS
548;École doctorale Mer et Sciences;;8;Sciences pour l'ingénieur;2019;2018-19;2018;2018;1;1;0;5;2;3;3;1;2;;;;;QX0fS
549;École doctorale Santé, Sciences Biologiques et Chimie du Vivant;SSBCV;6;Sciences humaines et humanités;2019;2018-19;2018;2018;4;3;1;9;6;3;3;1;2;;;;;B9ggO
549;École doctorale Santé, Sciences Biologiques et Chimie du Vivant;SSBCV;10;Sciences agronomiques et écologiques;2019;2018-19;2018;2018;2;0;2;7;2;5;4;3;1;;;;;B9ggO
552;École doctorale Énergie - Matériaux - Sciences de la Terre et de l'Univers;EMTSU;9;Sciences et technologies de l'information et de la communication;2019;2018-19;2018;2018;0;0;0;3;1;2;1;0;1;;;;;NTZhw
553;École doctorale Carnot - Pasteur;;3;Sciences de la terre et de l'univers, espace;2019;2018-19;2018;2018;2;1;1;4;1;3;1;0;1;;;;;6h4Z7
554;École doctorale Environnements - Santé;E-S;3;Sciences de la terre et de l'univers, espace;2019;2018-19;2018;2018;5;3;2;19;7;12;2;1;1;;;;;ElyFU
554;École doctorale Environnements - Santé;E-S;5;Biologie, médecine et santé;2019;2018-19;2018;2018;53;24;29;209;109;100;39;23;16;;;;;ElyFU
555;École doctorale Sciences de l'Homme et de la Société;SHS;7;Sciences de la société;2019;2018-19;2018;2018;25;5;20;114;40;74;12;5;7;;;;;44G6m
558;École doctorale Histoire, Mémoire, Patrimoine, Langage;HMPL;6;Sciences humaines et humanités;2019;2018-19;2018;2018;57;28;29;326;169;157;54;27;27;;;;;uX3jT
560;École doctorale Sciences de la terre et de l'environnement et Physique de l'univers, Paris;STEP'UP;3;Sciences de la terre et de l'univers, espace;2019;2018-19;2018;2018;55;27;28;182;76;106;42;18;24;;;;;Z2VI9
570;École doctorale Santé Publique;EDSP;6;Sciences humaines et humanités;2019;2018-19;2018;2018;2;1;1;7;5;2;1;1;0;;;;;9lgE4
573;École doctorale Interfaces : Approches Interdisciplinaires, Fondements, Applications et Innovation;ED INTERFACES;7;Sciences de la société;2019;2018-19;2018;2018;0;0;0;1;0;1;0;0;0;;;;;gG820
575;École doctorale Electrical, Optical, Bio : Physics and Engineering;EOBE;2;Physique;2019;2018-19;2018;2018;26;16;10;120;51;69;37;14;23;;;;;dfhyn
576;École doctorale Particules, Hadrons, Énergie, Noyau, Instrumentation, Imagerie, Cosmos et Simulation;PHENIICS;1;Mathématiques et leurs interactions;2019;2018-19;2018;2018;0;0;0;2;0;2;1;0;1;;;;;qC4rf
576;École doctorale Particules, Hadrons, Énergie, Noyau, Instrumentation, Imagerie, Cosmos et Simulation;PHENIICS;4;Chimie;2019;2018-19;2018;2018;1;1;0;6;2;4;1;0;1;;;;;qC4rf
576;École doctorale Particules, Hadrons, Énergie, Noyau, Instrumentation, Imagerie, Cosmos et Simulation;PHENIICS;8;Sciences pour l'ingénieur;2019;2018-19;2018;2018;2;0;2;7;2;5;3;1;2;;;;;qC4rf
578;École doctorale Sciences de l'Homme et de la Société;ED SHS;5;Biologie, médecine et santé;2019;2018-19;2018;2018;0;0;0;1;1;0;0;0;0;;;;;Ud43O
578;École doctorale Sciences de l'Homme et de la Société;ED SHS;6;Sciences humaines et humanités;2019;2018-19;2018;2018;38;17;21;174;88;86;24;13;11;;;;;Ud43O
579;École doctorale Sciences mécaniques et energétiques, matériaux et géosciences;SMEMaG;4;Chimie;2019;2018-19;2018;2018;0;0;0;8;2;6;3;0;3;;;;;atMj7
581;École doctorale Agriculture, alimentation, biologie, environnement, santé;ABIES;7;Sciences de la société;2019;2018-19;2018;2018;15;9;6;75;41;34;18;7;11;;;;;c1x56
582;École doctorale Cancérologie, Biologie, Médecine, Santé;CBMS;5;Biologie, médecine et santé;2019;2018-19;2018;2018;51;22;29;230;135;95;50;31;19;;;;;75bj4
583;École doctorale Risques et Société;;4;Chimie;2019;2018-19;2018;2018;3;2;1;6;4;2;0;0;0;;;;;wUBi9
583;École doctorale Risques et Société;;5;Biologie, médecine et santé;2019;2018-19;2018;2018;1;1;0;1;1;0;0;0;0;;;;;wUBi9
583;École doctorale Risques et Société;;6;Sciences humaines et humanités;2019;2018-19;2018;2018;3;2;1;8;5;3;1;0;1;;;;;wUBi9
583;École doctorale Risques et Société;;8;Sciences pour l'ingénieur;2019;2018-19;2018;2018;4;0;4;6;1;5;1;0;1;;;;;wUBi9
585;École doctorale Sciences, Technologie,  Sante;EDSTS;4;Chimie;2019;2018-19;2018;2018;11;5;6;44;20;24;8;3;5;;;;;NM3Dl
585;École doctorale Sciences, Technologie,  Sante;EDSTS;8;Sciences pour l'ingénieur;2019;2018-19;2018;2018;6;4;2;33;13;20;8;5;3;;;;;NM3Dl
585;École doctorale Sciences, Technologie,  Sante;EDSTS;9;Sciences et technologies de l'information et de la communication;2019;2018-19;2018;2018;5;2;3;24;4;20;4;1;3;;;;;NM3Dl
587;École doctorale Diversites, santé et développement en Amazonie;;6;Sciences humaines et humanités;2019;2018-19;2018;2018;2;1;1;14;9;5;1;1;0;;;;;V14tj
587;École doctorale Diversites, santé et développement en Amazonie;;9;Sciences et technologies de l'information et de la communication;2019;2018-19;2018;2018;2;0;2;4;0;4;0;0;0;;;;;V14tj
589;École doctorale Milieu insulaire tropical à risques : protection, valorisation , santé et développement;;4;Chimie;2019;2018-19;2018;2018;3;1;2;4;2;2;1;0;1;;;;;2cqi3
589;École doctorale Milieu insulaire tropical à risques : protection, valorisation , santé et développement;;5;Biologie, médecine et santé;2019;2018-19;2018;2018;13;9;4;44;27;17;9;5;4;;;;;2cqi3
591;École doctorale Physique, Sciences de l'Ingenieur, Materiaux, Énergie;PSIME;2;Physique;2019;2018-19;2018;2018;24;7;17;90;27;63;32;5;27;;;;;Hn5Om
591;École doctorale Physique, Sciences de l'Ingenieur, Materiaux, Énergie;PSIME;3;Sciences de la terre et de l'univers, espace;2019;2018-19;2018;2018;2;1;1;6;2;4;3;2;1;;;;;Hn5Om
591;École doctorale Physique, Sciences de l'Ingenieur, Materiaux, Énergie;PSIME;4;Chimie;2019;2018-19;2018;2018;7;3;4;23;11;12;9;3;6;;;;;Hn5Om
591;École doctorale Physique, Sciences de l'Ingenieur, Materiaux, Énergie;PSIME;8;Sciences pour l'ingénieur;2019;2018-19;2018;2018;39;12;27;151;44;107;50;15;35;;;;;Hn5Om
591;École doctorale Physique, Sciences de l'Ingenieur, Materiaux, Énergie;PSIME;9;Sciences et technologies de l'information et de la communication;2019;2018-19;2018;2018;0;0;0;6;2;4;0;0;0;;;;;Hn5Om
592;École doctorale Lettres, Communication, Langues, Arts;LECLA;6;Sciences humaines et humanités;2019;2018-19;2018;2018;42;24;18;205;128;77;30;18;12;;;;;sY7f3
593;École doctorale Droit, Gestion, sciences Économiques et Politique;DGEP;7;Sciences de la société;2019;2018-19;2018;2018;49;14;35;242;95;147;31;13;18;;;;;41pAm
594;École doctorale Sociétés, Espaces, Pratiques, Temps;ED SEPT;7;Sciences de la société;2019;2018-19;2018;2018;11;5;6;68;36;32;8;6;2;;;;;N85H3
596;École doctorale Matière, Molécules et Matériaux;ED 3M;2;Physique;2019;2018-19;2018;2018;29;11;18;142;50;92;36;11;25;;;;;77947
596;École doctorale Matière, Molécules et Matériaux;ED 3M;4;Chimie;2019;2018-19;2018;2018;87;34;53;277;127;150;68;26;42;;;;;77947
598;École doctorale Sciences de La Mer et du Littoral;SML;4;Chimie;2019;2018-19;2018;2018;1;0;1;3;1;2;1;1;0;;;;;Smen6
598;École doctorale Sciences de La Mer et du Littoral;SML;6;Sciences humaines et humanités;2019;2018-19;2018;2018;2;2;0;24;16;8;10;3;7;;;;;Smen6
598;École doctorale Sciences de La Mer et du Littoral;SML;8;Sciences pour l'ingénieur;2019;2018-19;2018;2018;7;1;6;26;8;18;4;1;3;;;;;Smen6
600;École doctorale Écologie, Géosciences, Agronomie et Alimentation;EGAAL;4;Chimie;2019;2018-19;2018;2018;2;1;1;6;4;2;1;1;0;;;;;urS33
600;École doctorale Écologie, Géosciences, Agronomie et Alimentation;EGAAL;5;Biologie, médecine et santé;2019;2018-19;2018;2018;4;3;1;31;16;15;13;6;7;;;;;urS33
601;École doctorale Mathématiques et Sciences et Technologies de l'information et de la Communication;MathSTIC;6;Sciences humaines et humanités;2019;2018-19;2018;2018;3;1;2;4;1;3;1;1;0;;;;;3Ue20
604;École doctorale Sociétés, Temps, Territoires;STT;7;Sciences de la société;2019;2018-19;2018;2018;16;7;9;87;43;44;14;8;6;;;;;SZI5T
604;École doctorale Sociétés, Temps, Territoires;STT;9;Sciences et technologies de l'information et de la communication;2019;2018-19;2018;2018;2;0;2;3;0;3;0;0;0;;;;;SZI5T
606;École doctorale Chimie - Mécanique - Matériaux - Physique;C2MP;4;Chimie;2019;2018-19;2018;2018;27;17;10;89;44;45;12;4;8;;;;;UkNR2
609;École doctorale Sciences et Ingénierie des Matériaux, Mécanique, Énergétique -;SIMME;8;Sciences pour l'ingénieur;2019;2018-19;2018;2018;44;11;33;173;43;130;0;0;0;;;;;N4Rjy
614;École doctorale Chimie, Écologie, Géosciences, Agrosciences - Théodore Monod;CEGA;10;Sciences agronomiques et écologiques;2019;2018-19;2018;2018;3;2;1;14;7;7;0;0;0;;;;;uc10I
616;École doctorale Humanités et Langues;H&L;6;Sciences humaines et humanités;2019;2018-19;2018;2018;61;32;29;269;155;114;29;19;10;;;;;FYOlf
618;École doctorale EUCLIDE;;4;Chimie;2019;2018-19;2018;2018;3;1;2;19;7;12;2;0;2;;;;;qveTN
618;École doctorale EUCLIDE;;6;Sciences humaines et humanités;2019;2018-19;2018;2018;4;3;1;34;18;16;6;3;3;;;;;qveTN
618;École doctorale EUCLIDE;;8;Sciences pour l'ingénieur;2019;2018-19;2018;2018;7;1;6;41;10;31;10;3;7;;;;;qveTN
619;École doctorale Sciences Fondamentales et Santé;SFS;1;Mathématiques et leurs interactions;2019;2018-19;2018;2018;2;1;1;5;2;3;0;0;0;;;;;JiZVW
619;École doctorale Sciences Fondamentales et Santé;SFS;2;Physique;2019;2018-19;2018;2018;2;1;1;8;4;4;3;1;2;;;;;JiZVW
619;École doctorale Sciences Fondamentales et Santé;SFS;3;Sciences de la terre et de l'univers, espace;2019;2018-19;2018;2018;1;0;1;3;1;2;0;0;0;;;;;JiZVW
620;École doctorale Sciences du Numérique et de l'Ingénieur;SNI;2;Physique;2019;2018-19;2018;2018;0;0;0;11;6;5;3;2;1;;;;;Dr40w
7;École doctorale Georges Vedel - Droit public interne, science administrative et science politique;;7;Sciences de la société;2020;2019-20;2019;2019;32;11;21;165;64;101;24;9;15;;;;;Dw881
22;École doctorale Mondes anciens et médiévaux;;6;Sciences humaines et humanités;2020;2019-20;2019;2019;42;21;21;175;94;81;24;16;8;;;;;fqCbl
34;École doctorale Matériaux;;4;Chimie;2020;2019-20;2019;2019;9;5;4;27;15;12;6;3;3;;;;;1Iufh
40;École doctorale Sciences chimiques;EDSC;9;Sciences et technologies de l'information et de la communication;2020;2019-20;2019;2019;0;0;0;1;0;1;0;0;0;;;;;wde3D
41;École doctorale Droit;;7;Sciences de la société;2020;2019-20;2019;2019;62;29;33;322;155;167;37;21;16;;;;;KnOQK
47;École doctorale Physique;;3;Sciences de la terre et de l'univers, espace;2020;2019-20;2019;2019;3;0;3;7;2;5;1;0;1;;;;;8kNpd
47;École doctorale Physique;;5;Biologie, médecine et santé;2020;2019-20;2019;2019;3;0;3;8;2;6;0;0;0;;;;;8kNpd
60;École doctorale Territoires, temps, sociétés et développement;TTSD;10;Sciences agronomiques et écologiques;2020;2019-20;2019;2019;0;0;0;2;1;1;2;1;1;;;;;fkIh6
62;École doctorale Sciences de la vie et de la santé;;1;Mathématiques et leurs interactions;2020;2019-20;2019;2019;1;1;0;2;1;1;0;0;0;;;;;vZzE7
70;École doctorale Sciences pour l'ingénieur;EDSPI;9;Sciences et technologies de l'information et de la communication;2020;2019-20;2019;2019;22;0;22;53;17;36;5;1;4;;;;;G413P
71;École doctorale Sciences pour l'ingénieur;;8;Sciences pour l'ingénieur;2020;2019-20;2019;2019;37;16;21;158;61;97;49;18;31;;;;;H6UYp
77;École doctorale Informatique, automatique, électronique, électrotechnique, mathématiques;IAEM;8;Sciences pour l'ingénieur;2020;2019-20;2019;2019;6;0;6;26;1;25;8;1;7;;;;;TCHTA
84;École doctorale Sciences et technologies de l'information et de la communication;STIC;1;Mathématiques et leurs interactions;2020;2019-20;2019;2019;0;0;0;0;0;0;1;1;0;;;;;9wS2W
85;École doctorale Sciences de la vie et de la santé;SVS;5;Biologie, médecine et santé;2020;2019-20;2019;2019;49;32;17;184;118;66;66;43;23;;;;;YdiMF
101;École doctorale de Sciences juridiques;;6;Sciences humaines et humanités;2020;2019-20;2019;2019;0;0;0;1;1;0;0;0;0;;;;;569G2
101;École doctorale de Sciences juridiques;;7;Sciences de la société;2020;2019-20;2019;2019;26;12;14;193;93;100;23;14;9;;;;;569G2
104;École doctorale Sciences de la matière, du rayonnement et de l'environnement;SMRE;4;Chimie;2020;2019-20;2019;2019;54;22;32;200;94;106;73;25;48;;;;;Q5iFz
105;École doctorale Terre, univers, environnement;;3;Sciences de la terre et de l'univers, espace;2020;2019-20;2019;2019;53;24;29;164;65;99;36;17;19;;;;;lcWAf
113;École doctorale Histoire;;6;Sciences humaines et humanités;2020;2019-20;2019;2019;54;21;33;289;146;143;33;14;19;;;;;G5wHs
124;École doctorale Histoire de l'art et archéologie;;6;Sciences humaines et humanités;2020;2019-20;2019;2019;26;14;12;142;96;46;22;11;11;;;;;MBN4L
129;École doctorale Sciences de l'environnement d'Ile de France;SEIF;2;Physique;2020;2019-20;2019;2019;3;1;2;3;1;2;1;1;0;;;;;TnAPh
129;École doctorale Sciences de l'environnement d'Ile de France;SEIF;3;Sciences de la terre et de l'univers, espace;2020;2019-20;2019;2019;50;31;19;173;88;85;39;23;16;;;;;TnAPh
131;École doctorale Langue, littérature, image, civilisations et sciences humaines (domaines francophone et anglophone);LLI;6;Sciences humaines et humanités;2020;2019-20;2019;2019;27;16;11;139;93;46;26;16;10;;;;;a47aW
146;École doctorale Galilée;GALILEE;2;Physique;2020;2019-20;2019;2019;6;2;4;20;7;13;5;0;5;;;;;71hqm
160;École doctorale Électronique, électrotechnique, automatique;EEA;5;Biologie, médecine et santé;2020;2019-20;2019;2019;2;1;1;8;6;2;2;0;2;;;;;EgfMQ
166;École doctorale Information, structures et systèmes;I2S;2;Physique;2020;2019-20;2019;2019;20;4;16;67;20;47;13;2;11;;;;;2uO68
166;École doctorale Information, structures et systèmes;I2S;7;Sciences de la société;2020;2019-20;2019;2019;0;0;0;2;1;1;1;0;1;;;;;2uO68
168;École doctorale Sciences chimiques et biologiques pour la santé;SCBS;5;Biologie, médecine et santé;2020;2019-20;2019;2019;108;60;48;397;223;174;90;49;41;;;;;8cEME
180;École doctorale Sciences humaines et sociales : cultures, individus, sociétés;SHS;6;Sciences humaines et humanités;2020;2019-20;2019;2019;0;0;0;0;0;0;1;1;0;;;;;D2BT3
184;École doctorale Mathématiques et informatique de Marseille;;9;Sciences et technologies de l'information et de la communication;2020;2019-20;2019;2019;8;1;7;29;8;21;11;5;6;;;;;DDObG
184;École doctorale Mathématiques et informatique de Marseille;;2;Physique;2020;2019-20;2019;2019;0;0;0;1;0;1;0;0;0;;;;;DDObG
184;École doctorale Mathématiques et informatique de Marseille;;5;Biologie, médecine et santé;2020;2019-20;2019;2019;0;0;0;1;0;1;0;0;0;;;;;DDObG
216;École doctorale Ingénierie pour la santé, la cognition, l'environnement;EDISCE;6;Sciences humaines et humanités;2020;2019-20;2019;2019;10;6;4;49;32;17;10;6;4;;;;;fPs1t
216;École doctorale Ingénierie pour la santé, la cognition, l'environnement;EDISCE;7;Sciences de la société;2020;2019-20;2019;2019;0;0;0;2;2;0;1;1;0;;;;;fPs1t
217;École doctorale Mathématiques, sciences et technologies de l'information, informatique;MSTII;1;Mathématiques et leurs interactions;2020;2019-20;2019;2019;25;4;21;85;16;69;21;2;19;;;;;Ehx7v
220;École doctorale Électronique, électrotechnique, automatique, traitement du signal;EEATS;8;Sciences pour l'ingénieur;2020;2019-20;2019;2019;51;10;41;200;43;157;73;19;54;;;;;IxEaw
221;École doctorale Augustin Cournot - Sciences économiques et de gestion - Sciences, technologies et sociétés;EDAC;6;Sciences humaines et humanités;2020;2019-20;2019;2019;0;0;0;0;0;0;2;1;1;;;;;5z9rW
221;École doctorale Augustin Cournot - Sciences économiques et de gestion - Sciences, technologies et sociétés;EDAC;5;Biologie, médecine et santé;2020;2019-20;2019;2019;0;0;0;1;0;1;0;0;0;;;;;5z9rW
224;École doctorale Cognition, langage, interaction;;6;Sciences humaines et humanités;2020;2019-20;2019;2019;35;18;17;151;95;56;21;16;5;;;;;7v43e
227;École doctorale Sciences de la nature et de l'homme;;7;Sciences de la société;2020;2019-20;2019;2019;0;0;0;1;1;0;0;0;0;;;;;xiDA5
245;École doctorale Sciences économiques, juridiques, politiques et de gestion;;7;Sciences de la société;2020;2019-20;2019;2019;39;11;28;179;67;112;33;15;18;;;;;ShLUg
251;École doctorale Sciences de l'environnement;;8;Sciences pour l'ingénieur;2020;2019-20;2019;2019;4;3;1;14;9;5;7;4;3;;;;;VR28y
261;École doctorale Cognition, comportements, conduites humaines;3CH;6;Sciences humaines et humanités;2020;2019-20;2019;2019;43;31;12;144;103;41;28;20;8;;;;;KOLCy
265;École doctorale Langues, littératures et sociétés du monde;;6;Sciences humaines et humanités;2020;2019-20;2019;2019;56;29;27;282;173;109;38;20;18;;;;;4YWGW
267;École doctorale Arts et médias;;6;Sciences humaines et humanités;2020;2019-20;2019;2019;40;22;18;211;135;76;40;27;13;;;;;eCF5C
269;École doctorale Mathématiques, sciences de l'information et de l'ingénieur;MSII;5;Biologie, médecine et santé;2020;2019-20;2019;2019;1;1;0;9;2;7;3;3;0;;;;;5E625
279;École doctorale Arts plastiques, esthétique et sciences de l'art;APESA;6;Sciences humaines et humanités;2020;2019-20;2019;2019;25;16;9;174;115;59;19;13;6;;;;;BpW1j
286;École doctorale de l'Ehess;;7;Sciences de la société;2020;2019-20;2019;2019;125;73;52;885;509;376;129;79;50;;;;;2S146
304;École doctorale Sciences et environnements;;7;Sciences de la société;2020;2019-20;2019;2019;4;4;0;7;7;0;3;1;2;;;;;2ywZn
305;École doctorale Énergie et environnement;E2;9;Sciences et technologies de l'information et de la communication;2020;2019-20;2019;2019;1;0;1;4;2;2;0;0;0;;;;;Kbt8I
326;École doctorale Comportement, langage, éducation, socialisation, cognition;CLESCO;8;Sciences pour l'ingénieur;2020;2019-20;2019;2019;1;0;1;1;0;1;0;0;0;;;;;nWIlG
327;École doctorale Temps, espaces, sociétés, cultures;TESC;10;Sciences agronomiques et écologiques;2020;2019-20;2019;2019;3;3;0;7;5;2;1;0;1;;;;;IjgiJ
355;École doctorale Espaces, cultures, sociétés;;6;Sciences humaines et humanités;2020;2019-20;2019;2019;41;18;23;188;100;88;30;15;15;;;;;2kMf5
356;École doctorale Cognition, langage, éducation;;9;Sciences et technologies de l'information et de la communication;2020;2019-20;2019;2019;7;3;4;20;11;9;5;4;1;;;;;55Cpz
370;École doctorale Lettres, sciences humaines et sociales;LSHS;6;Sciences humaines et humanités;2020;2019-20;2019;2019;37;19;18;190;103;87;34;20;14;;;;;xAXXx
377;École doctorale Environnement et société;;9;Sciences et technologies de l'information et de la communication;2020;2019-20;2019;2019;1;0;1;8;0;8;1;0;1;;;;;ZMG5u
391;École doctorale Sciences mécaniques, acoustique et électronique et robotique de Paris;SMAER;8;Sciences pour l'ingénieur;2020;2019-20;2019;2019;51;17;34;204;53;151;52;8;44;;;;;k0eue
393;École doctorale Pierre Louis de Santé Publique : Épidémiologie et Sciences de l'information biomédicale;PLSP;5;Biologie, médecine et santé;2020;2019-20;2019;2019;59;31;28;233;133;100;55;25;30;;;;;69445
401;École doctorale Sciences sociales;;7;Sciences de la société;2020;2019-20;2019;2019;30;13;17;173;92;81;23;16;7;;;;;raQ7K
405;École doctorale Économie, management,mathématiques et physique de Cergy;EM2C;7;Sciences de la société;2020;2019-20;2019;2019;17;6;11;73;31;42;16;7;9;;;;;QbwSB
414;École doctorale Sciences de la vie et de la santé;;4;Chimie;2020;2019-20;2019;2019;1;1;0;1;1;0;0;0;0;;;;;YI4xS
417;École doctorale Sciences et Ingénierie;S&I;8;Sciences pour l'ingénieur;2020;2019-20;2019;2019;8;2;6;54;22;32;9;3;6;;;;;SSBvE
432;École doctorale Sciences des métiers de l'ingénieur;SMI;8;Sciences pour l'ingénieur;2020;2019-20;2019;2019;109;37;72;385;107;278;74;13;61;;;;;nSsHB
441;École doctorale Histoire de l'art;;6;Sciences humaines et humanités;2020;2019-20;2019;2019;35;29;6;178;137;41;23;18;5;;;;;d5W3U
446;École doctorale Biologie - Santé;EDBSL;8;Sciences pour l'ingénieur;2020;2019-20;2019;2019;0;0;0;1;1;0;2;1;1;;;;;4iEUF
454;École doctorale Sciences de l'homme, du politique et du territoire;SHPT;7;Sciences de la société;2020;2019-20;2019;2019;16;9;7;79;41;38;13;8;5;;;;;Opv31
459;École doctorale Sciences chimiques Balard;;4;Chimie;2020;2019-20;2019;2019;67;35;32;240;129;111;71;25;46;;;;;YFs2W
460;École doctorale Sciences juridiques;SJ;7;Sciences de la société;2020;2019-20;2019;2019;23;14;9;148;81;67;8;3;5;;;;;ZB5I5
463;École doctorale Sciences du mouvement humain;SMH;7;Sciences de la société;2020;2019-20;2019;2019;0;0;0;1;0;1;1;0;1;;;;;UbtlY
467;École doctorale Aéronautique, astronautique;AA;9;Sciences et technologies de l'information et de la communication;2020;2019-20;2019;2019;4;1;3;10;4;6;0;0;0;;;;;U7l45
469;École doctorale du Pacifique;EDP;3;Sciences de la terre et de l'univers, espace;2020;2019-20;2019;2019;1;1;0;3;3;0;0;0;0;;;;;t9Z2n
469;École doctorale du Pacifique;EDP;5;Biologie, médecine et santé;2020;2019-20;2019;2019;3;2;1;10;3;7;3;0;3;;;;;t9Z2n
469;École doctorale du Pacifique;EDP;1;Mathématiques et leurs interactions;2020;2019-20;2019;2019;1;0;1;1;0;1;0;0;0;;;;;t9Z2n
472;École doctorale de l'EPHE;;1;Mathématiques et leurs interactions;2020;2019-20;2019;2019;0;0;0;3;2;1;0;0;0;;;;;27zK4
472;École doctorale de l'EPHE;;4;Chimie;2020;2019-20;2019;2019;0;0;0;2;2;0;0;0;0;;;;;27zK4
474;École doctorale Interdisciplinaire européenne frontières du vivant;FDV;6;Sciences humaines et humanités;2020;2019-20;2019;2019;4;4;0;4;4;0;2;2;0;;;;;E727j
474;École doctorale Interdisciplinaire européenne frontières du vivant;FDV;10;Sciences agronomiques et écologiques;2020;2019-20;2019;2019;3;1;2;3;1;2;2;0;2;;;;;E727j
475;École doctorale Mathématiques, informatique, télécommunications de Toulouse;MITT;9;Sciences et technologies de l'information et de la communication;2020;2019-20;2019;2019;69;12;57;287;75;212;70;21;49;;;;;xcp2r
476;École doctorale Neurosciences et cognition;NSCO;5;Biologie, médecine et santé;2020;2019-20;2019;2019;27;16;11;143;86;57;28;18;10;;;;;B1H0x
479;École doctorale Sciences juridiques et politiques;;7;Sciences de la société;2020;2019-20;2019;2019;40;19;21;314;161;153;36;14;22;;;;;34mid
480;École doctorale Montaigne-humanités;;6;Sciences humaines et humanités;2020;2019-20;2019;2019;109;62;47;554;332;222;48;29;19;;;;;f3SeZ
481;École doctorale Sciences sociales et humanités;SSH;7;Sciences de la société;2020;2019-20;2019;2019;30;15;15;179;88;91;23;8;15;;;;;E3z5j
482;École doctorale Sciences de la matière;SDM;10;Sciences agronomiques et écologiques;2020;2019-20;2019;2019;1;1;0;3;2;1;0;0;0;;;;;kmeZ4
488;École doctorale Sciences, ingénierie, santé;SIS;1;Mathématiques et leurs interactions;2020;2019-20;2019;2019;2;0;2;18;5;13;2;0;2;;;;;Fy2lK
488;École doctorale Sciences, ingénierie, santé;SIS;2;Physique;2020;2019-20;2019;2019;1;0;1;6;3;3;0;0;0;;;;;Fy2lK
489;École doctorale Sciences et ingénierie des systèmes, de l'environnement et des organisations;SISEO;4;Chimie;2020;2019-20;2019;2019;6;3;3;13;7;6;3;0;3;;;;;6pT77
489;École doctorale Sciences et ingénierie des systèmes, de l'environnement et des organisations;SISEO;2;Physique;2020;2019-20;2019;2019;1;0;1;2;0;2;0;0;0;;;;;6pT77
493;École doctorale Erasme;;6;Sciences humaines et humanités;2020;2019-20;2019;2019;21;17;4;106;76;30;17;11;6;;;;;FPW4T
509;École doctorale Civilisations et sociétés euro-méditerranéennes et comparées;;7;Sciences de la société;2020;2019-20;2019;2019;19;10;9;128;49;79;10;1;9;;;;;9tbyG
519;École doctorale Sciences humaines et sociales - Perspectives européennes;SHS-PE;6;Sciences humaines et humanités;2020;2019-20;2019;2019;44;22;22;225;130;95;38;22;16;;;;;2f5qs
519;École doctorale Sciences humaines et sociales - Perspectives européennes;SHS-PE;9;Sciences et technologies de l'information et de la communication;2020;2019-20;2019;2019;2;0;2;7;1;6;1;0;1;;;;;2f5qs
529;École doctorale Cultures et sociétés;CS;6;Sciences humaines et humanités;2020;2019-20;2019;2019;51;32;19;224;118;106;21;12;9;;;;;XU9tb
530;École doctorale Organisations, marchés, institutions;OMI;1;Mathématiques et leurs interactions;2020;2019-20;2019;2019;0;0;0;1;1;0;0;0;0;;;;;4htv7
532;École doctorale Mathématiques et sciences et technologies de l'information et de la communication;MSTIC;3;Sciences de la terre et de l'univers, espace;2020;2019-20;2019;2019;0;0;0;8;3;5;3;0;3;;;;;t43KM
536;École doctorale Sciences et agrosciences;;1;Mathématiques et leurs interactions;2020;2019-20;2019;2019;2;1;1;5;3;2;1;1;0;;;;;pHfqe
536;École doctorale Sciences et agrosciences;;9;Sciences et technologies de l'information et de la communication;2020;2019-20;2019;2019;8;2;6;28;7;21;4;0;4;;;;;pHfqe
537;École doctorale Culture et patrimoine;C&P;7;Sciences de la société;2020;2019-20;2019;2019;4;3;1;17;11;6;3;1;2;;;;;GxI4a
540;"École doctorale École transdisciplinaire ""lettres/sciences""";;2;Physique;2020;2019-20;2019;2019;0;0;0;2;1;1;0;0;0;;;;;tWWw7
540;"École doctorale École transdisciplinaire ""lettres/sciences""";;9;Sciences et technologies de l'information et de la communication;2020;2019-20;2019;2019;2;1;1;6;2;4;0;0;0;;;;;tWWw7
540;"École doctorale École transdisciplinaire ""lettres/sciences""";;4;Chimie;2020;2019-20;2019;2019;0;0;0;2;0;2;0;0;0;;;;;tWWw7
541;École doctorale de sciences humaines et sociales de La Réunion;SHS;10;Sciences agronomiques et écologiques;2020;2019-20;2019;2019;0;0;0;1;0;1;0;0;0;;;;;21SpE
542;École doctorale de sciences de La Réunion;STS;1;Mathématiques et leurs interactions;2020;2019-20;2019;2019;0;0;0;3;1;2;2;1;1;;;;;2pAql
542;École doctorale de sciences de La Réunion;STS;2;Physique;2020;2019-20;2019;2019;2;0;2;19;5;14;8;1;7;;;;;2pAql
542;École doctorale de sciences de La Réunion;STS;10;Sciences agronomiques et écologiques;2020;2019-20;2019;2019;6;4;2;19;10;9;11;3;8;;;;;2pAql
543;École doctorale de Dauphine;;6;Sciences humaines et humanités;2020;2019-20;2019;2019;4;3;1;11;7;4;0;0;0;;;;;u8w6A
543;École doctorale de Dauphine;;7;Sciences de la société;2020;2019-20;2019;2019;58;36;22;263;125;138;51;24;27;;;;;u8w6A
545;École doctorale Sociétés, politique et santé publique;SP2;7;Sciences de la société;2020;2019-20;2019;2019;23;12;11;87;39;48;13;9;4;;;;;IAKR4
546;École doctorale Abbé Grégoire;;7;Sciences de la société;2020;2019-20;2019;2019;0;0;0;80;45;35;11;6;5;;;;;ZSn7q
549;École doctorale Santé, Sciences Biologiques et Chimie du Vivant;SSBCV;2;Physique;2020;2019-20;2019;2019;0;0;0;2;1;1;1;0;1;;;;;B9ggO
549;École doctorale Santé, Sciences Biologiques et Chimie du Vivant;SSBCV;4;Chimie;2020;2019-20;2019;2019;13;5;8;50;23;27;14;6;8;;;;;B9ggO
549;École doctorale Santé, Sciences Biologiques et Chimie du Vivant;SSBCV;6;Sciences humaines et humanités;2020;2019-20;2019;2019;0;0;0;8;5;3;0;0;0;;;;;B9ggO
551;École doctorale Mathématiques, Informatique, Physique Théorique et Ingénierie des Systèmes;MIPTIS;1;Mathématiques et leurs interactions;2020;2019-20;2019;2019;7;3;4;28;7;21;7;4;3;;;;;Mpudz
552;École doctorale Énergie - Matériaux - Sciences de la Terre et de l'Univers;EMTSU;9;Sciences et technologies de l'information et de la communication;2020;2019-20;2019;2019;7;1;6;10;1;9;1;1;0;;;;;NTZhw
553;École doctorale Carnot - Pasteur;;2;Physique;2020;2019-20;2019;2019;6;1;5;38;8;30;15;4;11;;;;;6h4Z7
553;École doctorale Carnot - Pasteur;;3;Sciences de la terre et de l'univers, espace;2020;2019-20;2019;2019;1;1;0;4;2;2;0;0;0;;;;;6h4Z7
554;École doctorale Environnements - Santé;E-S;3;Sciences de la terre et de l'univers, espace;2020;2019-20;2019;2019;6;1;5;21;7;14;3;0;3;;;;;ElyFU
554;École doctorale Environnements - Santé;E-S;9;Sciences et technologies de l'information et de la communication;2020;2019-20;2019;2019;0;0;0;0;0;0;1;0;1;;;;;ElyFU
563;École doctorale Médicament - Toxicologie - Chimie - Imageries;MTCI;4;Chimie;2020;2019-20;2019;2019;9;4;5;48;27;21;8;4;4;;;;;j8uk1
564;École doctorale Physique en Ile de France;PIF;2;Physique;2020;2019-20;2019;2019;193;40;153;639;132;507;157;35;122;;;;;39AcN
565;École doctorale Droit de la Sorbonne;DS;7;Sciences de la société;2020;2019-20;2019;2019;129;68;61;629;343;286;77;37;40;;;;;aXJ7L
566;École doctorale Sciences du Sport, de la Motricité et du Mouvement Humain;SMMH;5;Biologie, médecine et santé;2020;2019-20;2019;2019;18;6;12;62;23;39;15;7;8;;;;;3iv8y
566;École doctorale Sciences du Sport, de la Motricité et du Mouvement Humain;SMMH;7;Sciences de la société;2020;2019-20;2019;2019;1;0;1;2;0;2;1;0;1;;;;;3iv8y
567;École doctorale Sciences du Végétal : du gène à l'écosystème;;10;Sciences agronomiques et écologiques;2020;2019-20;2019;2019;12;5;7;40;20;20;8;5;3;;;;;tuDkA
570;École doctorale Santé Publique;EDSP;6;Sciences humaines et humanités;2020;2019-20;2019;2019;0;0;0;5;3;2;2;1;1;;;;;9lgE4
571;École doctorale Sciences Chimiques : Molécules, Matériaux, Instrumentation et Biosystemes;2MIB;2;Physique;2020;2019-20;2019;2019;4;1;3;17;5;12;3;1;2;;;;;zbi37
573;École doctorale Interfaces : Approches Interdisciplinaires, Fondements, Applications et Innovation;ED INTERFACES;10;Sciences agronomiques et écologiques;2020;2019-20;2019;2019;0;0;0;1;1;0;0;0;0;;;;;gG820
576;École doctorale Particules, Hadrons, Énergie, Noyau, Instrumentation, Imagerie, Cosmos et Simulation;PHENIICS;4;Chimie;2020;2019-20;2019;2019;5;2;3;8;4;4;2;0;2;;;;;qC4rf
578;École doctorale Sciences de l'Homme et de la Société;ED SHS;6;Sciences humaines et humanités;2020;2019-20;2019;2019;39;21;18;150;77;73;27;18;9;;;;;Ud43O
580;École doctorale Sciences et technologies de l'information et de la communication;STIC;8;Sciences pour l'ingénieur;2020;2019-20;2019;2019;3;0;3;17;2;15;4;2;2;;;;;AzCC0
580;École doctorale Sciences et technologies de l'information et de la communication;STIC;9;Sciences et technologies de l'information et de la communication;2020;2019-20;2019;2019;121;36;85;440;116;324;175;49;126;;;;;AzCC0
581;École doctorale Agriculture, alimentation, biologie, environnement, santé;ABIES;4;Chimie;2020;2019-20;2019;2019;3;2;1;13;7;6;3;2;1;;;;;c1x56
582;École doctorale Cancérologie, Biologie, Médecine, Santé;CBMS;1;Mathématiques et leurs interactions;2020;2019-20;2019;2019;1;0;1;1;0;1;0;0;0;;;;;75bj4
583;École doctorale Risques et Société;;1;Mathématiques et leurs interactions;2020;2019-20;2019;2019;0;0;0;1;0;1;0;0;0;;;;;wUBi9
585;École doctorale Sciences, Technologie,  Sante;EDSTS;1;Mathématiques et leurs interactions;2020;2019-20;2019;2019;8;5;3;22;11;11;7;2;5;;;;;NM3Dl
587;École doctorale Diversites, santé et développement en Amazonie;;3;Sciences de la terre et de l'univers, espace;2020;2019-20;2019;2019;0;0;0;1;1;0;2;2;0;;;;;V14tj
587;École doctorale Diversites, santé et développement en Amazonie;;4;Chimie;2020;2019-20;2019;2019;1;0;1;1;0;1;0;0;0;;;;;V14tj
589;École doctorale Milieu insulaire tropical à risques : protection, valorisation , santé et développement;;2;Physique;2020;2019-20;2019;2019;4;1;3;10;1;9;2;1;1;;;;;2cqi3
592;École doctorale Lettres, Communication, Langues, Arts;LECLA;6;Sciences humaines et humanités;2020;2019-20;2019;2019;54;30;24;208;125;83;25;16;9;;;;;sY7f3
594;École doctorale Sociétés, Espaces, Pratiques, Temps;ED SEPT;6;Sciences humaines et humanités;2020;2019-20;2019;2019;57;33;24;279;130;149;45;27;18;;;;;N85H3
596;École doctorale Matière, Molécules et Matériaux;ED 3M;4;Chimie;2020;2019-20;2019;2019;72;30;42;265;127;138;61;26;35;;;;;77947
598;École doctorale Sciences de La Mer et du Littoral;SML;4;Chimie;2020;2019-20;2019;2019;1;1;0;5;1;4;2;1;1;;;;;Smen6
598;École doctorale Sciences de La Mer et du Littoral;SML;5;Biologie, médecine et santé;2020;2019-20;2019;2019;10;6;4;47;28;19;12;10;2;;;;;Smen6
599;École doctorale Droit et Science Politique;DSP;6;Sciences humaines et humanités;2020;2019-20;2019;2019;0;0;0;2;0;2;2;1;1;;;;;6rwtT
599;École doctorale Droit et Science Politique;DSP;7;Sciences de la société;2020;2019-20;2019;2019;53;31;22;388;184;204;55;22;33;;;;;6rwtT
602;École doctorale Sciences pour l'Ingénieur;SPI;8;Sciences pour l'ingénieur;2020;2019-20;2019;2019;114;40;74;504;160;344;131;39;92;;;;;8yWbu
604;École doctorale Sociétés, Temps, Territoires;STT;10;Sciences agronomiques et écologiques;2020;2019-20;2019;2019;0;0;0;5;2;3;3;2;1;;;;;SZI5T
605;École doctorale Biologie Santé;ED BS;8;Sciences pour l'ingénieur;2020;2019-20;2019;2019;0;0;0;3;2;1;1;0;1;;;;;w8CxU
607;École doctorale Sciences et Ingénierie des Ressources Naturelles;SIReNA;5;Biologie, médecine et santé;2020;2019-20;2019;2019;4;2;2;8;5;3;1;1;0;;;;;vi9w2
607;École doctorale Sciences et Ingénierie des Ressources Naturelles;SIReNA;4;Chimie;2020;2019-20;2019;2019;2;0;2;2;0;2;0;0;0;;;;;vi9w2
608;École doctorale Sciences et Ingénierie des Molécules, des Produits, des Procédés et de l'Énergie;SIMPPÉ;8;Sciences pour l'ingénieur;2020;2019-20;2019;2019;62;28;34;175;61;114;33;13;20;;;;;TyNjM
608;École doctorale Sciences et Ingénierie des Molécules, des Produits, des Procédés et de l'Énergie;SIMPPÉ;10;Sciences agronomiques et écologiques;2020;2019-20;2019;2019;2;1;1;10;5;5;3;3;0;;;;;TyNjM
610;École doctorale Sciences et Ingénierie des Systèmes, Mathématiques, Informatique;SISMI;1;Mathématiques et leurs interactions;2020;2019-20;2019;2019;8;2;6;31;5;26;11;5;6;;;;;dBCUB
613;École doctorale Sciences de la Société, Territoires, Sciences Economiques et de Gestion;SSTSEG;7;Sciences de la société;2020;2019-20;2019;2019;26;15;11;118;56;62;16;10;6;;;;;6eLRF
614;École doctorale Chimie, Écologie, Géosciences, Agrosciences - Théodore Monod;CEGA;4;Chimie;2020;2019-20;2019;2019;13;7;6;63;31;32;17;5;12;;;;;uc10I
614;École doctorale Chimie, Écologie, Géosciences, Agrosciences - Théodore Monod;CEGA;8;Sciences pour l'ingénieur;2020;2019-20;2019;2019;0;0;0;0;0;0;1;1;0;;;;;uc10I
616;École doctorale Humanités et Langues;H&L;5;Biologie, médecine et santé;2020;2019-20;2019;2019;1;1;0;8;4;4;0;0;0;;;;;FYOlf
617;École doctorale Sciences de la Société : Territoires, Economie et Droit;SSTED;10;Sciences agronomiques et écologiques;2020;2019-20;2019;2019;0;0;0;1;0;1;0;0;0;;;;;Kl9ZX
618;École doctorale EUCLIDE;;1;Mathématiques et leurs interactions;2020;2019-20;2019;2019;4;2;2;4;2;2;2;0;2;;;;;qveTN
619;École doctorale Sciences Fondamentales et Santé;SFS;2;Physique;2020;2019-20;2019;2019;2;2;0;8;6;2;2;0;2;;;;;JiZVW
619;École doctorale Sciences Fondamentales et Santé;SFS;4;Chimie;2020;2019-20;2019;2019;6;1;5;21;7;14;4;1;3;;;;;JiZVW
621;École doctorale Ingénierie des Systèmes, Matériaux, Mécanique, Énergétique;ISMME;8;Sciences pour l'ingénieur;2020;2019-20;2019;2019;65;16;49;229;55;174;47;7;40;;;;;B2549
623;École doctorale Savoir, Sciences, Éducation;SSE;1;Mathématiques et leurs interactions;2020;2019-20;2019;2019;7;3;4;17;9;8;8;4;4;;;;;98lMD
623;École doctorale Savoir, Sciences, Éducation;SSE;2;Physique;2020;2019-20;2019;2019;1;0;1;8;4;4;1;1;0;;;;;98lMD
623;École doctorale Savoir, Sciences, Éducation;SSE;5;Biologie, médecine et santé;2020;2019-20;2019;2019;1;0;1;5;2;3;5;3;2;;;;;98lMD
626;École doctorale de l’Institut Polytechnique de Paris;;7;Sciences de la société;2020;2019-20;2019;2019;13;4;9;124;48;76;4;2;2;;;;;DL5fO
37;École doctorale Sciences physiques pour l'ingénieur et microtechniques;SPIM;8;Sciences pour l'ingénieur;2016;2015-16;2015;2015;49;13;36;203;46;157;41;8;33;;;;;F7G1B
39;École doctorale Mathématiques et Informatique;EDMIB;9;Sciences et technologies de l'information et de la communication;2016;2015-16;2015;2015;31;3;28;114;19;95;35;6;29;;;;;TBj2X
41;École doctorale Droit;;7;Sciences de la société;2016;2015-16;2015;2015;63;28;35;334;157;177;39;15;24;;;;;KnOQK
47;École doctorale Physique;;2;Physique;2016;2015-16;2015;2015;86;23;63;367;101;266;100;25;75;;;;;8kNpd
60;École doctorale Territoires, temps, sociétés et développement;TTSD;10;Sciences agronomiques et écologiques;2016;2015-16;2015;2015;8;3;5;14;8;6;2;2;0;;;;;fkIh6
62;École doctorale Sciences de la vie et de la santé;;5;Biologie, médecine et santé;2016;2015-16;2015;2015;191;110;81;671;393;278;137;77;60;;;;;vZzE7
67;École doctorale Sciences juridiques et politiques;;7;Sciences de la société;2016;2015-16;2015;2015;100;48;52;594;299;295;77;34;43;;;;;qrOj1
70;École doctorale Sciences pour l'ingénieur;EDSPI;9;Sciences et technologies de l'information et de la communication;2016;2015-16;2015;2015;44;11;33;160;35;125;40;8;32;;;;;G413P
71;École doctorale Sciences pour l'ingénieur;;8;Sciences pour l'ingénieur;2016;2015-16;2015;2015;46;16;30;203;78;125;61;23;38;;;;;H6UYp
71;École doctorale Sciences pour l'ingénieur;;9;Sciences et technologies de l'information et de la communication;2016;2015-16;2015;2015;18;7;11;75;20;55;15;5;10;;;;;H6UYp
72;École doctorale Sciences pour l'ingénieur;SPI;1;Mathématiques et leurs interactions;2016;2015-16;2015;2015;19;10;9;68;24;44;19;5;14;;;;;47QPx
77;École doctorale Informatique, automatique, électronique, électrotechnique, mathématiques;IAEM;8;Sciences pour l'ingénieur;2016;2015-16;2015;2015;7;1;6;24;4;20;3;1;2;;;;;TCHTA
77;École doctorale Informatique, automatique, électronique, électrotechnique, mathématiques;IAEM;9;Sciences et technologies de l'information et de la communication;2016;2015-16;2015;2015;51;15;36;223;62;161;56;11;45;;;;;TCHTA
84;École doctorale Sciences et technologies de l'information et de la communication;STIC;9;Sciences et technologies de l'information et de la communication;2016;2015-16;2015;2015;54;18;36;247;66;181;57;11;46;;;;;9wS2W
88;École doctorale Droit et science politique;DSP;7;Sciences de la société;2016;2015-16;2015;2015;73;26;47;328;136;192;31;14;17;;;;;elnAJ
112;École doctorale Archéologie;;6;Sciences humaines et humanités;2016;2015-16;2015;2015;32;16;16;265;167;98;37;20;17;;;;;EvU7R
122;École doctorale Europe latine - Amérique latine;;6;Sciences humaines et humanités;2016;2015-16;2015;2015;24;14;10;140;88;52;23;17;6;;;;;z9lZY
127;École doctorale Astronomie et astrophysique d'Ile de France;A&A;3;Sciences de la terre et de l'univers, espace;2016;2015-16;2015;2015;40;17;23;167;67;100;42;18;24;;;;;cPXrq
129;École doctorale Sciences de l'environnement d'Ile de France;SEIF;3;Sciences de la terre et de l'univers, espace;2016;2015-16;2015;2015;46;20;26;193;103;90;45;22;23;;;;;TnAPh
141;École doctorale Droit et science politique;DSP;7;Sciences de la société;2016;2015-16;2015;2015;75;33;42;296;136;160;15;7;8;;;;;CyNBf
156;École doctorale Sciences de la mer;;7;Sciences de la société;2016;2015-16;2015;2015;6;4;2;21;11;10;0;0;0;;;;;EGY9P
162;École doctorale Mécanique, énergétique, génie civil, acoustique;MEGA;8;Sciences pour l'ingénieur;2016;2015-16;2015;2015;107;26;81;432;101;331;96;20;76;;;;;7wCke
166;École doctorale Information, structures et systèmes;I2S;4;Chimie;2016;2015-16;2015;2015;3;3;0;5;4;1;0;0;0;;;;;2uO68
168;École doctorale Sciences chimiques et biologiques pour la santé;SCBS;4;Chimie;2016;2015-16;2015;2015;3;2;1;5;4;1;3;2;1;;;;;8cEME
173;École doctorale Sciences de l'univers, de l'environnement et de l'espace;SDU2E;8;Sciences pour l'ingénieur;2016;2015-16;2015;2015;6;1;5;20;5;15;4;1;3;;;;;R0Z9c
173;École doctorale Sciences de l'univers, de l'environnement et de l'espace;SDU2E;10;Sciences agronomiques et écologiques;2016;2015-16;2015;2015;8;4;4;33;19;14;10;4;6;;;;;R0Z9c
178;École doctorale Sciences fondamentales;;2;Physique;2016;2015-16;2015;2015;9;1;8;34;8;26;10;0;10;;;;;1AiR7
178;École doctorale Sciences fondamentales;;4;Chimie;2016;2015-16;2015;2015;17;7;10;54;26;28;21;9;12;;;;;1AiR7
181;École doctorale Structure, informations, matière et matériaux;Simem;3;Sciences de la terre et de l'univers, espace;2016;2015-16;2015;2015;3;2;1;5;2;3;1;1;0;;;;;c1D6f
181;École doctorale Structure, informations, matière et matériaux;Simem;4;Chimie;2016;2015-16;2015;2015;10;5;5;36;13;23;10;6;4;;;;;c1D6f
181;École doctorale Structure, informations, matière et matériaux;Simem;8;Sciences pour l'ingénieur;2016;2015-16;2015;2015;13;7;6;32;11;21;4;1;3;;;;;c1D6f
182;École doctorale Physique et chimie-physique;;4;Chimie;2016;2015-16;2015;2015;18;8;10;73;31;42;20;9;11;;;;;3My6I
184;École doctorale Mathématiques et informatique de Marseille;;9;Sciences et technologies de l'information et de la communication;2016;2015-16;2015;2015;8;4;4;32;16;16;12;2;10;;;;;DDObG
205;École doctorale Interdisciplinaire Sciences-Santé;EDISS;5;Biologie, médecine et santé;2016;2015-16;2015;2015;59;34;25;250;146;104;60;34;26;;;;;69W38
209;École doctorale Sciences physiques et de L'ingénieur;SPI;3;Sciences de la terre et de l'univers, espace;2016;2015-16;2015;2015;2;0;2;6;2;4;4;2;2;;;;;tZcIZ
216;École doctorale Ingénierie pour la santé, la cognition, l'environnement;EDISCE;5;Biologie, médecine et santé;2016;2015-16;2015;2015;25;7;18;136;50;86;21;11;10;;;;;fPs1t
218;École doctorale Chimie et sciences du vivant;EDCSV;5;Biologie, médecine et santé;2016;2015-16;2015;2015;44;28;16;219;132;87;50;21;29;;;;;8bcJh
227;École doctorale Sciences de la nature et de l'homme;;4;Chimie;2016;2015-16;2015;2015;2;1;1;5;4;1;1;0;1;;;;;xiDA5
227;École doctorale Sciences de la nature et de l'homme;;7;Sciences de la société;2016;2015-16;2015;2015;1;0;1;6;4;2;2;2;0;;;;;xiDA5
234;École doctorale de Sciences Po;;7;Sciences de la société;2016;2015-16;2015;2015;61;29;32;356;177;179;56;26;30;;;;;ux756
251;École doctorale Sciences de l'environnement;;4;Chimie;2016;2015-16;2015;2015;1;1;0;12;6;6;6;4;2;;;;;VR28y
251;École doctorale Sciences de l'environnement;;6;Sciences humaines et humanités;2016;2015-16;2015;2015;2;1;1;8;5;3;1;0;1;;;;;VR28y
251;École doctorale Sciences de l'environnement;;10;Sciences agronomiques et écologiques;2016;2015-16;2015;2015;4;2;2;40;27;13;9;7;2;;;;;VR28y
254;École doctorale Sciences de la matière;;3;Sciences de la terre et de l'univers, espace;2016;2015-16;2015;2015;15;6;9;56;21;35;16;4;12;;;;;365F2
260;École doctorale pluridisciplinaire;;7;Sciences de la société;2016;2015-16;2015;2015;0;0;0;0;0;0;7;5;2;;;;;sCk1f
261;École doctorale Cognition, comportements, conduites humaines;3CH;6;Sciences humaines et humanités;2016;2015-16;2015;2015;57;44;13;152;119;33;38;31;7;;;;;KOLCy
268;École doctorale Langage et langues : description, théorisation, transmission;;6;Sciences humaines et humanités;2016;2015-16;2015;2015;47;28;19;267;185;82;41;28;13;;;;;wAIDE
269;École doctorale Mathématiques, sciences de l'information et de l'ingénieur;MSII;1;Mathématiques et leurs interactions;2016;2015-16;2015;2015;9;0;9;44;10;34;19;1;18;;;;;5E625
279;École doctorale Arts plastiques, esthétique et sciences de l'art;APESA;6;Sciences humaines et humanités;2016;2015-16;2015;2015;48;32;16;244;163;81;39;28;11;;;;;BpW1j
284;École doctorale Droit et Science Politique;DSP;7;Sciences de la société;2016;2015-16;2015;2015;3;1;2;32;19;13;4;3;1;;;;;ahH92
285;École doctorale Sciences pratiques;;1;Mathématiques et leurs interactions;2016;2015-16;2015;2015;0;0;0;0;0;0;6;1;5;;;;;Jd3t2
287;École doctorale Sciences pour l'ingénieur;;8;Sciences pour l'ingénieur;2016;2015-16;2015;2015;0;0;0;0;0;0;27;10;17;;;;;48Q1j
288;École doctorale Ondes et matière;EDOM;2;Physique;2016;2015-16;2015;2015;0;0;0;0;0;0;16;3;13;;;;;kJrcx
304;École doctorale Sciences et environnements;;6;Sciences humaines et humanités;2016;2015-16;2015;2015;2;2;0;15;6;9;4;3;1;;;;;2ywZn
305;École doctorale Énergie et environnement;E2;3;Sciences de la terre et de l'univers, espace;2016;2015-16;2015;2015;3;1;2;13;6;7;4;3;1;;;;;Kbt8I
305;École doctorale Énergie et environnement;E2;5;Biologie, médecine et santé;2016;2015-16;2015;2015;7;5;2;24;14;10;4;3;1;;;;;Kbt8I
305;École doctorale Énergie et environnement;E2;9;Sciences et technologies de l'information et de la communication;2016;2015-16;2015;2015;0;0;0;12;4;8;2;0;2;;;;;Kbt8I
351;École doctorale Sciences physiques, mathématiques et de l'information pour l'ingénieur;SPMII;1;Mathématiques et leurs interactions;2016;2015-16;2015;2015;12;4;8;39;13;26;11;5;6;;;;;rY4EP
352;École doctorale Physique et sciences de la matière;;2;Physique;2016;2015-16;2015;2015;82;22;60;255;73;182;62;19;43;;;;;fb5YC
353;École doctorale Sciences pour l'ingénieur : mécanique, physique, micro et nanoélectronique;;2;Physique;2016;2015-16;2015;2015;10;1;9;11;2;9;0;0;0;;;;;vk5Kp
353;École doctorale Sciences pour l'ingénieur : mécanique, physique, micro et nanoélectronique;;5;Biologie, médecine et santé;2016;2015-16;2015;2015;2;1;1;5;2;3;1;0;1;;;;;vk5Kp
353;École doctorale Sciences pour l'ingénieur : mécanique, physique, micro et nanoélectronique;;8;Sciences pour l'ingénieur;2016;2015-16;2015;2015;34;2;32;116;19;97;42;9;33;;;;;vk5Kp
359;École doctorale Mathématiques, télécommunications, informatique, signal, systèmes, électronique;MATISSE;9;Sciences et technologies de l'information et de la communication;2016;2015-16;2015;2015;129;29;100;444;98;346;111;33;78;;;;;Y0r76
364;École doctorale Sciences fondamentales et appliquées;EDSFA;4;Chimie;2016;2015-16;2015;2015;13;8;5;33;21;12;13;8;5;;;;;E483q
364;École doctorale Sciences fondamentales et appliquées;EDSFA;8;Sciences pour l'ingénieur;2016;2015-16;2015;2015;15;3;12;63;17;46;15;4;11;;;;;E483q
364;École doctorale Sciences fondamentales et appliquées;EDSFA;10;Sciences agronomiques et écologiques;2016;2015-16;2015;2015;4;2;2;9;5;4;3;2;1;;;;;E483q
373;École doctorale Santé, information/communications et mathématiques, matière;SICMA;4;Chimie;2016;2015-16;2015;2015;3;0;3;13;4;9;3;1;2;;;;;hTJF5
373;École doctorale Santé, information/communications et mathématiques, matière;SICMA;5;Biologie, médecine et santé;2016;2015-16;2015;2015;20;10;10;78;33;45;14;9;5;;;;;hTJF5
386;École doctorale Sciences mathématiques de Paris centre;SMPC;1;Mathématiques et leurs interactions;2016;2015-16;2015;2015;139;24;115;485;100;385;116;31;85;;;;;wMj98
395;École doctorale Milieux, cultures et sociétés du passé et du présent;MCSPP;6;Sciences humaines et humanités;2016;2015-16;2015;2015;54;37;17;398;269;129;59;41;18;;;;;2quEb
396;École doctorale Économie, organisations, société;EOS;8;Sciences pour l'ingénieur;2016;2015-16;2015;2015;0;0;0;2;2;0;0;0;0;;;;;Es5e7
400;École doctorale Savoirs scientifiques : épistémologie, histoire des sciences, didactique des disciplines;;5;Biologie, médecine et santé;2016;2015-16;2015;2015;1;1;0;10;6;4;2;0;2;;;;;nRax3
400;École doctorale Savoirs scientifiques : épistémologie, histoire des sciences, didactique des disciplines;;6;Sciences humaines et humanités;2016;2015-16;2015;2015;1;0;1;7;3;4;1;1;0;;;;;nRax3
402;École doctorale Sciences de la vie et de la santé;SVS;2;Physique;2016;2015-16;2015;2015;0;0;0;1;0;1;0;0;0;;;;;YKgsU
402;École doctorale Sciences de la vie et de la santé;SVS;3;Sciences de la terre et de l'univers, espace;2016;2015-16;2015;2015;1;0;1;1;0;1;0;0;0;;;;;YKgsU
405;École doctorale Économie, management,mathématiques et physique de Cergy;EM2C;2;Physique;2016;2015-16;2015;2015;2;0;2;6;0;6;0;0;0;;;;;QbwSB
405;École doctorale Économie, management,mathématiques et physique de Cergy;EM2C;7;Sciences de la société;2016;2015-16;2015;2015;6;2;4;33;13;20;6;2;4;;;;;QbwSB
409;École doctorale Énergie, mécanique, matériaux;EMMA;2;Physique;2016;2015-16;2015;2015;5;0;5;21;5;16;7;4;3;;;;;KXlbK
409;École doctorale Énergie, mécanique, matériaux;EMMA;4;Chimie;2016;2015-16;2015;2015;29;6;23;107;33;74;24;6;18;;;;;KXlbK
410;École doctorale Sciences et ingénierie des ressources, procédés, produits, environnement;RP2E;8;Sciences pour l'ingénieur;2016;2015-16;2015;2015;28;16;12;129;59;70;51;19;32;;;;;Q5fxV
410;École doctorale Sciences et ingénierie des ressources, procédés, produits, environnement;RP2E;10;Sciences agronomiques et écologiques;2016;2015-16;2015;2015;25;16;9;108;63;45;36;20;16;;;;;Q5fxV
413;École doctorale Sciences de la terre et de l'environnement;STE;6;Sciences humaines et humanités;2016;2015-16;2015;2015;4;1;3;16;9;7;2;1;1;;;;;u9BA9
413;École doctorale Sciences de la terre et de l'environnement;STE;8;Sciences pour l'ingénieur;2016;2015-16;2015;2015;0;0;0;0;0;0;1;1;0;;;;;u9BA9
414;École doctorale Sciences de la vie et de la santé;;4;Chimie;2016;2015-16;2015;2015;3;3;0;3;3;0;1;0;1;;;;;YI4xS
414;École doctorale Sciences de la vie et de la santé;;7;Sciences de la société;2016;2015-16;2015;2015;0;0;0;1;1;0;0;0;0;;;;;YI4xS
417;École doctorale Sciences et Ingénierie;S&I;5;Biologie, médecine et santé;2016;2015-16;2015;2015;0;0;0;6;5;1;2;2;0;;;;;SSBvE
417;École doctorale Sciences et Ingénierie;S&I;9;Sciences et technologies de l'information et de la communication;2016;2015-16;2015;2015;11;5;6;34;10;24;11;4;7;;;;;SSBvE
420;École doctorale Santé publique Paris 11 - Paris 5;;7;Sciences de la société;2016;2015-16;2015;2015;0;0;0;3;2;1;1;1;0;;;;;3BNdi
425;École doctorale Innovation thérapeutique : du fondamental à l'appliqué;;5;Biologie, médecine et santé;2016;2015-16;2015;2015;0;0;0;0;0;0;32;23;9;;;;;DkgNy
433;École doctorale Concepts et langages;;1;Mathématiques et leurs interactions;2016;2015-16;2015;2015;1;0;1;6;1;5;0;0;0;;;;;v8q34
433;École doctorale Concepts et langages;;9;Sciences et technologies de l'information et de la communication;2016;2015-16;2015;2015;11;10;1;35;20;15;6;4;2;;;;;v8q34
435;École doctorale Agriculture, alimentation, biologie, environnement et santé;;5;Biologie, médecine et santé;2016;2015-16;2015;2015;0;0;0;0;0;0;8;3;5;;;;;mC35U
435;École doctorale Agriculture, alimentation, biologie, environnement et santé;;10;Sciences agronomiques et écologiques;2016;2015-16;2015;2015;0;0;0;0;0;0;11;4;7;;;;;mC35U
446;École doctorale Biologie - Santé;EDBSL;10;Sciences agronomiques et écologiques;2016;2015-16;2015;2015;0;0;0;0;0;0;2;1;1;;;;;4iEUF
447;École doctorale de l'école polytechnique;;2;Physique;2016;2015-16;2015;2015;0;0;0;0;0;0;59;13;46;;;;;zgCCh
447;École doctorale de l'école polytechnique;;9;Sciences et technologies de l'information et de la communication;2016;2015-16;2015;2015;0;0;0;0;0;0;22;3;19;;;;;zgCCh
454;École doctorale Sciences de l'homme, du politique et du territoire;SHPT;6;Sciences humaines et humanités;2016;2015-16;2015;2015;38;21;17;215;116;99;27;19;8;;;;;Opv31
455;École doctorale Économie, Gestion, Information et Communication;EGIC;7;Sciences de la société;2016;2015-16;2015;2015;14;9;5;78;38;40;11;4;7;;;;;qCOg3
455;École doctorale Économie, Gestion, Information et Communication;EGIC;9;Sciences et technologies de l'information et de la communication;2016;2015-16;2015;2015;1;0;1;4;2;2;2;1;1;;;;;qCOg3
456;École doctorale Sciences du sport, de la motricité et du mouvement humain;;6;Sciences humaines et humanités;2016;2015-16;2015;2015;0;0;0;0;0;0;4;3;1;;;;;GqvEI
463;École doctorale Sciences du mouvement humain;SMH;8;Sciences pour l'ingénieur;2016;2015-16;2015;2015;5;2;3;21;5;16;4;0;4;;;;;UbtlY
468;École doctorale Mécanique, énergétique, génie civil, procédés;MEGEP;8;Sciences pour l'ingénieur;2016;2015-16;2015;2015;128;37;91;461;144;317;113;37;76;;;;;4XUTB
469;École doctorale du Pacifique;EDP;3;Sciences de la terre et de l'univers, espace;2016;2015-16;2015;2015;0;0;0;2;1;1;0;0;0;;;;;t9Z2n
469;École doctorale du Pacifique;EDP;7;Sciences de la société;2016;2015-16;2015;2015;3;2;1;14;6;8;0;0;0;;;;;t9Z2n
472;École doctorale de l'EPHE;;5;Biologie, médecine et santé;2016;2015-16;2015;2015;12;5;7;39;22;17;10;7;3;;;;;27zK4
472;École doctorale de l'EPHE;;10;Sciences agronomiques et écologiques;2016;2015-16;2015;2015;7;3;4;30;16;14;5;3;2;;;;;27zK4
473;École doctorale Sciences de l'homme et de la société;SHS;6;Sciences humaines et humanités;2016;2015-16;2015;2015;143;76;67;600;336;264;70;46;24;;;;;8qKD9
474;École doctorale Interdisciplinaire européenne frontières du vivant;FDV;2;Physique;2016;2015-16;2015;2015;5;4;1;13;6;7;6;2;4;;;;;E727j
474;École doctorale Interdisciplinaire européenne frontières du vivant;FDV;4;Chimie;2016;2015-16;2015;2015;3;2;1;12;4;8;1;0;1;;;;;E727j
476;École doctorale Neurosciences et cognition;NSCO;5;Biologie, médecine et santé;2016;2015-16;2015;2015;24;15;9;109;60;49;25;18;7;;;;;B1H0x
476;École doctorale Neurosciences et cognition;NSCO;6;Sciences humaines et humanités;2016;2015-16;2015;2015;9;4;5;31;22;9;5;4;1;;;;;B1H0x
477;École doctorale Systèmes intégrés en biologie, agronomie, géosciences, hydrosciences, environnement;SIBAGHE;8;Sciences pour l'ingénieur;2016;2015-16;2015;2015;0;0;0;0;0;0;1;0;1;;;;;zfN3N
478;École doctorale Sciences de Gestion;;7;Sciences de la société;2016;2015-16;2015;2015;9;6;3;52;32;20;10;6;4;;;;;q34kB
480;École doctorale Montaigne-humanités;;6;Sciences humaines et humanités;2016;2015-16;2015;2015;117;73;44;545;337;208;74;38;36;;;;;f3SeZ
481;École doctorale Sciences sociales et humanités;SSH;7;Sciences de la société;2016;2015-16;2015;2015;36;19;17;176;86;90;15;3;12;;;;;E3z5j
482;École doctorale Sciences de la matière;SDM;4;Chimie;2016;2015-16;2015;2015;33;11;22;179;74;105;64;28;36;;;;;kmeZ4
482;École doctorale Sciences de la matière;SDM;8;Sciences pour l'ingénieur;2016;2015-16;2015;2015;22;11;11;96;38;58;11;2;9;;;;;kmeZ4
483;École doctorale Histoire, géographie, aménagement, urbanisme, archéologie, science politique, sociologie, anthropologie;SCSO;7;Sciences de la société;2016;2015-16;2015;2015;41;23;18;183;95;88;20;13;7;;;;;hc6u4
489;École doctorale Sciences et ingénierie des systèmes, de l'environnement et des organisations;SISEO;8;Sciences pour l'ingénieur;2016;2015-16;2015;2015;14;2;12;55;14;41;6;2;4;;;;;6pT77
493;École doctorale Erasme;;6;Sciences humaines et humanités;2016;2015-16;2015;2015;29;13;16;120;80;40;20;13;7;;;;;FPW4T
495;École doctorale Végétal, environnement, nutrition, agroalimentaire, mer;VENAM;10;Sciences agronomiques et écologiques;2016;2015-16;2015;2015;31;14;17;117;63;54;39;27;12;;;;;HL495
496;École doctorale Sociétés, cultures, échanges;SCE;6;Sciences humaines et humanités;2016;2015-16;2015;2015;55;29;26;307;181;126;38;24;14;;;;;633tC
497;École doctorale Normande de Biologie Intégrative, Santé, Environnement;Ed NBISE;6;Sciences humaines et humanités;2016;2015-16;2015;2015;0;0;0;4;2;2;1;0;1;;;;;0D9Je
500;École doctorale Matière, molécules, matériaux en Pays de Loire;3MPL;9;Sciences et technologies de l'information et de la communication;2016;2015-16;2015;2015;1;0;1;2;0;2;0;0;0;;;;;822tM
501;École doctorale Droit, économie-gestion, sociétés, territoires;;7;Sciences de la société;2016;2015-16;2015;2015;84;39;45;357;165;192;47;20;27;;;;;wE7WM
502;École doctorale Biologie - Santé;;6;Sciences humaines et humanités;2016;2015-16;2015;2015;0;0;0;1;1;0;0;0;0;;;;;JCFV7
503;École doctorale Sciences et technologies de l'information et de mathématiques;STIM;1;Mathématiques et leurs interactions;2016;2015-16;2015;2015;6;3;3;42;13;29;14;5;9;;;;;JQevP
504;École doctorale Cognition, éducation, interactions;CEI;7;Sciences de la société;2016;2015-16;2015;2015;0;0;0;1;0;1;0;0;0;;;;;39naT
507;École doctorale Sciences humaines et sociales;;9;Sciences et technologies de l'information et de la communication;2016;2015-16;2015;2015;0;0;0;0;0;0;1;0;1;;;;;3e7VM
508;École doctorale Normande de chimie;EDNC;4;Chimie;2016;2015-16;2015;2015;39;20;19;134;66;68;40;14;26;;;;;E52OO
509;École doctorale Civilisations et sociétés euro-méditerranéennes et comparées;;6;Sciences humaines et humanités;2016;2015-16;2015;2015;8;6;2;52;30;22;5;2;3;;;;;9tbyG
509;École doctorale Civilisations et sociétés euro-méditerranéennes et comparées;;7;Sciences de la société;2016;2015-16;2015;2015;20;4;16;80;26;54;22;9;13;;;;;9tbyG
511;École doctorale Sciences et ingénierie;S&I;4;Chimie;2016;2015-16;2015;2015;0;0;0;0;0;0;3;1;2;;;;;7aXuB
512;École doctorale Informatique et mathématiques;InfoMaths;9;Sciences et technologies de l'information et de la communication;2016;2015-16;2015;2015;52;12;40;206;44;162;50;13;37;;;;;t86bi
514;École doctorale Études anglophones, germanophones et européennes;EDEAGE;6;Sciences humaines et humanités;2016;2015-16;2015;2015;28;21;7;161;123;38;33;21;12;;;;;fuIQs
515;École doctorale Complexité du vivant;CdV;5;Biologie, médecine et santé;2016;2015-16;2015;2015;88;49;39;310;173;137;84;51;33;;;;;CbV9s
519;École doctorale Sciences humaines et sociales - Perspectives européennes;SHS-PE;7;Sciences de la société;2016;2015-16;2015;2015;76;44;32;394;226;168;66;32;34;;;;;2f5qs
521;École doctorale Sciences et ingénierie pour l'information, mathématiques;S2I;1;Mathématiques et leurs interactions;2016;2015-16;2015;2015;13;5;8;41;16;25;14;5;9;;;;;V6i83
523;École doctorale Sciences pour l'environnement - Gay Lussac;;3;Sciences de la terre et de l'univers, espace;2016;2015-16;2015;2015;4;1;3;22;9;13;11;3;8;;;;;6xD69
523;École doctorale Sciences pour l'environnement - Gay Lussac;;6;Sciences humaines et humanités;2016;2015-16;2015;2015;1;1;0;6;3;3;3;1;2;;;;;6xD69
528;École doctorale Ville, transports et territoires;VTT;8;Sciences pour l'ingénieur;2016;2015-16;2015;2015;5;1;4;22;7;15;3;2;1;;;;;68zCc
530;École doctorale Organisations, marchés, institutions;OMI;9;Sciences et technologies de l'information et de la communication;2016;2015-16;2015;2015;0;0;0;1;1;0;0;0;0;;;;;4htv7
531;École doctorale Sciences, ingénierie et environnement;SIE;2;Physique;2016;2015-16;2015;2015;4;1;3;27;8;19;9;1;8;;;;;b5BYq
531;École doctorale Sciences, ingénierie et environnement;SIE;4;Chimie;2016;2015-16;2015;2015;15;5;10;47;17;30;11;6;5;;;;;b5BYq
531;École doctorale Sciences, ingénierie et environnement;SIE;5;Biologie, médecine et santé;2016;2015-16;2015;2015;1;0;1;3;1;2;1;1;0;;;;;b5BYq
536;École doctorale Sciences et agrosciences;;4;Chimie;2016;2015-16;2015;2015;5;4;1;17;10;7;1;1;0;;;;;pHfqe
537;École doctorale Culture et patrimoine;C&P;7;Sciences de la société;2016;2015-16;2015;2015;14;6;8;75;46;29;14;7;7;;;;;GxI4a
538;École doctorale Culture, régulation, institutions et territoire;CRIT;6;Sciences humaines et humanités;2016;2015-16;2015;2015;0;0;0;0;0;0;11;7;4;;;;;8T505
539;École doctorale Sciences et technologies de Versailles;;2;Physique;2016;2015-16;2015;2015;0;0;0;0;0;0;4;1;3;;;;;nv3h8
540;"École doctorale École transdisciplinaire ""lettres/sciences""";;6;Sciences humaines et humanités;2016;2015-16;2015;2015;45;23;22;131;68;63;4;2;2;;;;;tWWw7
543;École doctorale de Dauphine;;1;Mathématiques et leurs interactions;2016;2015-16;2015;2015;15;2;13;49;11;38;11;4;7;;;;;u8w6A
543;École doctorale de Dauphine;;9;Sciences et technologies de l'information et de la communication;2016;2015-16;2015;2015;14;7;7;40;13;27;4;2;2;;;;;u8w6A
544;École doctorale Inter-Med : Espaces, temps, cultures;INTER-MED;6;Sciences humaines et humanités;2016;2015-16;2015;2015;36;16;20;103;56;47;13;6;7;;;;;7VjtD
545;École doctorale Sociétés, politique et santé publique;SP2;5;Biologie, médecine et santé;2016;2015-16;2015;2015;15;9;6;67;41;26;9;5;4;;;;;IAKR4
545;École doctorale Sociétés, politique et santé publique;SP2;6;Sciences humaines et humanités;2016;2015-16;2015;2015;31;18;13;101;59;42;16;9;7;;;;;IAKR4
546;École doctorale Abbé Grégoire;;7;Sciences de la société;2016;2015-16;2015;2015;21;9;12;94;43;51;17;11;6;;;;;ZSn7q
546;École doctorale Abbé Grégoire;;9;Sciences et technologies de l'information et de la communication;2016;2015-16;2015;2015;3;2;1;16;11;5;0;0;0;;;;;ZSn7q
547;École doctorale Sciences, Technologie, Santé;EDSTS;2;Physique;2016;2015-16;2015;2015;8;4;4;24;7;17;7;2;5;;;;;wEdn2
547;École doctorale Sciences, Technologie, Santé;EDSTS;5;Biologie, médecine et santé;2016;2015-16;2015;2015;14;9;5;73;41;32;16;6;10;;;;;wEdn2
547;École doctorale Sciences, Technologie, Santé;EDSTS;8;Sciences pour l'ingénieur;2016;2015-16;2015;2015;13;2;11;54;11;43;18;1;17;;;;;wEdn2
548;École doctorale Mer et Sciences;;5;Biologie, médecine et santé;2016;2015-16;2015;2015;2;0;2;5;0;5;2;2;0;;;;;QX0fS
548;École doctorale Mer et Sciences;;6;Sciences humaines et humanités;2016;2015-16;2015;2015;0;0;0;2;0;2;1;1;0;;;;;QX0fS
548;École doctorale Mer et Sciences;;10;Sciences agronomiques et écologiques;2016;2015-16;2015;2015;1;0;1;1;0;1;0;0;0;;;;;QX0fS
549;École doctorale Santé, Sciences Biologiques et Chimie du Vivant;SSBCV;6;Sciences humaines et humanités;2016;2015-16;2015;2015;1;0;1;10;6;4;1;1;0;;;;;B9ggO
552;École doctorale Énergie - Matériaux - Sciences de la Terre et de l'Univers;EMTSU;2;Physique;2016;2015-16;2015;2015;13;4;9;41;14;27;11;5;6;;;;;NTZhw
554;École doctorale Environnements - Santé;E-S;3;Sciences de la terre et de l'univers, espace;2016;2015-16;2015;2015;0;0;0;8;1;7;2;0;2;;;;;ElyFU
554;École doctorale Environnements - Santé;E-S;4;Chimie;2016;2015-16;2015;2015;0;0;0;1;0;1;0;0;0;;;;;ElyFU
554;École doctorale Environnements - Santé;E-S;6;Sciences humaines et humanités;2016;2015-16;2015;2015;2;0;2;16;5;11;2;1;1;;;;;ElyFU
555;École doctorale Sciences de l'Homme et de la Société;SHS;6;Sciences humaines et humanités;2016;2015-16;2015;2015;22;13;9;104;51;53;18;10;8;;;;;44G6m
559;École doctorale Management Panthéon-Sorbonne;;7;Sciences de la société;2016;2015-16;2015;2015;39;20;19;198;83;115;23;14;9;;;;;4SP7k
564;École doctorale Physique en Ile de France;PIF;2;Physique;2016;2015-16;2015;2015;156;41;115;581;151;430;148;36;112;;;;;39AcN
565;École doctorale Droit de la Sorbonne;DS;7;Sciences de la société;2016;2015-16;2015;2015;119;51;68;792;361;431;71;35;36;;;;;aXJ7L
566;École doctorale Sciences du Sport, de la Motricité et du Mouvement Humain;SMMH;6;Sciences humaines et humanités;2016;2015-16;2015;2015;12;4;8;77;36;41;4;2;2;;;;;3iv8y
570;École doctorale Santé Publique;EDSP;5;Biologie, médecine et santé;2016;2015-16;2015;2015;25;17;8;132;88;44;13;6;7;;;;;9lgE4
573;École doctorale Interfaces : Approches Interdisciplinaires, Fondements, Applications et Innovation;ED INTERFACES;2;Physique;2016;2015-16;2015;2015;20;5;15;88;27;61;1;0;1;;;;;gG820
574;École doctorale de Mathématiques Hadamard;EDMH;1;Mathématiques et leurs interactions;2016;2015-16;2015;2015;57;16;41;242;58;184;21;6;15;;;;;4pqal
576;École doctorale Particules, Hadrons, Énergie, Noyau, Instrumentation, Imagerie, Cosmos et Simulation;PHENIICS;2;Physique;2016;2015-16;2015;2015;61;19;42;188;55;133;15;5;10;;;;;qC4rf
576;École doctorale Particules, Hadrons, Énergie, Noyau, Instrumentation, Imagerie, Cosmos et Simulation;PHENIICS;3;Sciences de la terre et de l'univers, espace;2016;2015-16;2015;2015;0;0;0;2;0;2;0;0;0;;;;;qC4rf
576;École doctorale Particules, Hadrons, Énergie, Noyau, Instrumentation, Imagerie, Cosmos et Simulation;PHENIICS;4;Chimie;2016;2015-16;2015;2015;2;0;2;11;5;6;2;1;1;;;;;qC4rf
579;École doctorale Sciences mécaniques et energétiques, matériaux et géosciences;SMEMaG;1;Mathématiques et leurs interactions;2016;2015-16;2015;2015;2;0;2;4;1;3;0;0;0;;;;;atMj7
579;École doctorale Sciences mécaniques et energétiques, matériaux et géosciences;SMEMaG;9;Sciences et technologies de l'information et de la communication;2016;2015-16;2015;2015;0;0;0;1;0;1;0;0;0;;;;;atMj7
580;École doctorale Sciences et technologies de l'information et de la communication;STIC;8;Sciences pour l'ingénieur;2016;2015-16;2015;2015;4;1;3;15;2;13;1;0;1;;;;;AzCC0
580;École doctorale Sciences et technologies de l'information et de la communication;STIC;9;Sciences et technologies de l'information et de la communication;2016;2015-16;2015;2015;161;40;121;562;153;409;46;8;38;;;;;AzCC0
582;École doctorale Cancérologie, Biologie, Médecine, Santé;CBMS;5;Biologie, médecine et santé;2016;2015-16;2015;2015;47;32;15;217;145;72;50;34;16;;;;;75bj4
583;École doctorale Risques et Société;;8;Sciences pour l'ingénieur;2016;2015-16;2015;2015;3;1;2;3;1;2;0;0;0;;;;;wUBi9
584;École doctorale Biodiversité, Agriculture, Alimentation, Environnement, Terre, Eau;GAIA;5;Biologie, médecine et santé;2016;2015-16;2015;2015;19;11;8;66;37;29;0;0;0;;;;;F1h5f
586;École doctorale Sciences Humaines et Sociales;EDSHS;6;Sciences humaines et humanités;2016;2015-16;2015;2015;38;28;10;196;109;87;9;4;5;;;;;0RKVX
587;École doctorale Diversites, santé et développement en Amazonie;;6;Sciences humaines et humanités;2016;2015-16;2015;2015;3;2;1;10;7;3;0;0;0;;;;;V14tj
588;École doctorale Milieu insulaire tropical : dynamiques de développement, sociétés, patrimoine et culture dans l'espace Caraïbes-Amériques;;6;Sciences humaines et humanités;2016;2015-16;2015;2015;29;19;10;144;99;45;14;7;7;;;;;4W5IO
589;École doctorale Milieu insulaire tropical à risques : protection, valorisation , santé et développement;;1;Mathématiques et leurs interactions;2016;2015-16;2015;2015;2;1;1;10;3;7;2;1;1;;;;;2cqi3
589;École doctorale Milieu insulaire tropical à risques : protection, valorisation , santé et développement;;4;Chimie;2016;2015-16;2015;2015;1;1;0;8;4;4;4;1;3;;;;;2cqi3
589;École doctorale Milieu insulaire tropical à risques : protection, valorisation , santé et développement;;5;Biologie, médecine et santé;2016;2015-16;2015;2015;4;2;2;36;25;11;15;10;5;;;;;2cqi3
589;École doctorale Milieu insulaire tropical à risques : protection, valorisation , santé et développement;;9;Sciences et technologies de l'information et de la communication;2016;2015-16;2015;2015;1;0;1;3;1;2;0;0;0;;;;;2cqi3
6;École doctorale Droit privé;;7;Sciences de la société;2017;2016-17;2016;2016;38;14;24;299;145;154;28;15;13;;;;;UMnW1
34;École doctorale Matériaux;;2;Physique;2017;2016-17;2016;2016;17;7;10;109;44;65;35;17;18;;;;;1Iufh
34;École doctorale Matériaux;;4;Chimie;2017;2016-17;2016;2016;6;2;4;38;16;22;12;6;6;;;;;1Iufh
34;École doctorale Matériaux;;8;Sciences pour l'ingénieur;2017;2016-17;2016;2016;32;13;19;73;29;44;7;4;3;;;;;1Iufh
47;École doctorale Physique;;3;Sciences de la terre et de l'univers, espace;2017;2016-17;2016;2016;1;0;1;4;0;4;2;1;1;;;;;8kNpd
47;École doctorale Physique;;4;Chimie;2017;2016-17;2016;2016;1;0;1;2;0;2;0;0;0;;;;;8kNpd
50;École doctorale Langues, littératures et sciences humaines;LLSH;7;Sciences de la société;2017;2016-17;2016;2016;0;0;0;1;1;0;0;0;0;;;;;8THzQ
58;École doctorale Langues, littératures, cultures, civilisations;LLCC;6;Sciences humaines et humanités;2017;2016-17;2016;2016;107;65;42;461;281;180;50;32;18;;;;;I9ATR
67;École doctorale Sciences juridiques et politiques;;8;Sciences pour l'ingénieur;2017;2016-17;2016;2016;0;0;0;1;1;0;0;0;0;;;;;qrOj1
71;École doctorale Sciences pour l'ingénieur;;8;Sciences pour l'ingénieur;2017;2016-17;2016;2016;37;16;21;195;73;122;43;20;23;;;;;H6UYp
73;École doctorale Sciences économiques, sociales, de l'aménagement et du management;SESAM;1;Mathématiques et leurs interactions;2017;2016-17;2016;2016;0;0;0;5;1;4;3;0;3;;;;;IQ0Hk
73;École doctorale Sciences économiques, sociales, de l'aménagement et du management;SESAM;6;Sciences humaines et humanités;2017;2016-17;2016;2016;26;12;14;57;35;22;6;3;3;;;;;IQ0Hk
77;École doctorale Informatique, automatique, électronique, électrotechnique, mathématiques;IAEM;1;Mathématiques et leurs interactions;2017;2016-17;2016;2016;14;4;10;41;11;30;13;2;11;;;;;TCHTA
86;École doctorale Sociétés, humanités, arts, lettres;LSHS;7;Sciences de la société;2017;2016-17;2016;2016;5;2;3;28;20;8;2;2;0;;;;;O8E6y
104;École doctorale Sciences de la matière, du rayonnement et de l'environnement;SMRE;10;Sciences agronomiques et écologiques;2017;2016-17;2016;2016;24;14;10;79;47;32;25;7;18;;;;;Q5iFz
112;École doctorale Archéologie;;6;Sciences humaines et humanités;2017;2016-17;2016;2016;31;17;14;235;141;94;32;22;10;;;;;EvU7R
113;École doctorale Histoire;;6;Sciences humaines et humanités;2017;2016-17;2016;2016;45;26;19;304;160;144;43;15;28;;;;;G5wHs
119;École doctorale Science politique;;7;Sciences de la société;2017;2016-17;2016;2016;17;9;8;102;53;49;17;10;7;;;;;eyibb
127;École doctorale Astronomie et astrophysique d'Ile de France;A&A;3;Sciences de la terre et de l'univers, espace;2017;2016-17;2016;2016;52;13;39;184;61;123;51;24;27;;;;;cPXrq
129;École doctorale Sciences de l'environnement d'Ile de France;SEIF;10;Sciences agronomiques et écologiques;2017;2016-17;2016;2016;0;0;0;3;2;1;2;1;1;;;;;TnAPh
130;École doctorale Informatique, télécommunications et électronique de Paris;EDITE;9;Sciences et technologies de l'information et de la communication;2017;2016-17;2016;2016;89;17;72;666;164;502;166;48;118;;;;;O5ysj
131;École doctorale Langue, littérature, image, civilisations et sciences humaines (domaines francophone et anglophone);LLI;6;Sciences humaines et humanités;2017;2016-17;2016;2016;28;21;7;175;117;58;31;20;11;;;;;a47aW
146;École doctorale Galilée;GALILEE;2;Physique;2017;2016-17;2016;2016;5;3;2;19;4;15;7;4;3;;;;;71hqm
146;École doctorale Galilée;GALILEE;8;Sciences pour l'ingénieur;2017;2016-17;2016;2016;12;4;8;34;15;19;8;1;7;;;;;71hqm
151;École doctorale Biologie, santé, biotechnologies;;5;Biologie, médecine et santé;2017;2016-17;2016;2016;90;59;31;373;221;152;86;51;35;;;;;yP8w4
154;École doctorale Sciences de la vie et de la santé;SVS;5;Biologie, médecine et santé;2017;2016-17;2016;2016;94;57;37;303;182;121;83;45;38;;;;;hLn36
156;École doctorale Sciences de la mer;;5;Biologie, médecine et santé;2017;2016-17;2016;2016;27;10;17;77;40;37;23;14;9;;;;;EGY9P
156;École doctorale Sciences de la mer;;7;Sciences de la société;2017;2016-17;2016;2016;6;2;4;19;11;8;4;2;2;;;;;EGY9P
159;École doctorale Esthétique, sciences et technologies des arts;EDESTA;6;Sciences humaines et humanités;2017;2016-17;2016;2016;40;21;19;244;146;98;32;18;14;;;;;zj1Vj
166;École doctorale Information, structures et systèmes;I2S;3;Sciences de la terre et de l'univers, espace;2017;2016-17;2016;2016;2;1;1;4;2;2;2;1;1;;;;;2uO68
173;École doctorale Sciences de l'univers, de l'environnement et de l'espace;SDU2E;8;Sciences pour l'ingénieur;2017;2016-17;2016;2016;3;1;2;18;5;13;5;2;3;;;;;R0Z9c
181;École doctorale Structure, informations, matière et matériaux;Simem;2;Physique;2017;2016-17;2016;2016;0;0;0;0;0;0;13;1;12;;;;;c1D6f
181;École doctorale Structure, informations, matière et matériaux;Simem;4;Chimie;2017;2016-17;2016;2016;0;0;0;0;0;0;16;9;7;;;;;c1D6f
182;École doctorale Physique et chimie-physique;;4;Chimie;2017;2016-17;2016;2016;23;13;10;76;35;41;19;5;14;;;;;3My6I
205;École doctorale Interdisciplinaire Sciences-Santé;EDISS;9;Sciences et technologies de l'information et de la communication;2017;2016-17;2016;2016;1;1;0;4;1;3;1;0;1;;;;;69W38
209;École doctorale Sciences physiques et de L'ingénieur;SPI;9;Sciences et technologies de l'information et de la communication;2017;2016-17;2016;2016;47;7;40;143;32;111;33;6;27;;;;;tZcIZ
211;École doctorale Sciences exactes et leurs applications;ED SEA;2;Physique;2017;2016-17;2016;2016;3;1;2;12;4;8;2;0;2;;;;;1G1iC
211;École doctorale Sciences exactes et leurs applications;ED SEA;10;Sciences agronomiques et écologiques;2017;2016-17;2016;2016;5;3;2;12;6;6;2;2;0;;;;;1G1iC
216;École doctorale Ingénierie pour la santé, la cognition, l'environnement;EDISCE;2;Physique;2017;2016-17;2016;2016;2;0;2;5;0;5;0;0;0;;;;;fPs1t
216;École doctorale Ingénierie pour la santé, la cognition, l'environnement;EDISCE;7;Sciences de la société;2017;2016-17;2016;2016;0;0;0;5;4;1;1;1;0;;;;;fPs1t
216;École doctorale Ingénierie pour la santé, la cognition, l'environnement;EDISCE;9;Sciences et technologies de l'information et de la communication;2017;2016-17;2016;2016;5;2;3;22;12;10;2;0;2;;;;;fPs1t
217;École doctorale Mathématiques, sciences et technologies de l'information, informatique;MSTII;1;Mathématiques et leurs interactions;2017;2016-17;2016;2016;25;6;19;91;19;72;25;6;19;;;;;Ehx7v
218;École doctorale Chimie et sciences du vivant;EDCSV;4;Chimie;2017;2016-17;2016;2016;27;14;13;111;52;59;22;12;10;;;;;8bcJh
220;École doctorale Électronique, électrotechnique, automatique, traitement du signal;EEATS;3;Sciences de la terre et de l'univers, espace;2017;2016-17;2016;2016;0;0;0;1;0;1;0;0;0;;;;;IxEaw
220;École doctorale Électronique, électrotechnique, automatique, traitement du signal;EEATS;9;Sciences et technologies de l'information et de la communication;2017;2016-17;2016;2016;37;11;26;252;63;189;84;22;62;;;;;IxEaw
221;École doctorale Augustin Cournot - Sciences économiques et de gestion - Sciences, technologies et sociétés;EDAC;6;Sciences humaines et humanités;2017;2016-17;2016;2016;1;1;0;9;4;5;0;0;0;;;;;5z9rW
222;École doctorale Sciences chimiques;EDSC;8;Sciences pour l'ingénieur;2017;2016-17;2016;2016;1;1;0;2;2;0;0;0;0;;;;;AdU8Q
224;École doctorale Cognition, langage, interaction;;1;Mathématiques et leurs interactions;2017;2016-17;2016;2016;4;1;3;7;2;5;0;0;0;;;;;7v43e
224;École doctorale Cognition, langage, interaction;;8;Sciences pour l'ingénieur;2017;2016-17;2016;2016;2;1;1;8;6;2;0;0;0;;;;;7v43e
234;École doctorale de Sciences Po;;7;Sciences de la société;2017;2016-17;2016;2016;60;32;28;329;166;163;72;37;35;;;;;ux756
240;École doctorale Sciences de l'homme et de la société;SHS;7;Sciences de la société;2017;2016-17;2016;2016;13;6;7;86;36;50;9;2;7;;;;;j345k
251;École doctorale Sciences de l'environnement;;5;Biologie, médecine et santé;2017;2016-17;2016;2016;0;0;0;3;2;1;3;1;2;;;;;VR28y
254;École doctorale Sciences de la matière;;8;Sciences pour l'ingénieur;2017;2016-17;2016;2016;10;3;7;42;9;33;10;1;9;;;;;365F2
262;École doctorale Sciences juridiques, politiques, économiques et de gestion;DEG;7;Sciences de la société;2017;2016-17;2016;2016;40;21;19;193;91;102;29;19;10;;;;;H7GyL
266;École doctorale Biologie, santé, environnement;BIOSE;4;Chimie;2017;2016-17;2016;2016;0;0;0;1;1;0;0;0;0;;;;;386V9
269;École doctorale Mathématiques, sciences de l'information et de l'ingénieur;MSII;8;Sciences pour l'ingénieur;2017;2016-17;2016;2016;25;8;17;94;31;63;46;20;26;;;;;5E625
284;École doctorale Droit et Science Politique;DSP;6;Sciences humaines et humanités;2017;2016-17;2016;2016;53;25;28;197;110;87;25;15;10;;;;;ahH92
304;École doctorale Sciences et environnements;;3;Sciences de la terre et de l'univers, espace;2017;2016-17;2016;2016;4;3;1;24;15;9;11;8;3;;;;;2ywZn
304;École doctorale Sciences et environnements;;7;Sciences de la société;2017;2016-17;2016;2016;4;3;1;10;8;2;5;4;1;;;;;2ywZn
323;École doctorale Génie électrique, électronique et télécommunications;GEET;8;Sciences pour l'ingénieur;2017;2016-17;2016;2016;42;15;27;185;49;136;60;20;40;;;;;arcz6
327;École doctorale Temps, espaces, sociétés, cultures;TESC;7;Sciences de la société;2017;2016-17;2016;2016;14;7;7;106;51;55;20;8;12;;;;;IjgiJ
328;École doctorale Arts, lettres, langues, philosophie et communication;ALLPH@;6;Sciences humaines et humanités;2017;2016-17;2016;2016;66;40;26;300;186;114;36;18;18;;;;;xLxMh
341;École doctorale Évolution, écosystèmes, microbiologie, modélisation;E2M2;3;Sciences de la terre et de l'univers, espace;2017;2016-17;2016;2016;2;1;1;3;2;1;0;0;0;;;;;J83I0
341;École doctorale Évolution, écosystèmes, microbiologie, modélisation;E2M2;10;Sciences agronomiques et écologiques;2017;2016-17;2016;2016;16;9;7;58;28;30;9;2;7;;;;;J83I0
353;École doctorale Sciences pour l'ingénieur : mécanique, physique, micro et nanoélectronique;;2;Physique;2017;2016-17;2016;2016;9;3;6;12;3;9;8;2;6;;;;;vk5Kp
353;École doctorale Sciences pour l'ingénieur : mécanique, physique, micro et nanoélectronique;;3;Sciences de la terre et de l'univers, espace;2017;2016-17;2016;2016;0;0;0;5;2;3;0;0;0;;;;;vk5Kp
359;École doctorale Mathématiques, télécommunications, informatique, signal, systèmes, électronique;MATISSE;8;Sciences pour l'ingénieur;2017;2016-17;2016;2016;0;0;0;1;0;1;1;1;0;;;;;Y0r76
373;École doctorale Santé, information/communications et mathématiques, matière;SICMA;4;Chimie;2017;2016-17;2016;2016;4;2;2;15;5;10;2;0;2;;;;;hTJF5
373;École doctorale Santé, information/communications et mathématiques, matière;SICMA;8;Sciences pour l'ingénieur;2017;2016-17;2016;2016;15;4;11;57;11;46;13;7;6;;;;;hTJF5
373;École doctorale Santé, information/communications et mathématiques, matière;SICMA;9;Sciences et technologies de l'information et de la communication;2017;2016-17;2016;2016;67;17;50;264;61;203;57;17;40;;;;;hTJF5
386;École doctorale Sciences mathématiques de Paris centre;SMPC;1;Mathématiques et leurs interactions;2017;2016-17;2016;2016;106;20;86;484;96;388;126;30;96;;;;;wMj98
396;École doctorale Économie, organisations, société;EOS;6;Sciences humaines et humanités;2017;2016-17;2016;2016;4;0;4;29;10;19;5;2;3;;;;;Es5e7
397;École doctorale Physique et chimie des matériaux;;4;Chimie;2017;2016-17;2016;2016;50;26;24;129;61;68;50;25;25;;;;;WxSt9
400;École doctorale Savoirs scientifiques : épistémologie, histoire des sciences, didactique des disciplines;;6;Sciences humaines et humanités;2017;2016-17;2016;2016;15;6;9;63;30;33;10;5;5;;;;;nRax3
401;École doctorale Sciences sociales;;7;Sciences de la société;2017;2016-17;2016;2016;29;18;11;167;96;71;19;11;8;;;;;raQ7K
402;École doctorale Sciences de la vie et de la santé;SVS;5;Biologie, médecine et santé;2017;2016-17;2016;2016;24;14;10;101;62;39;30;13;17;;;;;YKgsU
405;École doctorale Économie, management,mathématiques et physique de Cergy;EM2C;1;Mathématiques et leurs interactions;2017;2016-17;2016;2016;2;1;1;20;4;16;3;1;2;;;;;QbwSB
405;École doctorale Économie, management,mathématiques et physique de Cergy;EM2C;7;Sciences de la société;2017;2016-17;2016;2016;19;5;14;83;36;47;17;8;9;;;;;QbwSB
411;École doctorale Humanités nouvelles : Fernand Braudel;;6;Sciences humaines et humanités;2017;2016-17;2016;2016;75;46;29;299;167;132;36;15;21;;;;;l2rFh
413;École doctorale Sciences de la terre et de l'environnement;STE;10;Sciences agronomiques et écologiques;2017;2016-17;2016;2016;0;0;0;2;2;0;2;2;0;;;;;u9BA9
414;École doctorale Sciences de la vie et de la santé;;4;Chimie;2017;2016-17;2016;2016;0;0;0;2;2;0;1;1;0;;;;;YI4xS
417;École doctorale Sciences et Ingénierie;S&I;9;Sciences et technologies de l'information et de la communication;2017;2016-17;2016;2016;9;3;6;43;12;31;3;0;3;;;;;SSBvE
433;École doctorale Concepts et langages;;1;Mathématiques et leurs interactions;2017;2016-17;2016;2016;2;2;0;7;3;4;1;0;1;;;;;v8q34
433;École doctorale Concepts et langages;;7;Sciences de la société;2017;2016-17;2016;2016;0;0;0;0;0;0;3;0;3;;;;;v8q34
433;École doctorale Concepts et langages;;9;Sciences et technologies de l'information et de la communication;2017;2016-17;2016;2016;14;7;7;47;25;22;3;3;0;;;;;v8q34
446;École doctorale Biologie - Santé;EDBSL;5;Biologie, médecine et santé;2017;2016-17;2016;2016;100;54;46;339;183;156;67;37;30;;;;;4iEUF
455;École doctorale Économie, Gestion, Information et Communication;EGIC;6;Sciences humaines et humanités;2017;2016-17;2016;2016;12;8;4;50;34;16;2;1;1;;;;;qCOg3
458;École doctorale Sciences écologiques, vétérinaires, agronomiques et bioingénieries;SEVAB;10;Sciences agronomiques et écologiques;2017;2016-17;2016;2016;71;36;35;249;124;125;56;30;26;;;;;Yf3TI
463;École doctorale Sciences du mouvement humain;SMH;5;Biologie, médecine et santé;2017;2016-17;2016;2016;15;8;7;63;28;35;14;3;11;;;;;UbtlY
467;École doctorale Aéronautique, astronautique;AA;2;Physique;2017;2016-17;2016;2016;2;1;1;7;2;5;1;0;1;;;;;U7l45
467;École doctorale Aéronautique, astronautique;AA;4;Chimie;2017;2016-17;2016;2016;1;0;1;1;0;1;0;0;0;;;;;U7l45
467;École doctorale Aéronautique, astronautique;AA;7;Sciences de la société;2017;2016-17;2016;2016;0;0;0;3;1;2;0;0;0;;;;;U7l45
469;École doctorale du Pacifique;EDP;7;Sciences de la société;2017;2016-17;2016;2016;9;6;3;27;15;12;1;0;1;;;;;t9Z2n
472;École doctorale de l'EPHE;;5;Biologie, médecine et santé;2017;2016-17;2016;2016;14;9;5;41;18;23;10;9;1;;;;;27zK4
472;École doctorale de l'EPHE;;6;Sciences humaines et humanités;2017;2016-17;2016;2016;84;41;43;490;259;231;90;45;45;;;;;27zK4
473;École doctorale Sciences de l'homme et de la société;SHS;6;Sciences humaines et humanités;2017;2016-17;2016;2016;138;84;54;614;353;261;79;41;38;;;;;8qKD9
473;École doctorale Sciences de l'homme et de la société;SHS;7;Sciences de la société;2017;2016-17;2016;2016;0;0;0;1;0;1;1;0;1;;;;;8qKD9
474;École doctorale Interdisciplinaire européenne frontières du vivant;FDV;2;Physique;2017;2016-17;2016;2016;7;2;5;14;5;9;2;0;2;;;;;E727j
474;École doctorale Interdisciplinaire européenne frontières du vivant;FDV;4;Chimie;2017;2016-17;2016;2016;2;1;1;8;4;4;3;2;1;;;;;E727j
478;École doctorale Sciences de Gestion;;7;Sciences de la société;2017;2016-17;2016;2016;11;4;7;53;33;20;8;3;5;;;;;q34kB
481;École doctorale Sciences sociales et humanités;SSH;6;Sciences humaines et humanités;2017;2016-17;2016;2016;22;9;13;146;85;61;28;15;13;;;;;E3z5j
482;École doctorale Sciences de la matière;SDM;4;Chimie;2017;2016-17;2016;2016;38;17;21;198;80;118;59;31;28;;;;;kmeZ4
485;École doctorale Éducation, Psychologie, Information et Communication;EPIC;6;Sciences humaines et humanités;2017;2016-17;2016;2016;42;23;19;244;163;81;60;40;20;;;;;O82eL
487;École doctorale Philosophie;PHCR;6;Sciences humaines et humanités;2017;2016-17;2016;2016;32;18;14;153;65;88;20;6;14;;;;;3BRzJ
488;École doctorale Sciences, ingénierie, santé;SIS;5;Biologie, médecine et santé;2017;2016-17;2016;2016;18;9;9;70;25;45;14;5;9;;;;;Fy2lK
488;École doctorale Sciences, ingénierie, santé;SIS;9;Sciences et technologies de l'information et de la communication;2017;2016-17;2016;2016;43;15;28;153;41;112;47;12;35;;;;;Fy2lK
488;École doctorale Sciences, ingénierie, santé;SIS;10;Sciences agronomiques et écologiques;2017;2016-17;2016;2016;1;1;0;5;4;1;4;3;1;;;;;Fy2lK
491;École doctorale Langages, idées, sociétés, institutions, territoires;LISIT;7;Sciences de la société;2017;2016-17;2016;2016;0;0;0;0;0;0;23;11;12;;;;;iB25j
498;École doctorale Sciences pour l'ingénieur, géosciences, architecture;SPIGA;6;Sciences humaines et humanités;2017;2016-17;2016;2016;1;1;0;8;5;3;2;0;2;;;;;0vlKH
498;École doctorale Sciences pour l'ingénieur, géosciences, architecture;SPIGA;9;Sciences et technologies de l'information et de la communication;2017;2016-17;2016;2016;7;3;4;20;3;17;1;0;1;;;;;0vlKH
500;École doctorale Matière, molécules, matériaux en Pays de Loire;3MPL;5;Biologie, médecine et santé;2017;2016-17;2016;2016;1;1;0;1;1;0;1;1;0;;;;;822tM
501;École doctorale Droit, économie-gestion, sociétés, territoires;;7;Sciences de la société;2017;2016-17;2016;2016;70;23;47;345;143;202;44;22;22;;;;;wE7WM
503;École doctorale Sciences et technologies de l'information et de mathématiques;STIM;2;Physique;2017;2016-17;2016;2016;0;0;0;1;0;1;0;0;0;;;;;JQevP
503;École doctorale Sciences et technologies de l'information et de mathématiques;STIM;6;Sciences humaines et humanités;2017;2016-17;2016;2016;1;0;1;10;5;5;1;0;1;;;;;JQevP
505;École doctorale Sciences de l'homme, des organisations et de la société;SHOS;7;Sciences de la société;2017;2016-17;2016;2016;50;22;28;332;155;177;50;18;32;;;;;qts78
506;École doctorale arts, lettres et langues;;6;Sciences humaines et humanités;2017;2016-17;2016;2016;44;30;14;221;148;73;24;20;4;;;;;m9yqI
507;École doctorale Sciences humaines et sociales;;6;Sciences humaines et humanités;2017;2016-17;2016;2016;80;50;30;429;230;199;57;29;28;;;;;3e7VM
508;École doctorale Normande de chimie;EDNC;4;Chimie;2017;2016-17;2016;2016;31;11;20;141;67;74;27;16;11;;;;;E52OO
508;École doctorale Normande de chimie;EDNC;5;Biologie, médecine et santé;2017;2016-17;2016;2016;4;3;1;10;7;3;0;0;0;;;;;E52OO
510;École doctorale Ingénierie - Matériaux, mécanique, environnement, énergétique, procédés, production;IMEP2;8;Sciences pour l'ingénieur;2017;2016-17;2016;2016;85;35;50;379;111;268;101;28;73;;;;;Ce7NF
519;École doctorale Sciences humaines et sociales - Perspectives européennes;SHS-PE;7;Sciences de la société;2017;2016-17;2016;2016;32;21;11;157;90;67;25;12;13;;;;;2f5qs
521;École doctorale Sciences et ingénierie pour l'information, mathématiques;S2I;8;Sciences pour l'ingénieur;2017;2016-17;2016;2016;10;3;7;48;13;35;25;5;20;;;;;V6i83
521;École doctorale Sciences et ingénierie pour l'information, mathématiques;S2I;10;Sciences agronomiques et écologiques;2017;2016-17;2016;2016;3;1;2;29;6;23;0;0;0;;;;;V6i83
524;École doctorale Biologie - santé;;5;Biologie, médecine et santé;2017;2016-17;2016;2016;36;20;16;133;79;54;38;26;12;;;;;S7Kk6
526;École doctorale Sociétés et organisations;SORG;7;Sciences de la société;2017;2016-17;2016;2016;28;13;15;109;58;51;26;7;19;;;;;5F3Fd
530;École doctorale Organisations, marchés, institutions;OMI;8;Sciences pour l'ingénieur;2017;2016-17;2016;2016;0;0;0;1;1;0;0;0;0;;;;;4htv7
531;École doctorale Sciences, ingénierie et environnement;SIE;6;Sciences humaines et humanités;2017;2016-17;2016;2016;0;0;0;2;1;1;0;0;0;;;;;b5BYq
532;École doctorale Mathématiques et sciences et technologies de l'information et de la communication;MSTIC;3;Sciences de la terre et de l'univers, espace;2017;2016-17;2016;2016;4;1;3;15;5;10;3;1;2;;;;;t43KM
536;École doctorale Sciences et agrosciences;;9;Sciences et technologies de l'information et de la communication;2017;2016-17;2016;2016;3;1;2;24;5;19;9;5;4;;;;;pHfqe
540;"École doctorale École transdisciplinaire ""lettres/sciences""";;5;Biologie, médecine et santé;2017;2016-17;2016;2016;0;0;0;3;2;1;0;0;0;;;;;tWWw7
542;École doctorale de sciences de La Réunion;STS;1;Mathématiques et leurs interactions;2017;2016-17;2016;2016;2;0;2;21;8;13;0;0;0;;;;;2pAql
545;École doctorale Sociétés, politique et santé publique;SP2;5;Biologie, médecine et santé;2017;2016-17;2016;2016;25;10;15;70;39;31;19;10;9;;;;;IAKR4
546;École doctorale Abbé Grégoire;;7;Sciences de la société;2017;2016-17;2016;2016;26;12;14;106;57;49;14;4;10;;;;;ZSn7q
547;École doctorale Sciences, Technologie, Santé;EDSTS;4;Chimie;2017;2016-17;2016;2016;5;1;4;25;9;16;4;2;2;;;;;wEdn2
547;École doctorale Sciences, Technologie, Santé;EDSTS;9;Sciences et technologies de l'information et de la communication;2017;2016-17;2016;2016;11;0;11;47;6;41;8;1;7;;;;;wEdn2
548;École doctorale Mer et Sciences;;2;Physique;2017;2016-17;2016;2016;3;0;3;6;2;4;1;1;0;;;;;QX0fS
548;École doctorale Mer et Sciences;;6;Sciences humaines et humanités;2017;2016-17;2016;2016;0;0;0;0;0;0;1;0;1;;;;;QX0fS
549;École doctorale Santé, Sciences Biologiques et Chimie du Vivant;SSBCV;2;Physique;2017;2016-17;2016;2016;1;0;1;3;2;1;0;0;0;;;;;B9ggO
549;École doctorale Santé, Sciences Biologiques et Chimie du Vivant;SSBCV;9;Sciences et technologies de l'information et de la communication;2017;2016-17;2016;2016;1;0;1;4;1;3;1;0;1;;;;;B9ggO
549;École doctorale Santé, Sciences Biologiques et Chimie du Vivant;SSBCV;10;Sciences agronomiques et écologiques;2017;2016-17;2016;2016;0;0;0;18;13;5;7;0;7;;;;;B9ggO
551;École doctorale Mathématiques, Informatique, Physique Théorique et Ingénierie des Systèmes;MIPTIS;1;Mathématiques et leurs interactions;2017;2016-17;2016;2016;7;3;4;26;10;16;8;2;6;;;;;Mpudz
551;École doctorale Mathématiques, Informatique, Physique Théorique et Ingénierie des Systèmes;MIPTIS;9;Sciences et technologies de l'information et de la communication;2017;2016-17;2016;2016;33;6;27;84;17;67;15;3;12;;;;;Mpudz
552;École doctorale Énergie - Matériaux - Sciences de la Terre et de l'Univers;EMTSU;2;Physique;2017;2016-17;2016;2016;5;0;5;33;12;21;14;3;11;;;;;NTZhw
552;École doctorale Énergie - Matériaux - Sciences de la Terre et de l'Univers;EMTSU;5;Biologie, médecine et santé;2017;2016-17;2016;2016;1;0;1;9;2;7;2;1;1;;;;;NTZhw
553;École doctorale Carnot - Pasteur;;3;Sciences de la terre et de l'univers, espace;2017;2016-17;2016;2016;1;0;1;5;0;5;0;0;0;;;;;6h4Z7
555;École doctorale Sciences de l'Homme et de la Société;SHS;6;Sciences humaines et humanités;2017;2016-17;2016;2016;18;11;7;102;53;49;13;6;7;;;;;44G6m
559;École doctorale Management Panthéon-Sorbonne;;9;Sciences et technologies de l'information et de la communication;2017;2016-17;2016;2016;2;0;2;15;5;10;2;1;1;;;;;4SP7k
562;École doctorale Bio Sorbonne Paris Cité;BioSPC;5;Biologie, médecine et santé;2017;2016-17;2016;2016;148;95;53;531;342;189;152;87;65;;;;;4Yju6
564;École doctorale Physique en Ile de France;PIF;2;Physique;2017;2016-17;2016;2016;183;42;141;619;152;467;164;49;115;;;;;39AcN
567;École doctorale Sciences du Végétal : du gène à l'écosystème;;5;Biologie, médecine et santé;2017;2016-17;2016;2016;28;13;15;115;60;55;27;15;12;;;;;tuDkA
570;École doctorale Santé Publique;EDSP;1;Mathématiques et leurs interactions;2017;2016-17;2016;2016;2;1;1;5;2;3;2;0;2;;;;;9lgE4
571;École doctorale Sciences Chimiques : Molécules, Matériaux, Instrumentation et Biosystemes;2MIB;5;Biologie, médecine et santé;2017;2016-17;2016;2016;0;0;0;0;0;0;1;1;0;;;;;zbi37
572;École doctorale Ondes et matière;EDOM;8;Sciences pour l'ingénieur;2017;2016-17;2016;2016;3;2;1;4;3;1;0;0;0;;;;;etSIi
573;École doctorale Interfaces : Approches Interdisciplinaires, Fondements, Applications et Innovation;ED INTERFACES;5;Biologie, médecine et santé;2017;2016-17;2016;2016;9;4;5;26;13;13;7;5;2;;;;;gG820
575;École doctorale Electrical, Optical, Bio : Physics and Engineering;EOBE;2;Physique;2017;2016-17;2016;2016;25;9;16;131;45;86;44;6;38;;;;;dfhyn
575;École doctorale Electrical, Optical, Bio : Physics and Engineering;EOBE;8;Sciences pour l'ingénieur;2017;2016-17;2016;2016;31;9;22;135;39;96;22;6;16;;;;;dfhyn
577;École doctorale Structure et dynamique des systèmes vivants;SDSV;4;Chimie;2017;2016-17;2016;2016;0;0;0;2;2;0;0;0;0;;;;;4bsxJ
579;École doctorale Sciences mécaniques et energétiques, matériaux et géosciences;SMEMaG;1;Mathématiques et leurs interactions;2017;2016-17;2016;2016;1;0;1;3;0;3;1;1;0;;;;;atMj7
579;École doctorale Sciences mécaniques et energétiques, matériaux et géosciences;SMEMaG;4;Chimie;2017;2016-17;2016;2016;2;0;2;10;2;8;4;1;3;;;;;atMj7
579;École doctorale Sciences mécaniques et energétiques, matériaux et géosciences;SMEMaG;9;Sciences et technologies de l'information et de la communication;2017;2016-17;2016;2016;0;0;0;1;0;1;0;0;0;;;;;atMj7
581;École doctorale Agriculture, alimentation, biologie, environnement, santé;ABIES;2;Physique;2017;2016-17;2016;2016;0;0;0;2;1;1;0;0;0;;;;;c1x56
581;École doctorale Agriculture, alimentation, biologie, environnement, santé;ABIES;4;Chimie;2017;2016-17;2016;2016;2;2;0;14;8;6;5;2;3;;;;;c1x56
581;École doctorale Agriculture, alimentation, biologie, environnement, santé;ABIES;8;Sciences pour l'ingénieur;2017;2016-17;2016;2016;7;5;2;26;19;7;5;2;3;;;;;c1x56
581;École doctorale Agriculture, alimentation, biologie, environnement, santé;ABIES;10;Sciences agronomiques et écologiques;2017;2016-17;2016;2016;41;28;13;143;84;59;35;18;17;;;;;c1x56
583;École doctorale Risques et Société;;1;Mathématiques et leurs interactions;2017;2016-17;2016;2016;1;0;1;1;0;1;0;0;0;;;;;wUBi9
583;École doctorale Risques et Société;;3;Sciences de la terre et de l'univers, espace;2017;2016-17;2016;2016;1;0;1;1;0;1;0;0;0;;;;;wUBi9
585;École doctorale Sciences, Technologie,  Sante;EDSTS;9;Sciences et technologies de l'information et de la communication;2017;2016-17;2016;2016;8;1;7;24;6;18;4;1;3;;;;;NM3Dl
587;École doctorale Diversites, santé et développement en Amazonie;;7;Sciences de la société;2017;2016-17;2016;2016;2;1;1;8;4;4;1;0;1;;;;;V14tj
589;École doctorale Milieu insulaire tropical à risques : protection, valorisation , santé et développement;;3;Sciences de la terre et de l'univers, espace;2017;2016-17;2016;2016;2;0;2;4;2;2;0;0;0;;;;;2cqi3
589;École doctorale Milieu insulaire tropical à risques : protection, valorisation , santé et développement;;4;Chimie;2017;2016-17;2016;2016;1;1;0;4;3;1;0;0;0;;;;;2cqi3
589;École doctorale Milieu insulaire tropical à risques : protection, valorisation , santé et développement;;8;Sciences pour l'ingénieur;2017;2016-17;2016;2016;1;0;1;1;0;1;0;0;0;;;;;2cqi3
590;École doctorale Mathematiques, Information, Ingenierie des Systemes;MIIS;1;Mathématiques et leurs interactions;2017;2016-17;2016;2016;12;1;11;56;19;37;0;0;0;;;;;L20t5
590;École doctorale Mathematiques, Information, Ingenierie des Systemes;MIIS;9;Sciences et technologies de l'information et de la communication;2017;2016-17;2016;2016;22;3;19;126;34;92;0;0;0;;;;;L20t5
593;École doctorale Droit, Gestion, sciences Économiques et Politique;DGEP;7;Sciences de la société;2017;2016-17;2016;2016;61;25;36;229;103;126;0;0;0;;;;;41pAm
19;École doctorale Littératures françaises et comparée;;6;Sciences humaines et humanités;2011;2010-11;2010;2010;75;48;27;347;245;102;40;24;16;;;;;13M43
37;École doctorale Sciences physiques pour l'ingénieur et microtechniques;SPIM;9;Sciences et technologies de l'information et de la communication;2011;2010-11;2010;2010;43;5;38;151;31;120;25;6;19;;;;;F7G1B
40;École doctorale Sciences chimiques;EDSC;4;Chimie;2011;2010-11;2010;2010;96;40;56;283;133;150;81;28;53;;;;;wde3D
50;École doctorale Langues, littératures et sciences humaines;LLSH;6;Sciences humaines et humanités;2011;2010-11;2010;2010;53;34;19;327;228;99;37;28;9;;;;;8THzQ
52;École doctorale Physique et astrophysique de Lyon;PHAST;2;Physique;2011;2010-11;2010;2010;35;8;27;138;37;101;42;5;37;;;;;61XPb
58;École doctorale Langues, littératures, cultures, civilisations;LLCC;6;Sciences humaines et humanités;2011;2010-11;2010;2010;146;84;62;573;332;241;53;30;23;;;;;I9ATR
60;École doctorale Territoires, temps, sociétés et développement;TTSD;9;Sciences et technologies de l'information et de la communication;2011;2010-11;2010;2010;0;0;0;0;0;0;1;1;0;;;;;fkIh6
68;École doctorale Littératures, cultures et sciences sociales;;7;Sciences de la société;2011;2010-11;2010;2010;5;5;0;32;16;16;5;4;1;;;;;NZuM2
70;École doctorale Sciences pour l'ingénieur;EDSPI;8;Sciences pour l'ingénieur;2011;2010-11;2010;2010;20;5;15;56;9;47;14;3;11;;;;;G413P
71;École doctorale Sciences pour l'ingénieur;;9;Sciences et technologies de l'information et de la communication;2011;2010-11;2010;2010;25;11;14;84;30;54;21;4;17;;;;;H6UYp
88;École doctorale Droit et science politique;DSP;7;Sciences de la société;2011;2010-11;2010;2010;60;26;34;395;173;222;39;20;19;;;;;elnAJ
92;École doctorale Vie -  Agro - Santé;;10;Sciences agronomiques et écologiques;2011;2010-11;2010;2010;27;14;13;128;68;60;39;24;15;;;;;RjvXY
101;École doctorale de Sciences juridiques;;7;Sciences de la société;2011;2010-11;2010;2010;71;29;42;386;187;199;38;15;23;;;;;569G2
102;École doctorale Santé, sciences, technologies;;3;Sciences de la terre et de l'univers, espace;2011;2010-11;2010;2010;0;0;0;6;3;3;0;0;0;;;;;4h65n
102;École doctorale Santé, sciences, technologies;;5;Biologie, médecine et santé;2011;2010-11;2010;2010;48;23;25;179;94;85;36;20;16;;;;;4h65n
130;École doctorale Informatique, télécommunications et électronique de Paris;EDITE;9;Sciences et technologies de l'information et de la communication;2011;2010-11;2010;2010;246;71;175;860;224;636;209;45;164;;;;;O5ysj
141;École doctorale Droit et science politique;DSP;7;Sciences de la société;2011;2010-11;2010;2010;79;32;47;79;32;47;22;9;13;;;;;CyNBf
142;École doctorale Mathématiques de la région Paris-Sud;;1;Mathématiques et leurs interactions;2011;2010-11;2010;2010;28;6;22;102;25;77;20;6;14;;;;;5XlH9
160;École doctorale Électronique, électrotechnique, automatique;EEA;5;Biologie, médecine et santé;2011;2010-11;2010;2010;3;0;3;12;2;10;2;2;0;;;;;EgfMQ
162;École doctorale Mécanique, énergétique, génie civil, acoustique;MEGA;8;Sciences pour l'ingénieur;2011;2010-11;2010;2010;104;23;81;499;94;405;55;13;42;;;;;7wCke
166;École doctorale Information, structures et systèmes;I2S;2;Physique;2011;2010-11;2010;2010;22;7;15;50;15;35;13;2;11;;;;;2uO68
166;École doctorale Information, structures et systèmes;I2S;8;Sciences pour l'ingénieur;2011;2010-11;2010;2010;15;2;13;51;14;37;9;1;8;;;;;2uO68
177;École doctorale Sciences et technologies de l'université d'Orléans;;1;Mathématiques et leurs interactions;2011;2010-11;2010;2010;3;1;2;17;6;11;4;1;3;;;;;JI65m
178;École doctorale Sciences fondamentales;;2;Physique;2011;2010-11;2010;2010;8;3;5;33;7;26;11;1;10;;;;;1AiR7
178;École doctorale Sciences fondamentales;;4;Chimie;2011;2010-11;2010;2010;21;12;9;70;35;35;9;5;4;;;;;1AiR7
180;École doctorale Sciences humaines et sociales : cultures, individus, sociétés;SHS;6;Sciences humaines et humanités;2011;2010-11;2010;2010;22;19;3;109;82;27;18;11;7;;;;;D2BT3
181;École doctorale Structure, informations, matière et matériaux;Simem;3;Sciences de la terre et de l'univers, espace;2011;2010-11;2010;2010;4;3;1;11;7;4;4;0;4;;;;;c1D6f
184;École doctorale Mathématiques et informatique de Marseille;;1;Mathématiques et leurs interactions;2011;2010-11;2010;2010;18;4;14;76;19;57;12;2;10;;;;;DDObG
184;École doctorale Mathématiques et informatique de Marseille;;8;Sciences pour l'ingénieur;2011;2010-11;2010;2010;5;0;5;12;2;10;1;0;1;;;;;DDObG
205;École doctorale Interdisciplinaire Sciences-Santé;EDISS;5;Biologie, médecine et santé;2011;2010-11;2010;2010;64;34;30;286;151;135;66;34;32;;;;;69W38
205;École doctorale Interdisciplinaire Sciences-Santé;EDISS;7;Sciences de la société;2011;2010-11;2010;2010;2;1;1;43;20;23;6;3;3;;;;;69W38
209;École doctorale Sciences physiques et de L'ingénieur;SPI;3;Sciences de la terre et de l'univers, espace;2011;2010-11;2010;2010;3;2;1;9;5;4;1;1;0;;;;;tZcIZ
211;École doctorale Sciences exactes et leurs applications;ED SEA;9;Sciences et technologies de l'information et de la communication;2011;2010-11;2010;2010;5;2;3;24;5;19;4;1;3;;;;;1G1iC
218;École doctorale Chimie et sciences du vivant;EDCSV;5;Biologie, médecine et santé;2011;2010-11;2010;2010;62;43;19;236;136;100;58;32;26;;;;;8bcJh
222;École doctorale Sciences chimiques;EDSC;5;Biologie, médecine et santé;2011;2010-11;2010;2010;2;2;0;15;8;7;0;0;0;;;;;AdU8Q
224;École doctorale Cognition, langage, interaction;;6;Sciences humaines et humanités;2011;2010-11;2010;2010;39;23;16;197;125;72;19;10;9;;;;;7v43e
227;École doctorale Sciences de la nature et de l'homme;;6;Sciences humaines et humanités;2011;2010-11;2010;2010;15;10;5;48;28;20;9;6;3;;;;;xiDA5
238;École doctorale Sciences humaines et sociales;;7;Sciences de la société;2011;2010-11;2010;2010;33;15;18;145;66;79;15;6;9;;;;;lr2wn
240;École doctorale Sciences de l'homme et de la société;SHS;6;Sciences humaines et humanités;2011;2010-11;2010;2010;67;35;32;239;147;92;39;26;13;;;;;j345k
242;École doctorale Économie - Gestion - Normandie;;6;Sciences humaines et humanités;2011;2010-11;2010;2010;11;5;6;93;40;53;6;4;2;;;;;z35ku
245;École doctorale Sciences économiques, juridiques, politiques et de gestion;;7;Sciences de la société;2011;2010-11;2010;2010;36;14;22;205;79;126;19;9;10;;;;;ShLUg
251;École doctorale Sciences de l'environnement;;3;Sciences de la terre et de l'univers, espace;2011;2010-11;2010;2010;29;16;13;134;57;77;28;11;17;;;;;VR28y
251;École doctorale Sciences de l'environnement;;10;Sciences agronomiques et écologiques;2011;2010-11;2010;2010;12;7;5;65;33;32;11;5;6;;;;;VR28y
254;École doctorale Sciences de la matière;;2;Physique;2011;2010-11;2010;2010;16;3;13;60;12;48;24;8;16;;;;;365F2
261;École doctorale Cognition, comportements, conduites humaines;3CH;6;Sciences humaines et humanités;2011;2010-11;2010;2010;45;30;15;143;103;40;28;23;5;;;;;KOLCy
262;École doctorale Sciences juridiques, politiques, économiques et de gestion;DEG;7;Sciences de la société;2011;2010-11;2010;2010;40;21;19;195;102;93;27;9;18;;;;;H7GyL
265;École doctorale Langues, littératures et sociétés du monde;;6;Sciences humaines et humanités;2011;2010-11;2010;2010;51;33;18;272;167;105;25;17;8;;;;;4YWGW
267;École doctorale Arts et médias;;6;Sciences humaines et humanités;2011;2010-11;2010;2010;77;54;23;316;228;88;35;23;12;;;;;eCF5C
269;École doctorale Mathématiques, sciences de l'information et de l'ingénieur;MSII;1;Mathématiques et leurs interactions;2011;2010-11;2010;2010;14;3;11;42;6;36;9;3;6;;;;;5E625
269;École doctorale Mathématiques, sciences de l'information et de l'ingénieur;MSII;5;Biologie, médecine et santé;2011;2010-11;2010;2010;0;0;0;3;1;2;0;0;0;;;;;5E625
273;École doctorale Biologie et biotechnologie;B2T;5;Biologie, médecine et santé;2011;2010-11;2010;2010;63;38;25;238;148;90;64;33;31;;;;;Wtta6
279;École doctorale Arts plastiques, esthétique et sciences de l'art;APESA;6;Sciences humaines et humanités;2011;2010-11;2010;2010;74;54;20;378;270;108;35;15;20;;;;;BpW1j
280;École doctorale Philosophie;;6;Sciences humaines et humanités;2011;2010-11;2010;2010;58;30;28;252;106;146;23;9;14;;;;;kJxnm
284;École doctorale Droit et Science Politique;DSP;7;Sciences de la société;2011;2010-11;2010;2010;10;5;5;73;29;44;9;5;4;;;;;ahH92
285;École doctorale Sciences pratiques;;7;Sciences de la société;2011;2010-11;2010;2010;4;2;2;11;6;5;3;2;1;;;;;Jd3t2
303;École doctorale Sciences sociales : société, santé, décision;;7;Sciences de la société;2011;2010-11;2010;2010;13;5;8;59;35;24;8;6;2;;;;;s3X5X
304;École doctorale Sciences et environnements;;3;Sciences de la terre et de l'univers, espace;2011;2010-11;2010;2010;14;10;4;39;23;16;9;4;5;;;;;2ywZn
304;École doctorale Sciences et environnements;;4;Chimie;2011;2010-11;2010;2010;4;3;1;5;4;1;1;0;1;;;;;2ywZn
304;École doctorale Sciences et environnements;;10;Sciences agronomiques et écologiques;2011;2010-11;2010;2010;4;2;2;32;12;20;7;4;3;;;;;2ywZn
306;École doctorale Sciences des procédés, sciences des aliments;;8;Sciences pour l'ingénieur;2011;2010-11;2010;2010;9;6;3;73;38;35;9;2;7;;;;;adF7W
309;École doctorale Systèmes;EDSYS;8;Sciences pour l'ingénieur;2011;2010-11;2010;2010;23;8;15;110;32;78;34;5;29;;;;;8TT4b
326;École doctorale Comportement, langage, éducation, socialisation, cognition;CLESCO;6;Sciences humaines et humanités;2011;2010-11;2010;2010;75;50;25;314;212;102;50;33;17;;;;;nWIlG
327;École doctorale Temps, espaces, sociétés, cultures;TESC;6;Sciences humaines et humanités;2011;2010-11;2010;2010;72;30;42;282;147;135;35;17;18;;;;;IjgiJ
327;École doctorale Temps, espaces, sociétés, cultures;TESC;7;Sciences de la société;2011;2010-11;2010;2010;28;15;13;179;109;70;18;11;7;;;;;IjgiJ
341;École doctorale Évolution, écosystèmes, microbiologie, modélisation;E2M2;3;Sciences de la terre et de l'univers, espace;2011;2010-11;2010;2010;4;2;2;14;6;8;6;2;4;;;;;J83I0
341;École doctorale Évolution, écosystèmes, microbiologie, modélisation;E2M2;10;Sciences agronomiques et écologiques;2011;2010-11;2010;2010;28;18;10;106;57;49;31;15;16;;;;;J83I0
351;École doctorale Sciences physiques, mathématiques et de l'information pour l'ingénieur;SPMII;1;Mathématiques et leurs interactions;2011;2010-11;2010;2010;10;6;4;40;16;24;9;2;7;;;;;rY4EP
351;École doctorale Sciences physiques, mathématiques et de l'information pour l'ingénieur;SPMII;9;Sciences et technologies de l'information et de la communication;2011;2010-11;2010;2010;24;7;17;120;27;93;19;6;13;;;;;rY4EP
353;École doctorale Sciences pour l'ingénieur : mécanique, physique, micro et nanoélectronique;;3;Sciences de la terre et de l'univers, espace;2011;2010-11;2010;2010;3;1;2;6;3;3;0;0;0;;;;;vk5Kp
353;École doctorale Sciences pour l'ingénieur : mécanique, physique, micro et nanoélectronique;;5;Biologie, médecine et santé;2011;2010-11;2010;2010;1;0;1;8;3;5;1;1;0;;;;;vk5Kp
359;École doctorale Mathématiques, télécommunications, informatique, signal, systèmes, électronique;MATISSE;1;Mathématiques et leurs interactions;2011;2010-11;2010;2010;19;6;13;78;16;62;18;4;14;;;;;Y0r76
368;École doctorale Sciences et santé;;4;Chimie;2011;2010-11;2010;2010;13;5;8;51;20;31;14;5;9;;;;;4L0a1
368;École doctorale Sciences et santé;;5;Biologie, médecine et santé;2011;2010-11;2010;2010;23;10;13;70;30;40;13;6;7;;;;;4L0a1
371;École doctorale Louis Pasteur;;1;Mathématiques et leurs interactions;2011;2010-11;2010;2010;7;1;6;26;6;20;6;1;5;;;;;2tr4F
371;École doctorale Louis Pasteur;;5;Biologie, médecine et santé;2011;2010-11;2010;2010;1;0;1;1;0;1;0;0;0;;;;;2tr4F
373;École doctorale Santé, information/communications et mathématiques, matière;SICMA;1;Mathématiques et leurs interactions;2011;2010-11;2010;2010;6;1;5;34;8;26;8;3;5;;;;;hTJF5
373;École doctorale Santé, information/communications et mathématiques, matière;SICMA;2;Physique;2011;2010-11;2010;2010;2;1;1;10;4;6;3;1;2;;;;;hTJF5
373;École doctorale Santé, information/communications et mathématiques, matière;SICMA;9;Sciences et technologies de l'information et de la communication;2011;2010-11;2010;2010;60;13;47;240;59;181;48;13;35;;;;;hTJF5
377;École doctorale Environnement et société;;2;Physique;2011;2010-11;2010;2010;0;0;0;12;2;10;2;1;1;;;;;ZMG5u
378;École doctorale Sciences de l'homme et de la société;SHS;6;Sciences humaines et humanités;2011;2010-11;2010;2010;15;8;7;76;44;32;9;6;3;;;;;3XKuF
387;École doctorale Interdisciplinaire pour le vivant;I-ViV;4;Chimie;2011;2010-11;2010;2010;3;2;1;17;8;9;5;1;4;;;;;06uKM
388;École doctorale Chimie physique et chimie analytique de Paris centre;CPCA;4;Chimie;2011;2010-11;2010;2010;71;32;39;253;117;136;49;18;31;;;;;M0Hnd
393;École doctorale Pierre Louis de Santé Publique : Épidémiologie et Sciences de l'information biomédicale;PLSP;5;Biologie, médecine et santé;2011;2010-11;2010;2010;39;17;22;144;77;67;25;14;11;;;;;69445
394;École doctorale Physiologie et physiopathologie;p2t;5;Biologie, médecine et santé;2011;2010-11;2010;2010;77;41;36;313;183;130;79;54;25;;;;;VMYmT
400;École doctorale Savoirs scientifiques : épistémologie, histoire des sciences, didactique des disciplines;;4;Chimie;2011;2010-11;2010;2010;0;0;0;1;0;1;0;0;0;;;;;nRax3
409;École doctorale Énergie, mécanique, matériaux;EMMA;8;Sciences pour l'ingénieur;2011;2010-11;2010;2010;35;6;29;111;25;86;24;3;21;;;;;KXlbK
411;École doctorale Humanités nouvelles : Fernand Braudel;;9;Sciences et technologies de l'information et de la communication;2011;2010-11;2010;2010;11;5;6;47;25;22;5;2;3;;;;;l2rFh
413;École doctorale Sciences de la terre et de l'environnement;STE;3;Sciences de la terre et de l'univers, espace;2011;2010-11;2010;2010;22;7;15;85;32;53;18;4;14;;;;;u9BA9
413;École doctorale Sciences de la terre et de l'environnement;STE;6;Sciences humaines et humanités;2011;2010-11;2010;2010;4;2;2;15;8;7;2;2;0;;;;;u9BA9
414;École doctorale Sciences de la vie et de la santé;;5;Biologie, médecine et santé;2011;2010-11;2010;2010;128;74;54;532;270;262;130;69;61;;;;;YI4xS
414;École doctorale Sciences de la vie et de la santé;;6;Sciences humaines et humanités;2011;2010-11;2010;2010;1;0;1;6;3;3;0;0;0;;;;;YI4xS
415;"École doctorale Interdisciplinaire ""Arts et métiers""";;8;Sciences pour l'ingénieur;2011;2010-11;2010;2010;8;3;5;8;3;5;3;1;2;;;;;B3z99
417;École doctorale Sciences et Ingénierie;S&I;4;Chimie;2011;2010-11;2010;2010;6;2;4;19;11;8;4;0;4;;;;;SSBvE
419;École doctorale Signalisations et réseaux intégratifs en biologie;BIO-SIGNE;5;Biologie, médecine et santé;2011;2010-11;2010;2010;34;24;10;138;81;57;31;20;11;;;;;rDuFq
420;École doctorale Santé publique Paris 11 - Paris 5;;7;Sciences de la société;2011;2010-11;2010;2010;4;3;1;12;9;3;2;2;0;;;;;3BNdi
422;École doctorale Sciences et technologies de l'information, des télécommunications et des systèmes;;9;Sciences et technologies de l'information et de la communication;2011;2010-11;2010;2010;70;20;50;260;68;192;54;12;42;;;;;998UM
423;École doctorale Des génomes aux organismes;;1;Mathématiques et leurs interactions;2011;2010-11;2010;2010;2;0;2;4;1;3;0;0;0;;;;;VguHK
426;École doctorale Gènes, génomes, cellules;;5;Biologie, médecine et santé;2011;2010-11;2010;2010;34;21;13;142;81;61;38;25;13;;;;;XPaY8
433;École doctorale Concepts et langages;;9;Sciences et technologies de l'information et de la communication;2011;2010-11;2010;2010;9;9;0;27;20;7;6;4;2;;;;;v8q34
435;École doctorale Agriculture, alimentation, biologie, environnement et santé;;1;Mathématiques et leurs interactions;2011;2010-11;2010;2010;4;2;2;9;6;3;1;0;1;;;;;mC35U
435;École doctorale Agriculture, alimentation, biologie, environnement et santé;;7;Sciences de la société;2011;2010-11;2010;2010;4;2;2;36;20;16;3;2;1;;;;;mC35U
447;École doctorale de l'école polytechnique;;2;Physique;2011;2010-11;2010;2010;49;9;40;211;49;162;49;12;37;;;;;zgCCh
447;École doctorale de l'école polytechnique;;6;Sciences humaines et humanités;2011;2010-11;2010;2010;11;5;6;39;16;23;4;0;4;;;;;zgCCh
454;École doctorale Sciences de l'homme, du politique et du territoire;SHPT;6;Sciences humaines et humanités;2011;2010-11;2010;2010;52;20;32;211;102;109;23;10;13;;;;;Opv31
455;École doctorale Économie, Gestion, Information et Communication;EGIC;7;Sciences de la société;2011;2010-11;2010;2010;35;10;25;111;50;61;28;10;18;;;;;qCOg3
467;École doctorale Aéronautique, astronautique;AA;1;Mathématiques et leurs interactions;2011;2010-11;2010;2010;2;0;2;3;1;2;0;0;0;;;;;U7l45
467;École doctorale Aéronautique, astronautique;AA;2;Physique;2011;2010-11;2010;2010;7;1;6;7;1;6;0;0;0;;;;;U7l45
467;École doctorale Aéronautique, astronautique;AA;9;Sciences et technologies de l'information et de la communication;2011;2010-11;2010;2010;0;0;0;6;0;6;1;0;1;;;;;U7l45
468;École doctorale Mécanique, énergétique, génie civil, procédés;MEGEP;8;Sciences pour l'ingénieur;2011;2010-11;2010;2010;119;39;80;376;109;267;95;27;68;;;;;4XUTB
469;École doctorale du Pacifique;EDP;5;Biologie, médecine et santé;2011;2010-11;2010;2010;5;4;1;14;7;7;3;3;0;;;;;t9Z2n
474;École doctorale Interdisciplinaire européenne frontières du vivant;FDV;2;Physique;2011;2010-11;2010;2010;7;1;6;14;3;11;2;0;2;;;;;E727j
474;École doctorale Interdisciplinaire européenne frontières du vivant;FDV;9;Sciences et technologies de l'information et de la communication;2011;2010-11;2010;2010;1;0;1;4;2;2;0;0;0;;;;;E727j
474;École doctorale Interdisciplinaire européenne frontières du vivant;FDV;10;Sciences agronomiques et écologiques;2011;2010-11;2010;2010;1;0;1;7;5;2;1;1;0;;;;;E727j
476;École doctorale Neurosciences et cognition;NSCO;5;Biologie, médecine et santé;2011;2010-11;2010;2010;38;18;20;121;66;55;24;12;12;;;;;B1H0x
479;École doctorale Sciences juridiques et politiques;;7;Sciences de la société;2011;2010-11;2010;2010;89;34;55;544;244;300;62;25;37;;;;;34mid
483;École doctorale Histoire, géographie, aménagement, urbanisme, archéologie, science politique, sociologie, anthropologie;SCSO;7;Sciences de la société;2011;2010-11;2010;2010;94;48;46;507;247;260;50;25;25;;;;;hc6u4
486;École doctorale Sciences économiques et de gestion;SEG;7;Sciences de la société;2011;2010-11;2010;2010;39;19;20;236;104;132;53;23;30;;;;;h1GZ3
488;École doctorale Sciences, ingénierie, santé;SIS;3;Sciences de la terre et de l'univers, espace;2011;2010-11;2010;2010;10;4;6;35;10;25;4;2;2;;;;;Fy2lK
488;École doctorale Sciences, ingénierie, santé;SIS;5;Biologie, médecine et santé;2011;2010-11;2010;2010;20;6;14;61;24;37;17;7;10;;;;;Fy2lK
488;École doctorale Sciences, ingénierie, santé;SIS;8;Sciences pour l'ingénieur;2011;2010-11;2010;2010;36;11;25;117;46;71;18;4;14;;;;;Fy2lK
489;École doctorale Sciences et ingénierie des systèmes, de l'environnement et des organisations;SISEO;6;Sciences humaines et humanités;2011;2010-11;2010;2010;0;0;0;0;0;0;5;2;3;;;;;6pT77
489;École doctorale Sciences et ingénierie des systèmes, de l'environnement et des organisations;SISEO;9;Sciences et technologies de l'information et de la communication;2011;2010-11;2010;2010;3;0;3;13;2;11;4;2;2;;;;;6pT77
490;École doctorale Environnement - Santé/STIC;E2S;5;Biologie, médecine et santé;2011;2010-11;2010;2010;28;13;15;120;52;68;21;6;15;;;;;sYTua
493;École doctorale Erasme;;7;Sciences de la société;2011;2010-11;2010;2010;49;31;18;170;111;59;21;15;6;;;;;FPW4T
494;École doctorale Jean-Henri Lambert;;2;Physique;2011;2010-11;2010;2010;2;1;1;5;3;2;0;0;0;;;;;A3m51
494;École doctorale Jean-Henri Lambert;;10;Sciences agronomiques et écologiques;2011;2010-11;2010;2010;2;1;1;4;3;1;3;1;2;;;;;A3m51
495;École doctorale Végétal, environnement, nutrition, agroalimentaire, mer;VENAM;3;Sciences de la terre et de l'univers, espace;2011;2010-11;2010;2010;2;1;1;7;5;2;0;0;0;;;;;HL495
498;École doctorale Sciences pour l'ingénieur, géosciences, architecture;SPIGA;8;Sciences pour l'ingénieur;2011;2010-11;2010;2010;93;28;65;355;101;254;74;14;60;;;;;0vlKH
503;École doctorale Sciences et technologies de l'information et de mathématiques;STIM;1;Mathématiques et leurs interactions;2011;2010-11;2010;2010;16;5;11;44;12;32;10;2;8;;;;;JQevP
503;École doctorale Sciences et technologies de l'information et de mathématiques;STIM;2;Physique;2011;2010-11;2010;2010;0;0;0;2;1;1;1;1;0;;;;;JQevP
506;École doctorale arts, lettres et langues;;6;Sciences humaines et humanités;2011;2010-11;2010;2010;45;32;13;251;162;89;24;18;6;;;;;m9yqI
507;École doctorale Sciences humaines et sociales;;6;Sciences humaines et humanités;2011;2010-11;2010;2010;83;48;35;390;195;195;77;36;41;;;;;3e7VM
508;École doctorale Normande de chimie;EDNC;5;Biologie, médecine et santé;2011;2010-11;2010;2010;4;1;3;5;2;3;1;0;1;;;;;E52OO
511;École doctorale Sciences et ingénierie;S&I;4;Chimie;2011;2010-11;2010;2010;4;4;0;24;17;7;2;1;1;;;;;7aXuB
511;École doctorale Sciences et ingénierie;S&I;5;Biologie, médecine et santé;2011;2010-11;2010;2010;3;1;2;3;1;2;3;0;3;;;;;7aXuB
511;École doctorale Sciences et ingénierie;S&I;9;Sciences et technologies de l'information et de la communication;2011;2010-11;2010;2010;9;1;8;52;10;42;4;3;1;;;;;7aXuB
519;École doctorale Sciences humaines et sociales - Perspectives européennes;SHS-PE;6;Sciences humaines et humanités;2011;2010-11;2010;2010;91;51;40;378;222;156;31;13;18;;;;;2f5qs
523;École doctorale Sciences pour l'environnement - Gay Lussac;;3;Sciences de la terre et de l'univers, espace;2011;2010-11;2010;2010;15;7;8;37;16;21;12;6;6;;;;;6xD69
523;École doctorale Sciences pour l'environnement - Gay Lussac;;8;Sciences pour l'ingénieur;2011;2010-11;2010;2010;12;2;10;46;12;34;5;1;4;;;;;6xD69
531;École doctorale Sciences, ingénierie et environnement;SIE;4;Chimie;2011;2010-11;2010;2010;12;4;8;49;24;25;10;6;4;;;;;b5BYq
531;École doctorale Sciences, ingénierie et environnement;SIE;6;Sciences humaines et humanités;2011;2010-11;2010;2010;0;0;0;2;2;0;1;0;1;;;;;b5BYq
531;École doctorale Sciences, ingénierie et environnement;SIE;10;Sciences agronomiques et écologiques;2011;2010-11;2010;2010;3;3;0;5;4;1;0;0;0;;;;;b5BYq
535;École doctorale Sciences de la société;SDS;7;Sciences de la société;2011;2010-11;2010;2010;24;16;8;84;49;35;11;7;4;;;;;iEUOV
536;École doctorale Sciences et agrosciences;;2;Physique;2011;2010-11;2010;2010;1;1;0;2;1;1;0;0;0;;;;;pHfqe
537;École doctorale Culture et patrimoine;C&P;6;Sciences humaines et humanités;2011;2010-11;2010;2010;44;29;15;121;84;37;19;13;6;;;;;GxI4a
539;École doctorale Sciences et technologies de Versailles;;3;Sciences de la terre et de l'univers, espace;2011;2010-11;2010;2010;1;0;1;3;1;2;2;0;2;;;;;nv3h8
539;École doctorale Sciences et technologies de Versailles;;9;Sciences et technologies de l'information et de la communication;2011;2010-11;2010;2010;12;4;8;80;21;59;21;6;15;;;;;nv3h8
542;École doctorale de sciences de La Réunion;STS;0;;2011;2010-11;2010;2010;9;9;0;44;44;0;5;5;0;;;;;2pAql
543;École doctorale de Dauphine;;9;Sciences et technologies de l'information et de la communication;2011;2010-11;2010;2010;11;5;6;44;15;29;12;2;10;;;;;u8w6A
7;École doctorale Georges Vedel - Droit public interne, science administrative et science politique;;7;Sciences de la société;2013;2012-13;2012;2012;39;13;26;153;57;96;28;10;18;;;;;Dw881
19;École doctorale Littératures françaises et comparée;;6;Sciences humaines et humanités;2013;2012-13;2012;2012;69;43;26;321;223;98;56;42;14;;;;;13M43
34;École doctorale Matériaux;;2;Physique;2013;2012-13;2012;2012;49;23;26;181;72;109;43;17;26;;;;;1Iufh
39;École doctorale Mathématiques et Informatique;EDMIB;1;Mathématiques et leurs interactions;2013;2012-13;2012;2012;28;7;21;91;13;78;23;4;19;;;;;TBj2X
41;École doctorale Droit;;7;Sciences de la société;2013;2012-13;2012;2012;69;29;40;338;160;178;28;13;15;;;;;KnOQK
42;École doctorale Entreprise, économie, société;EES;7;Sciences de la société;2013;2012-13;2012;2012;24;11;13;151;61;90;31;15;16;;;;;uO01d
50;École doctorale Langues, littératures et sciences humaines;LLSH;6;Sciences humaines et humanités;2013;2012-13;2012;2012;58;37;21;276;194;82;55;39;16;;;;;8THzQ
60;École doctorale Territoires, temps, sociétés et développement;TTSD;6;Sciences humaines et humanités;2013;2012-13;2012;2012;61;34;27;218;133;85;27;14;13;;;;;fkIh6
70;École doctorale Sciences pour l'ingénieur;EDSPI;8;Sciences pour l'ingénieur;2013;2012-13;2012;2012;12;2;10;51;11;40;17;1;16;;;;;G413P
70;École doctorale Sciences pour l'ingénieur;EDSPI;9;Sciences et technologies de l'information et de la communication;2013;2012-13;2012;2012;66;19;47;185;37;148;37;3;34;;;;;G413P
72;École doctorale Sciences pour l'ingénieur;SPI;8;Sciences pour l'ingénieur;2013;2012-13;2012;2012;81;21;60;288;67;221;70;17;53;;;;;47QPx
78;École doctorale Sociétés, langages, temps, connaissances;STLC;6;Sciences humaines et humanités;2013;2012-13;2012;2012;44;34;10;222;128;94;27;17;10;;;;;vLU3i
78;École doctorale Sociétés, langages, temps, connaissances;STLC;7;Sciences de la société;2013;2012-13;2012;2012;7;2;5;18;7;11;2;1;1;;;;;vLU3i
79;École doctorale Sciences juridiques, politiques, économiques et de gestion;SJPEG;7;Sciences de la société;2013;2012-13;2012;2012;44;23;21;202;103;99;27;15;12;;;;;ea4x6
92;École doctorale Vie -  Agro - Santé;;5;Biologie, médecine et santé;2013;2012-13;2012;2012;58;29;29;210;98;112;69;40;29;;;;;RjvXY
109;École doctorale Sciences de la terre;;3;Sciences de la terre et de l'univers, espace;2013;2012-13;2012;2012;36;18;18;139;61;78;28;13;15;;;;;BQNt6
113;École doctorale Histoire;;6;Sciences humaines et humanités;2013;2012-13;2012;2012;56;27;29;370;179;191;54;21;33;;;;;G5wHs
151;École doctorale Biologie, santé, biotechnologies;;5;Biologie, médecine et santé;2013;2012-13;2012;2012;90;54;36;315;188;127;66;36;30;;;;;yP8w4
156;École doctorale Sciences de la mer;;7;Sciences de la société;2013;2012-13;2012;2012;8;5;3;22;11;11;4;1;3;;;;;EGY9P
160;École doctorale Électronique, électrotechnique, automatique;EEA;5;Biologie, médecine et santé;2013;2012-13;2012;2012;3;2;1;4;2;2;3;1;2;;;;;EgfMQ
166;École doctorale Information, structures et systèmes;I2S;3;Sciences de la terre et de l'univers, espace;2013;2012-13;2012;2012;1;0;1;3;1;2;0;0;0;;;;;2uO68
166;École doctorale Information, structures et systèmes;I2S;5;Biologie, médecine et santé;2013;2012-13;2012;2012;2;2;0;7;4;3;0;0;0;;;;;2uO68
166;École doctorale Information, structures et systèmes;I2S;10;Sciences agronomiques et écologiques;2013;2012-13;2012;2012;1;0;1;1;0;1;0;0;0;;;;;2uO68
168;École doctorale Sciences chimiques et biologiques pour la santé;SCBS;4;Chimie;2013;2012-13;2012;2012;1;1;0;4;3;1;0;0;0;;;;;8cEME
168;École doctorale Sciences chimiques et biologiques pour la santé;SCBS;5;Biologie, médecine et santé;2013;2012-13;2012;2012;105;65;40;331;197;134;98;54;44;;;;;8cEME
173;École doctorale Sciences de l'univers, de l'environnement et de l'espace;SDU2E;3;Sciences de la terre et de l'univers, espace;2013;2012-13;2012;2012;70;25;45;269;97;172;70;36;34;;;;;R0Z9c
178;École doctorale Sciences fondamentales;;4;Chimie;2013;2012-13;2012;2012;18;8;10;56;27;29;14;8;6;;;;;1AiR7
181;École doctorale Structure, informations, matière et matériaux;Simem;2;Physique;2013;2012-13;2012;2012;18;3;15;63;12;51;19;6;13;;;;;c1D6f
181;École doctorale Structure, informations, matière et matériaux;Simem;3;Sciences de la terre et de l'univers, espace;2013;2012-13;2012;2012;1;1;0;5;3;2;2;2;0;;;;;c1D6f
182;École doctorale Physique et chimie-physique;;4;Chimie;2013;2012-13;2012;2012;4;0;4;10;4;6;4;2;2;;;;;3My6I
184;École doctorale Mathématiques et informatique de Marseille;;1;Mathématiques et leurs interactions;2013;2012-13;2012;2012;22;7;15;90;29;61;17;4;13;;;;;DDObG
206;École doctorale Chimie : chimie, procédés, environnement;;4;Chimie;2013;2012-13;2012;2012;100;51;49;373;173;200;84;30;54;;;;;m0UhD
211;École doctorale Sciences exactes et leurs applications;ED SEA;2;Physique;2013;2012-13;2012;2012;3;1;2;10;2;8;6;0;6;;;;;1G1iC
211;École doctorale Sciences exactes et leurs applications;ED SEA;3;Sciences de la terre et de l'univers, espace;2013;2012-13;2012;2012;3;1;2;8;4;4;2;1;1;;;;;1G1iC
211;École doctorale Sciences exactes et leurs applications;ED SEA;9;Sciences et technologies de l'information et de la communication;2013;2012-13;2012;2012;7;2;5;17;4;13;7;2;5;;;;;1G1iC
216;École doctorale Ingénierie pour la santé, la cognition, l'environnement;EDISCE;8;Sciences pour l'ingénieur;2013;2012-13;2012;2012;3;0;3;5;1;4;1;1;0;;;;;fPs1t
216;École doctorale Ingénierie pour la santé, la cognition, l'environnement;EDISCE;9;Sciences et technologies de l'information et de la communication;2013;2012-13;2012;2012;5;1;4;32;11;21;9;3;6;;;;;fPs1t
224;École doctorale Cognition, langage, interaction;;1;Mathématiques et leurs interactions;2013;2012-13;2012;2012;1;0;1;1;0;1;0;0;0;;;;;7v43e
224;École doctorale Cognition, langage, interaction;;9;Sciences et technologies de l'information et de la communication;2013;2012-13;2012;2012;1;1;0;7;2;5;2;0;2;;;;;7v43e
227;École doctorale Sciences de la nature et de l'homme;;5;Biologie, médecine et santé;2013;2012-13;2012;2012;21;15;6;77;47;30;28;19;9;;;;;xiDA5
240;École doctorale Sciences de l'homme et de la société;SHS;6;Sciences humaines et humanités;2013;2012-13;2012;2012;78;40;38;299;179;120;38;24;14;;;;;j345k
249;École doctorale Droit comparé;;7;Sciences de la société;2013;2012-13;2012;2012;28;14;14;148;81;67;13;9;4;;;;;yu36C
251;École doctorale Sciences de l'environnement;;3;Sciences de la terre et de l'univers, espace;2013;2012-13;2012;2012;24;15;9;111;63;48;27;10;17;;;;;VR28y
251;École doctorale Sciences de l'environnement;;8;Sciences pour l'ingénieur;2013;2012-13;2012;2012;6;1;5;20;10;10;4;3;1;;;;;VR28y
251;École doctorale Sciences de l'environnement;;10;Sciences agronomiques et écologiques;2013;2012-13;2012;2012;17;10;7;47;30;17;9;4;5;;;;;VR28y
260;École doctorale pluridisciplinaire;;3;Sciences de la terre et de l'univers, espace;2013;2012-13;2012;2012;9;5;4;27;15;12;2;2;0;;;;;sCk1f
260;École doctorale pluridisciplinaire;;5;Biologie, médecine et santé;2013;2012-13;2012;2012;26;15;11;80;49;31;12;5;7;;;;;sCk1f
260;École doctorale pluridisciplinaire;;10;Sciences agronomiques et écologiques;2013;2012-13;2012;2012;3;3;0;14;11;3;5;4;1;;;;;sCk1f
268;École doctorale Langage et langues : description, théorisation, transmission;;6;Sciences humaines et humanités;2013;2012-13;2012;2012;60;47;13;406;281;125;47;34;13;;;;;wAIDE
269;École doctorale Mathématiques, sciences de l'information et de l'ingénieur;MSII;1;Mathématiques et leurs interactions;2013;2012-13;2012;2012;21;6;15;75;19;56;8;1;7;;;;;5E625
285;École doctorale Sciences pratiques;;6;Sciences humaines et humanités;2013;2012-13;2012;2012;5;0;5;18;7;11;5;3;2;;;;;Jd3t2
287;École doctorale Sciences pour l'ingénieur;;9;Sciences et technologies de l'information et de la communication;2013;2012-13;2012;2012;23;9;14;49;23;26;14;4;10;;;;;48Q1j
304;École doctorale Sciences et environnements;;4;Chimie;2013;2012-13;2012;2012;0;0;0;3;3;0;0;0;0;;;;;2ywZn
305;École doctorale Énergie et environnement;E2;2;Physique;2013;2012-13;2012;2012;5;0;5;10;0;10;4;0;4;;;;;Kbt8I
305;École doctorale Énergie et environnement;E2;3;Sciences de la terre et de l'univers, espace;2013;2012-13;2012;2012;3;3;0;20;12;8;3;1;2;;;;;Kbt8I
305;École doctorale Énergie et environnement;E2;10;Sciences agronomiques et écologiques;2013;2012-13;2012;2012;2;0;2;5;0;5;0;0;0;;;;;Kbt8I
306;École doctorale Sciences des procédés, sciences des aliments;;5;Biologie, médecine et santé;2013;2012-13;2012;2012;7;2;5;18;9;9;3;3;0;;;;;adF7W
351;École doctorale Sciences physiques, mathématiques et de l'information pour l'ingénieur;SPMII;4;Chimie;2013;2012-13;2012;2012;1;1;0;8;3;5;1;1;0;;;;;rY4EP
352;École doctorale Physique et sciences de la matière;;2;Physique;2013;2012-13;2012;2012;65;17;48;236;67;169;84;23;61;;;;;fb5YC
353;École doctorale Sciences pour l'ingénieur : mécanique, physique, micro et nanoélectronique;;5;Biologie, médecine et santé;2013;2012-13;2012;2012;1;1;0;7;2;5;4;1;3;;;;;vk5Kp
359;École doctorale Mathématiques, télécommunications, informatique, signal, systèmes, électronique;MATISSE;1;Mathématiques et leurs interactions;2013;2012-13;2012;2012;15;4;11;69;21;48;23;2;21;;;;;Y0r76
359;École doctorale Mathématiques, télécommunications, informatique, signal, systèmes, électronique;MATISSE;9;Sciences et technologies de l'information et de la communication;2013;2012-13;2012;2012;130;32;98;496;116;380;109;14;95;;;;;Y0r76
361;École doctorale Sciences et Technologies;ED ST;8;Sciences pour l'ingénieur;2013;2012-13;2012;2012;14;3;11;36;6;30;8;2;6;;;;;cOUmL
364;École doctorale Sciences fondamentales et appliquées;EDSFA;2;Physique;2013;2012-13;2012;2012;13;2;11;54;13;41;12;4;8;;;;;E483q
373;École doctorale Santé, information/communications et mathématiques, matière;SICMA;9;Sciences et technologies de l'information et de la communication;2013;2012-13;2012;2012;73;23;50;220;55;165;53;11;42;;;;;hTJF5
377;École doctorale Environnement et société;;6;Sciences humaines et humanités;2013;2012-13;2012;2012;12;9;3;66;42;24;4;3;1;;;;;ZMG5u
391;École doctorale Sciences mécaniques, acoustique et électronique et robotique de Paris;SMAER;8;Sciences pour l'ingénieur;2013;2012-13;2012;2012;54;6;48;237;47;190;48;13;35;;;;;k0eue
392;École doctorale Diversité du vivant;;10;Sciences agronomiques et écologiques;2013;2012-13;2012;2012;20;13;7;46;24;22;7;3;4;;;;;537J0
395;École doctorale Milieux, cultures et sociétés du passé et du présent;MCSPP;6;Sciences humaines et humanités;2013;2012-13;2012;2012;74;54;20;478;320;158;43;31;12;;;;;2quEb
398;École doctorale Géosciences, ressources naturelles et environnement;GRNE;3;Sciences de la terre et de l'univers, espace;2013;2012-13;2012;2012;46;20;26;156;63;93;32;12;20;;;;;Zi4Zf
401;École doctorale Sciences sociales;;9;Sciences et technologies de l'information et de la communication;2013;2012-13;2012;2012;9;2;7;20;4;16;2;1;1;;;;;raQ7K
410;École doctorale Sciences et ingénierie des ressources, procédés, produits, environnement;RP2E;3;Sciences de la terre et de l'univers, espace;2013;2012-13;2012;2012;26;5;21;122;45;77;26;11;15;;;;;Q5fxV
410;École doctorale Sciences et ingénierie des ressources, procédés, produits, environnement;RP2E;4;Chimie;2013;2012-13;2012;2012;6;6;0;17;8;9;2;1;1;;;;;Q5fxV
410;École doctorale Sciences et ingénierie des ressources, procédés, produits, environnement;RP2E;10;Sciences agronomiques et écologiques;2013;2012-13;2012;2012;30;20;10;117;65;52;54;24;30;;;;;Q5fxV
412;École doctorale Lorraine de chimie et physique moléculaires : synthèses, expériences, simulations, applications : de la molécule aux édifices supramoléculaires;SESAMES;2;Physique;2013;2012-13;2012;2012;6;3;3;19;8;11;6;1;5;;;;;mvHX2
414;École doctorale Sciences de la vie et de la santé;;4;Chimie;2013;2012-13;2012;2012;0;0;0;2;2;0;1;1;0;;;;;YI4xS
422;École doctorale Sciences et technologies de l'information, des télécommunications et des systèmes;;5;Biologie, médecine et santé;2013;2012-13;2012;2012;10;4;6;54;28;26;16;8;8;;;;;998UM
423;École doctorale Des génomes aux organismes;;4;Chimie;2013;2012-13;2012;2012;0;0;0;5;3;2;2;1;1;;;;;VguHK
423;École doctorale Des génomes aux organismes;;5;Biologie, médecine et santé;2013;2012-13;2012;2012;39;20;19;141;69;72;32;16;16;;;;;VguHK
425;École doctorale Innovation thérapeutique : du fondamental à l'appliqué;;5;Biologie, médecine et santé;2013;2012-13;2012;2012;54;30;24;214;130;84;59;35;24;;;;;DkgNy
435;École doctorale Agriculture, alimentation, biologie, environnement et santé;;1;Mathématiques et leurs interactions;2013;2012-13;2012;2012;2;0;2;14;5;9;2;1;1;;;;;mC35U
435;École doctorale Agriculture, alimentation, biologie, environnement et santé;;8;Sciences pour l'ingénieur;2013;2012-13;2012;2012;8;6;2;36;22;14;10;6;4;;;;;mC35U
436;École doctorale Médicament, toxicologie, chimie, environnement;MTCE;4;Chimie;2013;2012-13;2012;2012;10;5;5;46;21;25;16;7;9;;;;;dPsg3
447;École doctorale de l'école polytechnique;;2;Physique;2013;2012-13;2012;2012;58;12;46;207;41;166;49;12;37;;;;;zgCCh
447;École doctorale de l'école polytechnique;;5;Biologie, médecine et santé;2013;2012-13;2012;2012;5;0;5;6;1;5;0;0;0;;;;;zgCCh
447;École doctorale de l'école polytechnique;;6;Sciences humaines et humanités;2013;2012-13;2012;2012;8;0;8;34;9;25;3;2;1;;;;;zgCCh
456;École doctorale Sciences du sport, de la motricité et du mouvement humain;;6;Sciences humaines et humanités;2013;2012-13;2012;2012;10;4;6;45;21;24;9;6;3;;;;;GqvEI
459;École doctorale Sciences chimiques Balard;;4;Chimie;2013;2012-13;2012;2012;94;38;56;258;119;139;63;27;36;;;;;YFs2W
467;École doctorale Aéronautique, astronautique;AA;4;Chimie;2013;2012-13;2012;2012;1;0;1;3;1;2;1;1;0;;;;;U7l45
467;École doctorale Aéronautique, astronautique;AA;8;Sciences pour l'ingénieur;2013;2012-13;2012;2012;3;1;2;20;5;15;4;0;4;;;;;U7l45
467;École doctorale Aéronautique, astronautique;AA;9;Sciences et technologies de l'information et de la communication;2013;2012-13;2012;2012;0;0;0;6;2;4;0;0;0;;;;;U7l45
469;École doctorale du Pacifique;EDP;1;Mathématiques et leurs interactions;2013;2012-13;2012;2012;0;0;0;1;0;1;0;0;0;;;;;t9Z2n
469;École doctorale du Pacifique;EDP;5;Biologie, médecine et santé;2013;2012-13;2012;2012;3;1;2;9;6;3;2;1;1;;;;;t9Z2n
469;École doctorale du Pacifique;EDP;6;Sciences humaines et humanités;2013;2012-13;2012;2012;5;3;2;18;14;4;5;4;1;;;;;t9Z2n
472;École doctorale de l'EPHE;;10;Sciences agronomiques et écologiques;2013;2012-13;2012;2012;0;0;0;0;0;0;6;4;2;;;;;27zK4
474;École doctorale Interdisciplinaire européenne frontières du vivant;FDV;6;Sciences humaines et humanités;2013;2012-13;2012;2012;0;0;0;2;0;2;1;1;0;;;;;E727j
474;École doctorale Interdisciplinaire européenne frontières du vivant;FDV;9;Sciences et technologies de l'information et de la communication;2013;2012-13;2012;2012;1;0;1;4;1;3;0;0;0;;;;;E727j
475;École doctorale Mathématiques, informatique, télécommunications de Toulouse;MITT;1;Mathématiques et leurs interactions;2013;2012-13;2012;2012;39;15;24;142;54;88;32;10;22;;;;;xcp2r
479;École doctorale Sciences juridiques et politiques;;7;Sciences de la société;2013;2012-13;2012;2012;105;57;48;482;223;259;54;28;26;;;;;34mid
480;École doctorale Montaigne-humanités;;3;Sciences de la terre et de l'univers, espace;2013;2012-13;2012;2012;6;3;3;21;8;13;4;2;2;;;;;f3SeZ
482;École doctorale Sciences de la matière;SDM;5;Biologie, médecine et santé;2013;2012-13;2012;2012;3;1;2;3;1;2;0;0;0;;;;;kmeZ4
485;École doctorale Éducation, Psychologie, Information et Communication;EPIC;6;Sciences humaines et humanités;2013;2012-13;2012;2012;73;42;31;322;198;124;39;26;13;;;;;O82eL
486;École doctorale Sciences économiques et de gestion;SEG;7;Sciences de la société;2013;2012-13;2012;2012;35;11;24;173;74;99;37;16;21;;;;;h1GZ3
489;École doctorale Sciences et ingénierie des systèmes, de l'environnement et des organisations;SISEO;4;Chimie;2013;2012-13;2012;2012;2;1;1;7;4;3;5;2;3;;;;;6pT77
491;École doctorale Langages, idées, sociétés, institutions, territoires;LISIT;7;Sciences de la société;2013;2012-13;2012;2012;39;19;20;219;107;112;33;18;15;;;;;iB25j
494;École doctorale Jean-Henri Lambert;;4;Chimie;2013;2012-13;2012;2012;23;13;10;64;28;36;27;17;10;;;;;A3m51
494;École doctorale Jean-Henri Lambert;;5;Biologie, médecine et santé;2013;2012-13;2012;2012;2;0;2;7;2;5;1;1;0;;;;;A3m51
495;École doctorale Végétal, environnement, nutrition, agroalimentaire, mer;VENAM;1;Mathématiques et leurs interactions;2013;2012-13;2012;2012;0;0;0;2;0;2;1;0;1;;;;;HL495
497;École doctorale Normande de Biologie Intégrative, Santé, Environnement;Ed NBISE;3;Sciences de la terre et de l'univers, espace;2013;2012-13;2012;2012;3;2;1;16;6;10;4;2;2;;;;;0D9Je
497;École doctorale Normande de Biologie Intégrative, Santé, Environnement;Ed NBISE;10;Sciences agronomiques et écologiques;2013;2012-13;2012;2012;8;5;3;21;13;8;1;1;0;;;;;0D9Je
498;École doctorale Sciences pour l'ingénieur, géosciences, architecture;SPIGA;10;Sciences agronomiques et écologiques;2013;2012-13;2012;2012;0;0;0;0;0;0;1;0;1;;;;;0vlKH
500;École doctorale Matière, molécules, matériaux en Pays de Loire;3MPL;4;Chimie;2013;2012-13;2012;2012;37;15;22;146;53;93;33;10;23;;;;;822tM
500;École doctorale Matière, molécules, matériaux en Pays de Loire;3MPL;5;Biologie, médecine et santé;2013;2012-13;2012;2012;1;1;0;1;1;0;0;0;0;;;;;822tM
500;École doctorale Matière, molécules, matériaux en Pays de Loire;3MPL;8;Sciences pour l'ingénieur;2013;2012-13;2012;2012;4;0;4;15;2;13;3;0;3;;;;;822tM
501;École doctorale Droit, économie-gestion, sociétés, territoires;;7;Sciences de la société;2013;2012-13;2012;2012;74;31;43;342;160;182;37;18;19;;;;;wE7WM
503;École doctorale Sciences et technologies de l'information et de mathématiques;STIM;1;Mathématiques et leurs interactions;2013;2012-13;2012;2012;15;5;10;56;18;38;8;1;7;;;;;JQevP
505;École doctorale Sciences de l'homme, des organisations et de la société;SHOS;6;Sciences humaines et humanités;2013;2012-13;2012;2012;8;2;6;22;5;17;2;0;2;;;;;qts78
508;École doctorale Normande de chimie;EDNC;4;Chimie;2013;2012-13;2012;2012;36;15;21;152;74;78;35;19;16;;;;;E52OO
510;École doctorale Ingénierie - Matériaux, mécanique, environnement, énergétique, procédés, production;IMEP2;4;Chimie;2013;2012-13;2012;2012;20;14;6;84;40;44;27;8;19;;;;;Ce7NF
510;École doctorale Ingénierie - Matériaux, mécanique, environnement, énergétique, procédés, production;IMEP2;8;Sciences pour l'ingénieur;2013;2012-13;2012;2012;107;35;72;411;134;277;87;29;58;;;;;Ce7NF
510;École doctorale Ingénierie - Matériaux, mécanique, environnement, énergétique, procédés, production;IMEP2;9;Sciences et technologies de l'information et de la communication;2013;2012-13;2012;2012;1;0;1;2;0;2;1;0;1;;;;;Ce7NF
522;École doctorale Sciences et ingénierie en matériaux, mécanique, énergétique et aéronautique;SI-MMEA;2;Physique;2013;2012-13;2012;2012;8;4;4;22;6;16;4;1;3;;;;;82F19
522;École doctorale Sciences et ingénierie en matériaux, mécanique, énergétique et aéronautique;SI-MMEA;8;Sciences pour l'ingénieur;2013;2012-13;2012;2012;57;11;46;243;49;194;70;19;51;;;;;82F19
523;École doctorale Sciences pour l'environnement - Gay Lussac;;3;Sciences de la terre et de l'univers, espace;2013;2012-13;2012;2012;12;3;9;34;15;19;11;3;8;;;;;6xD69
523;École doctorale Sciences pour l'environnement - Gay Lussac;;4;Chimie;2013;2012-13;2012;2012;29;14;15;85;38;47;36;15;21;;;;;6xD69
523;École doctorale Sciences pour l'environnement - Gay Lussac;;5;Biologie, médecine et santé;2013;2012-13;2012;2012;0;0;0;8;5;3;9;6;3;;;;;6xD69
528;École doctorale Ville, transports et territoires;VTT;8;Sciences pour l'ingénieur;2013;2012-13;2012;2012;1;0;1;7;2;5;2;0;2;;;;;68zCc
532;École doctorale Mathématiques et sciences et technologies de l'information et de la communication;MSTIC;9;Sciences et technologies de l'information et de la communication;2013;2012-13;2012;2012;43;9;34;162;48;114;34;4;30;;;;;t43KM
538;École doctorale Culture, régulation, institutions et territoire;CRIT;6;Sciences humaines et humanités;2013;2012-13;2012;2012;33;19;14;155;82;73;10;4;6;;;;;8T505
539;École doctorale Sciences et technologies de Versailles;;3;Sciences de la terre et de l'univers, espace;2013;2012-13;2012;2012;3;1;2;4;1;3;0;0;0;;;;;nv3h8
539;École doctorale Sciences et technologies de Versailles;;9;Sciences et technologies de l'information et de la communication;2013;2012-13;2012;2012;14;7;7;67;23;44;15;4;11;;;;;nv3h8
542;École doctorale de sciences de La Réunion;STS;5;Biologie, médecine et santé;2013;2012-13;2012;2012;9;2;7;24;9;15;2;1;1;;;;;2pAql
546;École doctorale Abbé Grégoire;;5;Biologie, médecine et santé;2013;2012-13;2012;2012;0;0;0;11;4;7;4;3;1;;;;;ZSn7q
547;École doctorale Sciences, Technologie, Santé;EDSTS;4;Chimie;2013;2012-13;2012;2012;16;9;7;85;43;42;10;3;7;;;;;wEdn2
547;École doctorale Sciences, Technologie, Santé;EDSTS;5;Biologie, médecine et santé;2013;2012-13;2012;2012;38;22;16;140;74;66;30;13;17;;;;;wEdn2
548;École doctorale Mer et Sciences;;1;Mathématiques et leurs interactions;2013;2012-13;2012;2012;2;1;1;8;2;6;0;0;0;;;;;QX0fS
549;École doctorale Santé, Sciences Biologiques et Chimie du Vivant;SSBCV;10;Sciences agronomiques et écologiques;2013;2012-13;2012;2012;7;0;7;10;3;7;7;6;1;;;;;B9ggO
551;École doctorale Mathématiques, Informatique, Physique Théorique et Ingénierie des Systèmes;MIPTIS;1;Mathématiques et leurs interactions;2013;2012-13;2012;2012;10;3;7;23;7;16;14;6;8;;;;;Mpudz
553;École doctorale Carnot - Pasteur;;1;Mathématiques et leurs interactions;2013;2012-13;2012;2012;16;6;10;47;13;34;9;3;6;;;;;6h4Z7
553;École doctorale Carnot - Pasteur;;3;Sciences de la terre et de l'univers, espace;2013;2012-13;2012;2012;1;0;1;4;0;4;0;0;0;;;;;6h4Z7
553;École doctorale Carnot - Pasteur;;4;Chimie;2013;2012-13;2012;2012;19;6;13;112;35;77;32;12;20;;;;;6h4Z7
554;École doctorale Environnements - Santé;E-S;3;Sciences de la terre et de l'univers, espace;2013;2012-13;2012;2012;2;1;1;12;5;7;1;0;1;;;;;ElyFU
6;École doctorale Droit privé;;7;Sciences de la société;2012;2011-12;2011;2011;62;33;29;297;143;154;32;18;14;;;;;UMnW1
31;École doctorale Pratiques et théories du sens;;6;Sciences humaines et humanités;2012;2011-12;2011;2011;120;79;41;579;345;234;79;45;34;;;;;1S466
34;École doctorale Matériaux;;2;Physique;2012;2011-12;2011;2011;7;5;2;40;16;24;24;10;14;;;;;1Iufh
47;École doctorale Physique;;2;Physique;2012;2011-12;2011;2011;98;29;69;367;95;272;81;19;62;;;;;8kNpd
67;École doctorale Sciences juridiques et politiques;;7;Sciences de la société;2012;2011-12;2011;2011;146;73;73;723;346;377;76;33;43;;;;;qrOj1
68;École doctorale Littératures, cultures et sciences sociales;;6;Sciences humaines et humanités;2012;2011-12;2011;2011;74;36;38;332;171;161;33;14;19;;;;;NZuM2
71;École doctorale Sciences pour l'ingénieur;;7;Sciences de la société;2012;2011-12;2011;2011;5;3;2;20;9;11;5;2;3;;;;;H6UYp
72;École doctorale Sciences pour l'ingénieur;SPI;9;Sciences et technologies de l'information et de la communication;2012;2011-12;2011;2011;86;23;63;362;114;248;96;23;73;;;;;47QPx
73;École doctorale Sciences économiques, sociales, de l'aménagement et du management;SESAM;7;Sciences de la société;2012;2011-12;2011;2011;61;21;40;259;121;138;26;6;20;;;;;IQ0Hk
77;École doctorale Informatique, automatique, électronique, électrotechnique, mathématiques;IAEM;1;Mathématiques et leurs interactions;2012;2011-12;2011;2011;11;4;7;50;10;40;11;3;8;;;;;TCHTA
77;École doctorale Informatique, automatique, électronique, électrotechnique, mathématiques;IAEM;6;Sciences humaines et humanités;2012;2011-12;2011;2011;0;0;0;6;2;4;1;1;0;;;;;TCHTA
84;École doctorale Sciences et technologies de l'information et de la communication;STIC;1;Mathématiques et leurs interactions;2012;2011-12;2011;2011;1;0;1;4;2;2;2;1;1;;;;;9wS2W
98;École doctorale Droit-Normandie;EDDN;7;Sciences de la société;2012;2011-12;2011;2011;28;16;12;147;69;78;6;5;1;;;;;9fYyW
101;École doctorale de Sciences juridiques;;7;Sciences de la société;2012;2011-12;2011;2011;66;34;32;317;162;155;36;16;20;;;;;569G2
102;École doctorale Santé, sciences, technologies;;6;Sciences humaines et humanités;2012;2011-12;2011;2011;2;2;0;3;3;0;1;0;1;;;;;4h65n
105;École doctorale Terre, univers, environnement;;3;Sciences de la terre et de l'univers, espace;2012;2011-12;2011;2011;51;19;32;205;82;123;55;23;32;;;;;lcWAf
127;École doctorale Astronomie et astrophysique d'Ile de France;A&A;3;Sciences de la terre et de l'univers, espace;2012;2011-12;2011;2011;44;15;29;167;63;104;38;14;24;;;;;cPXrq
129;École doctorale Sciences de l'environnement d'Ile de France;SEIF;3;Sciences de la terre et de l'univers, espace;2012;2011-12;2011;2011;48;25;23;211;101;110;45;19;26;;;;;TnAPh
132;École doctorale Sciences du langage;;6;Sciences humaines et humanités;2012;2011-12;2011;2011;24;16;8;115;72;43;21;14;7;;;;;5AUF1
139;École doctorale Connaissance, langage, modélisation;CLM;6;Sciences humaines et humanités;2012;2011-12;2011;2011;98;63;35;380;203;177;72;36;36;;;;;1lxGH
139;École doctorale Connaissance, langage, modélisation;CLM;8;Sciences pour l'ingénieur;2012;2011-12;2011;2011;9;4;5;34;4;30;6;1;5;;;;;1lxGH
149;École doctorale Carnot;;8;Sciences pour l'ingénieur;2012;2011-12;2011;2011;4;2;2;19;6;13;3;0;3;;;;;zuThw
151;École doctorale Biologie, santé, biotechnologies;;5;Biologie, médecine et santé;2012;2011-12;2011;2011;78;53;25;333;200;133;77;55;22;;;;;yP8w4
154;École doctorale Sciences de la vie et de la santé;SVS;5;Biologie, médecine et santé;2012;2011-12;2011;2011;89;48;41;272;148;124;77;37;40;;;;;hLn36
156;École doctorale Sciences de la mer;;3;Sciences de la terre et de l'univers, espace;2012;2011-12;2011;2011;16;5;11;63;24;39;13;5;8;;;;;EGY9P
156;École doctorale Sciences de la mer;;5;Biologie, médecine et santé;2012;2011-12;2011;2011;15;10;5;55;29;26;18;12;6;;;;;EGY9P
156;École doctorale Sciences de la mer;;7;Sciences de la société;2012;2011-12;2011;2011;3;2;1;22;8;14;3;1;2;;;;;EGY9P
166;École doctorale Information, structures et systèmes;I2S;9;Sciences et technologies de l'information et de la communication;2012;2011-12;2011;2011;36;4;32;164;28;136;56;14;42;;;;;2uO68
168;École doctorale Sciences chimiques et biologiques pour la santé;SCBS;5;Biologie, médecine et santé;2012;2011-12;2011;2011;78;48;30;332;197;135;98;52;46;;;;;8cEME
171;École doctorale Toulouse sciences économiques;TSE;7;Sciences de la société;2012;2011-12;2011;2011;26;6;20;88;28;60;24;8;16;;;;;Q5nNQ
177;École doctorale Sciences et technologies de l'université d'Orléans;;8;Sciences pour l'ingénieur;2012;2011-12;2011;2011;19;5;14;55;11;44;16;4;12;;;;;JI65m
177;École doctorale Sciences et technologies de l'université d'Orléans;;9;Sciences et technologies de l'information et de la communication;2012;2011-12;2011;2011;12;1;11;48;5;43;15;1;14;;;;;JI65m
181;École doctorale Structure, informations, matière et matériaux;Simem;1;Mathématiques et leurs interactions;2012;2011-12;2011;2011;4;2;2;13;4;9;7;0;7;;;;;c1D6f
181;École doctorale Structure, informations, matière et matériaux;Simem;2;Physique;2012;2011-12;2011;2011;11;2;9;48;13;35;22;4;18;;;;;c1D6f
184;École doctorale Mathématiques et informatique de Marseille;;1;Mathématiques et leurs interactions;2012;2011-12;2011;2011;15;6;9;76;19;57;24;7;17;;;;;DDObG
205;École doctorale Interdisciplinaire Sciences-Santé;EDISS;5;Biologie, médecine et santé;2012;2011-12;2011;2011;49;24;25;235;123;112;67;33;34;;;;;69W38
205;École doctorale Interdisciplinaire Sciences-Santé;EDISS;7;Sciences de la société;2012;2011-12;2011;2011;5;4;1;36;22;14;8;2;6;;;;;69W38
209;École doctorale Sciences physiques et de L'ingénieur;SPI;3;Sciences de la terre et de l'univers, espace;2012;2011-12;2011;2011;3;0;3;10;5;5;2;0;2;;;;;tZcIZ
209;École doctorale Sciences physiques et de L'ingénieur;SPI;8;Sciences pour l'ingénieur;2012;2011-12;2011;2011;19;6;13;113;32;81;22;8;14;;;;;tZcIZ
211;École doctorale Sciences exactes et leurs applications;ED SEA;1;Mathématiques et leurs interactions;2012;2011-12;2011;2011;9;1;8;23;6;17;7;1;6;;;;;1G1iC
211;École doctorale Sciences exactes et leurs applications;ED SEA;2;Physique;2012;2011-12;2011;2011;4;1;3;12;1;11;7;3;4;;;;;1G1iC
217;École doctorale Mathématiques, sciences et technologies de l'information, informatique;MSTII;1;Mathématiques et leurs interactions;2012;2011-12;2011;2011;26;9;17;95;25;70;17;5;12;;;;;Ehx7v
220;École doctorale Électronique, électrotechnique, automatique, traitement du signal;EEATS;9;Sciences et technologies de l'information et de la communication;2012;2011-12;2011;2011;116;26;90;418;100;318;99;25;74;;;;;IxEaw
224;École doctorale Cognition, langage, interaction;;6;Sciences humaines et humanités;2012;2011-12;2011;2011;45;33;12;187;129;58;22;16;6;;;;;7v43e
227;École doctorale Sciences de la nature et de l'homme;;7;Sciences de la société;2012;2011-12;2011;2011;2;1;1;2;1;1;1;0;1;;;;;xiDA5
238;École doctorale Sciences humaines et sociales;;6;Sciences humaines et humanités;2012;2011-12;2011;2011;54;29;25;205;109;96;34;19;15;;;;;lr2wn
242;École doctorale Économie - Gestion - Normandie;;7;Sciences de la société;2012;2011-12;2011;2011;30;14;16;129;53;76;20;8;12;;;;;z35ku
251;École doctorale Sciences de l'environnement;;5;Biologie, médecine et santé;2012;2011-12;2011;2011;5;2;3;19;10;9;3;2;1;;;;;VR28y
254;École doctorale Sciences de la matière;;6;Sciences humaines et humanités;2012;2011-12;2011;2011;2;1;1;13;9;4;5;2;3;;;;;365F2
260;École doctorale pluridisciplinaire;;1;Mathématiques et leurs interactions;2012;2011-12;2011;2011;5;2;3;27;16;11;3;2;1;;;;;sCk1f
260;École doctorale pluridisciplinaire;;2;Physique;2012;2011-12;2011;2011;5;5;0;19;13;6;0;0;0;;;;;sCk1f
260;École doctorale pluridisciplinaire;;3;Sciences de la terre et de l'univers, espace;2012;2011-12;2011;2011;2;2;0;7;6;1;14;9;5;;;;;sCk1f
260;École doctorale pluridisciplinaire;;6;Sciences humaines et humanités;2012;2011-12;2011;2011;34;19;15;102;67;35;3;3;0;;;;;sCk1f
269;École doctorale Mathématiques, sciences de l'information et de l'ingénieur;MSII;4;Chimie;2012;2011-12;2011;2011;0;0;0;1;1;0;0;0;0;;;;;5E625
269;École doctorale Mathématiques, sciences de l'information et de l'ingénieur;MSII;8;Sciences pour l'ingénieur;2012;2011-12;2011;2011;35;6;29;112;18;94;34;5;29;;;;;5E625
281;École doctorale Droit public et droit fiscal;;7;Sciences de la société;2012;2011-12;2011;2011;45;20;25;502;239;263;18;9;9;;;;;jr1Nt
285;École doctorale Sciences pratiques;;1;Mathématiques et leurs interactions;2012;2011-12;2011;2011;7;3;4;30;5;25;10;3;7;;;;;Jd3t2
285;École doctorale Sciences pratiques;;4;Chimie;2012;2011-12;2011;2011;4;2;2;18;8;10;5;2;3;;;;;Jd3t2
286;École doctorale de l'Ehess;;6;Sciences humaines et humanités;2012;2011-12;2011;2011;164;94;70;767;447;320;105;54;51;;;;;2S146
304;École doctorale Sciences et environnements;;5;Biologie, médecine et santé;2012;2011-12;2011;2011;4;3;1;25;12;13;7;3;4;;;;;2ywZn
304;École doctorale Sciences et environnements;;6;Sciences humaines et humanités;2012;2011-12;2011;2011;1;1;0;16;7;9;5;1;4;;;;;2ywZn
304;École doctorale Sciences et environnements;;7;Sciences de la société;2012;2011-12;2011;2011;4;4;0;13;10;3;4;3;1;;;;;2ywZn
305;École doctorale Énergie et environnement;E2;2;Physique;2012;2011-12;2011;2011;1;0;1;9;1;8;0;0;0;;;;;Kbt8I
305;École doctorale Énergie et environnement;E2;8;Sciences pour l'ingénieur;2012;2011-12;2011;2011;9;3;6;43;10;33;10;0;10;;;;;Kbt8I
326;École doctorale Comportement, langage, éducation, socialisation, cognition;CLESCO;6;Sciences humaines et humanités;2012;2011-12;2011;2011;55;39;16;249;169;80;41;30;11;;;;;nWIlG
341;École doctorale Évolution, écosystèmes, microbiologie, modélisation;E2M2;5;Biologie, médecine et santé;2012;2011-12;2011;2011;8;7;1;30;23;7;11;9;2;;;;;J83I0
351;École doctorale Sciences physiques, mathématiques et de l'information pour l'ingénieur;SPMII;8;Sciences pour l'ingénieur;2012;2011-12;2011;2011;34;9;25;151;38;113;34;6;28;;;;;rY4EP
353;École doctorale Sciences pour l'ingénieur : mécanique, physique, micro et nanoélectronique;;8;Sciences pour l'ingénieur;2012;2011-12;2011;2011;45;11;34;161;36;125;34;3;31;;;;;vk5Kp
354;École doctorale Langues, lettres et arts;LLA;6;Sciences humaines et humanités;2012;2011-12;2011;2011;47;27;20;145;97;48;17;10;7;;;;;RwcSv
358;École doctorale Sciences, technologies, santé;;1;Mathématiques et leurs interactions;2012;2011-12;2011;2011;1;0;1;4;0;4;1;0;1;;;;;OZA3U
358;École doctorale Sciences, technologies, santé;;2;Physique;2012;2011-12;2011;2011;3;0;3;22;9;13;4;2;2;;;;;OZA3U
358;École doctorale Sciences, technologies, santé;;3;Sciences de la terre et de l'univers, espace;2012;2011-12;2011;2011;0;0;0;5;2;3;2;1;1;;;;;OZA3U
361;École doctorale Sciences et Technologies;ED ST;8;Sciences pour l'ingénieur;2012;2011-12;2011;2011;7;1;6;33;6;27;5;2;3;;;;;cOUmL
364;École doctorale Sciences fondamentales et appliquées;EDSFA;3;Sciences de la terre et de l'univers, espace;2012;2011-12;2011;2011;31;14;17;92;31;61;12;5;7;;;;;E483q
368;École doctorale Sciences et santé;;1;Mathématiques et leurs interactions;2012;2011-12;2011;2011;6;1;5;20;5;15;3;1;2;;;;;4L0a1
368;École doctorale Sciences et santé;;10;Sciences agronomiques et écologiques;2012;2011-12;2011;2011;7;5;2;19;9;10;7;4;3;;;;;4L0a1
369;École doctorale Homme, environnement, santé;;3;Sciences de la terre et de l'univers, espace;2012;2011-12;2011;2011;2;0;2;4;0;4;2;0;2;;;;;uZ8W7
371;École doctorale Louis Pasteur;;7;Sciences de la société;2012;2011-12;2011;2011;4;0;4;8;1;7;0;0;0;;;;;2tr4F
377;École doctorale Environnement et société;;4;Chimie;2012;2011-12;2011;2011;5;3;2;19;8;11;4;0;4;;;;;ZMG5u
377;École doctorale Environnement et société;;7;Sciences de la société;2012;2011-12;2011;2011;2;0;2;36;7;29;9;4;5;;;;;ZMG5u
389;École doctorale La physique, de la particule à la matière condensée;;2;Physique;2012;2011-12;2011;2011;30;8;22;126;31;95;26;10;16;;;;;2ydfg
394;École doctorale Physiologie et physiopathologie;p2t;5;Biologie, médecine et santé;2012;2011-12;2011;2011;78;46;32;270;157;113;67;36;31;;;;;VMYmT
396;École doctorale Économie, organisations, société;EOS;1;Mathématiques et leurs interactions;2012;2011-12;2011;2011;0;0;0;2;1;1;1;0;1;;;;;Es5e7
400;École doctorale Savoirs scientifiques : épistémologie, histoire des sciences, didactique des disciplines;;3;Sciences de la terre et de l'univers, espace;2012;2011-12;2011;2011;0;0;0;0;0;0;7;2;5;;;;;nRax3
401;École doctorale Sciences sociales;;9;Sciences et technologies de l'information et de la communication;2012;2011-12;2011;2011;4;1;3;16;5;11;3;1;2;;;;;raQ7K
409;École doctorale Énergie, mécanique, matériaux;EMMA;8;Sciences pour l'ingénieur;2012;2011-12;2011;2011;30;2;28;124;23;101;26;7;19;;;;;KXlbK
410;École doctorale Sciences et ingénierie des ressources, procédés, produits, environnement;RP2E;3;Sciences de la terre et de l'univers, espace;2012;2011-12;2011;2011;14;5;9;92;38;54;15;5;10;;;;;Q5fxV
410;École doctorale Sciences et ingénierie des ressources, procédés, produits, environnement;RP2E;10;Sciences agronomiques et écologiques;2012;2011-12;2011;2011;33;14;19;162;82;80;40;21;19;;;;;Q5fxV
411;École doctorale Humanités nouvelles : Fernand Braudel;;6;Sciences humaines et humanités;2012;2011-12;2011;2011;37;20;17;158;76;82;8;6;2;;;;;l2rFh
413;École doctorale Sciences de la terre et de l'environnement;STE;3;Sciences de la terre et de l'univers, espace;2012;2011-12;2011;2011;18;13;5;72;35;37;19;8;11;;;;;u9BA9
418;École doctorale Cancérologie : Biologie, médecine, santé;;5;Biologie, médecine et santé;2012;2011-12;2011;2011;51;31;20;228;142;86;49;28;21;;;;;gYm19
419;École doctorale Signalisations et réseaux intégratifs en biologie;BIO-SIGNE;5;Biologie, médecine et santé;2012;2011-12;2011;2011;37;28;9;144;89;55;40;24;16;;;;;rDuFq
420;École doctorale Santé publique Paris 11 - Paris 5;;1;Mathématiques et leurs interactions;2012;2011-12;2011;2011;5;3;2;18;12;6;4;3;1;;;;;3BNdi
426;École doctorale Gènes, génomes, cellules;;5;Biologie, médecine et santé;2012;2011-12;2011;2011;28;16;12;124;68;56;37;21;16;;;;;XPaY8
435;École doctorale Agriculture, alimentation, biologie, environnement et santé;;2;Physique;2012;2011-12;2011;2011;0;0;0;0;0;0;1;0;1;;;;;mC35U
435;École doctorale Agriculture, alimentation, biologie, environnement et santé;;5;Biologie, médecine et santé;2012;2011-12;2011;2011;25;12;13;123;77;46;25;18;7;;;;;mC35U
435;École doctorale Agriculture, alimentation, biologie, environnement et santé;;8;Sciences pour l'ingénieur;2012;2011-12;2011;2011;12;5;7;42;23;19;10;4;6;;;;;mC35U
447;École doctorale de l'école polytechnique;;8;Sciences pour l'ingénieur;2012;2011-12;2011;2011;21;8;13;100;22;78;22;5;17;;;;;zgCCh
454;École doctorale Sciences de l'homme, du politique et du territoire;SHPT;6;Sciences humaines et humanités;2012;2011-12;2011;2011;38;24;14;212;111;101;19;12;7;;;;;Opv31
460;École doctorale Sciences juridiques;SJ;7;Sciences de la société;2012;2011-12;2011;2011;20;8;12;146;66;80;12;6;6;;;;;ZB5I5
463;École doctorale Sciences du mouvement humain;SMH;5;Biologie, médecine et santé;2012;2011-12;2011;2011;14;4;10;65;17;48;19;5;14;;;;;UbtlY
463;École doctorale Sciences du mouvement humain;SMH;6;Sciences humaines et humanités;2012;2011-12;2011;2011;6;2;4;15;4;11;3;1;2;;;;;UbtlY
467;École doctorale Aéronautique, astronautique;AA;8;Sciences pour l'ingénieur;2012;2011-12;2011;2011;8;3;5;32;7;25;4;0;4;;;;;U7l45
469;École doctorale du Pacifique;EDP;2;Physique;2012;2011-12;2011;2011;0;0;0;2;0;2;0;0;0;;;;;t9Z2n
469;École doctorale du Pacifique;EDP;3;Sciences de la terre et de l'univers, espace;2012;2011-12;2011;2011;6;3;3;11;6;5;0;0;0;;;;;t9Z2n
469;École doctorale du Pacifique;EDP;6;Sciences humaines et humanités;2012;2011-12;2011;2011;7;4;3;25;18;7;2;1;1;;;;;t9Z2n
472;École doctorale de l'EPHE;;10;Sciences agronomiques et écologiques;2012;2011-12;2011;2011;8;4;4;40;18;22;11;5;6;;;;;27zK4
474;École doctorale Interdisciplinaire européenne frontières du vivant;FDV;2;Physique;2012;2011-12;2011;2011;7;3;4;17;6;11;1;0;1;;;;;E727j
477;École doctorale Systèmes intégrés en biologie, agronomie, géosciences, hydrosciences, environnement;SIBAGHE;3;Sciences de la terre et de l'univers, espace;2012;2011-12;2011;2011;23;8;15;87;39;48;15;6;9;;;;;zfN3N
483;École doctorale Histoire, géographie, aménagement, urbanisme, archéologie, science politique, sociologie, anthropologie;SCSO;7;Sciences de la société;2012;2011-12;2011;2011;79;45;34;394;197;197;56;26;30;;;;;hc6u4
485;École doctorale Éducation, Psychologie, Information et Communication;EPIC;9;Sciences et technologies de l'information et de la communication;2012;2011-12;2011;2011;2;2;0;43;29;14;7;6;1;;;;;O82eL
488;École doctorale Sciences, ingénierie, santé;SIS;10;Sciences agronomiques et écologiques;2012;2011-12;2011;2011;1;1;0;6;3;3;1;0;1;;;;;Fy2lK
489;École doctorale Sciences et ingénierie des systèmes, de l'environnement et des organisations;SISEO;8;Sciences pour l'ingénieur;2012;2011-12;2011;2011;10;2;8;54;10;44;13;3;10;;;;;6pT77
497;École doctorale Normande de Biologie Intégrative, Santé, Environnement;Ed NBISE;3;Sciences de la terre et de l'univers, espace;2012;2011-12;2011;2011;5;2;3;14;5;9;3;0;3;;;;;0D9Je
497;École doctorale Normande de Biologie Intégrative, Santé, Environnement;Ed NBISE;10;Sciences agronomiques et écologiques;2012;2011-12;2011;2011;3;1;2;15;8;7;3;1;2;;;;;0D9Je
501;École doctorale Droit, économie-gestion, sociétés, territoires;;6;Sciences humaines et humanités;2012;2011-12;2011;2011;23;11;12;95;42;53;9;1;8;;;;;wE7WM
501;École doctorale Droit, économie-gestion, sociétés, territoires;;7;Sciences de la société;2012;2011-12;2011;2011;69;34;35;336;158;178;37;17;20;;;;;wE7WM
509;École doctorale Civilisations et sociétés euro-méditerranéennes et comparées;;6;Sciences humaines et humanités;2012;2011-12;2011;2011;12;10;2;61;37;24;4;3;1;;;;;9tbyG
510;École doctorale Ingénierie - Matériaux, mécanique, environnement, énergétique, procédés, production;IMEP2;4;Chimie;2012;2011-12;2011;2011;22;11;11;96;39;57;20;9;11;;;;;Ce7NF
511;École doctorale Sciences et ingénierie;S&I;8;Sciences pour l'ingénieur;2012;2011-12;2011;2011;1;0;1;9;4;5;1;0;1;;;;;7aXuB
514;École doctorale Études anglophones, germanophones et européennes;EDEAGE;6;Sciences humaines et humanités;2012;2011-12;2011;2011;44;34;10;235;172;63;46;28;18;;;;;fuIQs
521;École doctorale Sciences et ingénierie pour l'information, mathématiques;S2I;9;Sciences et technologies de l'information et de la communication;2012;2011-12;2011;2011;51;10;41;199;45;154;55;7;48;;;;;V6i83
523;École doctorale Sciences pour l'environnement - Gay Lussac;;6;Sciences humaines et humanités;2012;2011-12;2011;2011;0;0;0;4;2;2;1;1;0;;;;;6xD69
528;École doctorale Ville, transports et territoires;VTT;6;Sciences humaines et humanités;2012;2011-12;2011;2011;38;17;21;194;112;82;28;18;10;;;;;68zCc
531;École doctorale Sciences, ingénierie et environnement;SIE;4;Chimie;2012;2011-12;2011;2011;12;6;6;50;21;29;9;8;1;;;;;b5BYq
531;École doctorale Sciences, ingénierie et environnement;SIE;8;Sciences pour l'ingénieur;2012;2011-12;2011;2011;48;15;33;172;49;123;42;12;30;;;;;b5BYq
532;École doctorale Mathématiques et sciences et technologies de l'information et de la communication;MSTIC;1;Mathématiques et leurs interactions;2012;2011-12;2011;2011;19;8;11;69;20;49;14;3;11;;;;;t43KM
534;École doctorale Modélisation et instrumentation en physique, énergie, géosciences et environnement;MIPEGE;2;Physique;2012;2011-12;2011;2011;24;10;14;80;26;54;14;4;10;;;;;K93eR
534;École doctorale Modélisation et instrumentation en physique, énergie, géosciences et environnement;MIPEGE;3;Sciences de la terre et de l'univers, espace;2012;2011-12;2011;2011;17;9;8;68;24;44;14;3;11;;;;;K93eR
535;École doctorale Sciences de la société;SDS;7;Sciences de la société;2012;2011-12;2011;2011;27;18;9;86;49;37;8;5;3;;;;;iEUOV
536;École doctorale Sciences et agrosciences;;9;Sciences et technologies de l'information et de la communication;2012;2011-12;2011;2011;3;1;2;24;2;22;7;1;6;;;;;pHfqe
536;École doctorale Sciences et agrosciences;;10;Sciences agronomiques et écologiques;2012;2011-12;2011;2011;9;7;2;31;21;10;0;0;0;;;;;pHfqe
538;École doctorale Culture, régulation, institutions et territoire;CRIT;7;Sciences de la société;2012;2011-12;2011;2011;56;23;33;232;111;121;16;5;11;;;;;8T505
539;École doctorale Sciences et technologies de Versailles;;2;Physique;2012;2011-12;2011;2011;5;1;4;14;4;10;8;2;6;;;;;nv3h8
540;"École doctorale École transdisciplinaire ""lettres/sciences""";;6;Sciences humaines et humanités;2012;2011-12;2011;2011;9;6;3;15;8;7;0;0;0;;;;;tWWw7
542;École doctorale de sciences de La Réunion;STS;4;Chimie;2012;2011-12;2011;2011;2;1;1;10;7;3;3;1;2;;;;;2pAql
542;École doctorale de sciences de La Réunion;STS;5;Biologie, médecine et santé;2012;2011-12;2011;2011;5;2;3;20;9;11;2;2;0;;;;;2pAql
542;École doctorale de sciences de La Réunion;STS;8;Sciences pour l'ingénieur;2012;2011-12;2011;2011;11;4;7;27;10;17;3;1;2;;;;;2pAql
545;École doctorale Sociétés, politique et santé publique;SP2;5;Biologie, médecine et santé;2012;2011-12;2011;2011;17;11;6;50;28;22;7;3;4;;;;;IAKR4
546;École doctorale Abbé Grégoire;;2;Physique;2012;2011-12;2011;2011;4;1;3;4;1;3;0;0;0;;;;;ZSn7q
546;École doctorale Abbé Grégoire;;4;Chimie;2012;2011-12;2011;2011;1;0;1;1;0;1;0;0;0;;;;;ZSn7q
546;École doctorale Abbé Grégoire;;8;Sciences pour l'ingénieur;2012;2011-12;2011;2011;1;1;0;1;1;0;0;0;0;;;;;ZSn7q
34;École doctorale Matériaux;;3;Sciences de la terre et de l'univers, espace;2015;2014-15;2014;2014;0;0;0;1;0;1;0;0;0;;;;;1Iufh
37;École doctorale Sciences physiques pour l'ingénieur et microtechniques;SPIM;8;Sciences pour l'ingénieur;2015;2014-15;2014;2014;53;12;41;202;42;160;58;16;42;;;;;F7G1B
37;École doctorale Sciences physiques pour l'ingénieur et microtechniques;SPIM;9;Sciences et technologies de l'information et de la communication;2015;2014-15;2014;2014;58;12;46;223;53;170;46;7;39;;;;;F7G1B
38;École doctorale Langages, espaces, temps, sociétés;;6;Sciences humaines et humanités;2015;2014-15;2014;2014;47;22;25;268;136;132;30;19;11;;;;;pGgDX
38;École doctorale Langages, espaces, temps, sociétés;;7;Sciences de la société;2015;2014-15;2014;2014;18;9;9;38;21;17;1;0;1;;;;;pGgDX
42;École doctorale Entreprise, économie, société;EES;7;Sciences de la société;2015;2014-15;2014;2014;18;7;11;130;53;77;22;7;15;;;;;uO01d
47;École doctorale Physique;;5;Biologie, médecine et santé;2015;2014-15;2014;2014;1;0;1;5;3;2;4;1;3;;;;;8kNpd
47;École doctorale Physique;;8;Sciences pour l'ingénieur;2015;2014-15;2014;2014;4;0;4;9;2;7;1;1;0;;;;;8kNpd
60;École doctorale Territoires, temps, sociétés et développement;TTSD;10;Sciences agronomiques et écologiques;2015;2014-15;2014;2014;1;1;0;3;3;0;1;0;1;;;;;fkIh6
70;École doctorale Sciences pour l'ingénieur;EDSPI;8;Sciences pour l'ingénieur;2015;2014-15;2014;2014;12;2;10;45;13;32;15;2;13;;;;;G413P
70;École doctorale Sciences pour l'ingénieur;EDSPI;9;Sciences et technologies de l'information et de la communication;2015;2014-15;2014;2014;42;6;36;160;32;128;32;4;28;;;;;G413P
73;École doctorale Sciences économiques, sociales, de l'aménagement et du management;SESAM;7;Sciences de la société;2015;2014-15;2014;2014;49;30;19;257;124;133;39;18;21;;;;;IQ0Hk
77;École doctorale Informatique, automatique, électronique, électrotechnique, mathématiques;IAEM;9;Sciences et technologies de l'information et de la communication;2015;2014-15;2014;2014;66;19;47;227;60;167;48;9;39;;;;;TCHTA
78;École doctorale Sociétés, langages, temps, connaissances;STLC;6;Sciences humaines et humanités;2015;2014-15;2014;2014;43;29;14;193;128;65;30;21;9;;;;;vLU3i
92;École doctorale Vie -  Agro - Santé;;5;Biologie, médecine et santé;2015;2014-15;2014;2014;66;35;31;209;104;105;46;17;29;;;;;RjvXY
92;École doctorale Vie -  Agro - Santé;;10;Sciences agronomiques et écologiques;2015;2014-15;2014;2014;24;15;9;86;51;35;34;17;17;;;;;RjvXY
130;École doctorale Informatique, télécommunications et électronique de Paris;EDITE;9;Sciences et technologies de l'information et de la communication;2015;2014-15;2014;2014;205;55;150;808;226;582;208;61;147;;;;;O5ysj
139;École doctorale Connaissance, langage, modélisation;CLM;8;Sciences pour l'ingénieur;2015;2014-15;2014;2014;7;3;4;21;4;17;8;2;6;;;;;1lxGH
145;École doctorale Sciences du végétal : du gène à l'écosystème;;5;Biologie, médecine et santé;2015;2014-15;2014;2014;24;13;11;97;56;41;26;16;10;;;;;ubDmM
146;École doctorale Galilée;GALILEE;8;Sciences pour l'ingénieur;2015;2014-15;2014;2014;1;0;1;21;13;8;7;2;5;;;;;71hqm
154;École doctorale Sciences de la vie et de la santé;SVS;5;Biologie, médecine et santé;2015;2014-15;2014;2014;86;59;27;289;169;120;87;41;46;;;;;hLn36
160;École doctorale Électronique, électrotechnique, automatique;EEA;5;Biologie, médecine et santé;2015;2014-15;2014;2014;5;3;2;15;6;9;6;1;5;;;;;EgfMQ
160;École doctorale Électronique, électrotechnique, automatique;EEA;9;Sciences et technologies de l'information et de la communication;2015;2014-15;2014;2014;14;4;10;106;35;71;12;6;6;;;;;EgfMQ
162;École doctorale Mécanique, énergétique, génie civil, acoustique;MEGA;9;Sciences et technologies de l'information et de la communication;2015;2014-15;2014;2014;2;0;2;5;0;5;1;0;1;;;;;7wCke
166;École doctorale Information, structures et systèmes;I2S;5;Biologie, médecine et santé;2015;2014-15;2014;2014;0;0;0;13;5;8;4;2;2;;;;;2uO68
166;École doctorale Information, structures et systèmes;I2S;10;Sciences agronomiques et écologiques;2015;2014-15;2014;2014;0;0;0;2;0;2;1;0;1;;;;;2uO68
168;École doctorale Sciences chimiques et biologiques pour la santé;SCBS;5;Biologie, médecine et santé;2015;2014-15;2014;2014;90;60;30;345;212;133;76;46;30;;;;;8cEME
173;École doctorale Sciences de l'univers, de l'environnement et de l'espace;SDU2E;8;Sciences pour l'ingénieur;2015;2014-15;2014;2014;5;0;5;19;5;14;2;1;1;;;;;R0Z9c
181;École doctorale Structure, informations, matière et matériaux;Simem;3;Sciences de la terre et de l'univers, espace;2015;2014-15;2014;2014;1;0;1;3;1;2;2;1;1;;;;;c1D6f
181;École doctorale Structure, informations, matière et matériaux;Simem;4;Chimie;2015;2014-15;2014;2014;12;1;11;35;15;20;13;3;10;;;;;c1D6f
181;École doctorale Structure, informations, matière et matériaux;Simem;9;Sciences et technologies de l'information et de la communication;2015;2014-15;2014;2014;13;2;11;52;7;45;14;5;9;;;;;c1D6f
184;École doctorale Mathématiques et informatique de Marseille;;5;Biologie, médecine et santé;2015;2014-15;2014;2014;0;0;0;1;0;1;0;0;0;;;;;DDObG
188;École doctorale Histoire moderne et contemporaine;;6;Sciences humaines et humanités;2015;2014-15;2014;2014;26;9;17;174;73;101;22;6;16;;;;;RSZ7F
206;École doctorale Chimie : chimie, procédés, environnement;;8;Sciences pour l'ingénieur;2015;2014-15;2014;2014;7;2;5;29;14;15;4;3;1;;;;;m0UhD
211;École doctorale Sciences exactes et leurs applications;ED SEA;1;Mathématiques et leurs interactions;2015;2014-15;2014;2014;5;1;4;27;6;21;9;1;8;;;;;1G1iC
216;École doctorale Ingénierie pour la santé, la cognition, l'environnement;EDISCE;7;Sciences de la société;2015;2014-15;2014;2014;2;2;0;6;3;3;0;0;0;;;;;fPs1t
218;École doctorale Chimie et sciences du vivant;EDCSV;4;Chimie;2015;2014-15;2014;2014;27;13;14;93;48;45;18;10;8;;;;;8bcJh
220;École doctorale Électronique, électrotechnique, automatique, traitement du signal;EEATS;8;Sciences pour l'ingénieur;2015;2014-15;2014;2014;38;9;29;108;24;84;25;7;18;;;;;IxEaw
221;École doctorale Augustin Cournot - Sciences économiques et de gestion - Sciences, technologies et sociétés;EDAC;7;Sciences de la société;2015;2014-15;2014;2014;18;11;7;78;37;41;21;10;11;;;;;5z9rW
222;École doctorale Sciences chimiques;EDSC;5;Biologie, médecine et santé;2015;2014-15;2014;2014;6;4;2;14;7;7;1;0;1;;;;;AdU8Q
224;École doctorale Cognition, langage, interaction;;6;Sciences humaines et humanités;2015;2014-15;2014;2014;28;18;10;167;108;59;23;15;8;;;;;7v43e
231;École doctorale Économie et gestion;EDEG;7;Sciences de la société;2015;2014-15;2014;2014;64;33;31;202;99;103;42;24;18;;;;;KT720
240;École doctorale Sciences de l'homme et de la société;SHS;7;Sciences de la société;2015;2014-15;2014;2014;26;10;16;89;36;53;12;6;6;;;;;j345k
250;École doctorale Sciences chimiques;;4;Chimie;2015;2014-15;2014;2014;21;9;12;90;41;49;27;10;17;;;;;O0Fav
251;École doctorale Sciences de l'environnement;;4;Chimie;2015;2014-15;2014;2014;5;4;1;18;10;8;4;3;1;;;;;VR28y
251;École doctorale Sciences de l'environnement;;10;Sciences agronomiques et écologiques;2015;2014-15;2014;2014;10;8;2;45;29;16;9;7;2;;;;;VR28y
260;École doctorale pluridisciplinaire;;1;Mathématiques et leurs interactions;2015;2014-15;2014;2014;1;0;1;10;4;6;1;1;0;;;;;sCk1f
260;École doctorale pluridisciplinaire;;3;Sciences de la terre et de l'univers, espace;2015;2014-15;2014;2014;0;0;0;2;2;0;2;1;1;;;;;sCk1f
262;École doctorale Sciences juridiques, politiques, économiques et de gestion;DEG;7;Sciences de la société;2015;2014-15;2014;2014;55;19;36;206;101;105;27;13;14;;;;;H7GyL
268;École doctorale Langage et langues : description, théorisation, transmission;;6;Sciences humaines et humanités;2015;2014-15;2014;2014;52;32;20;299;214;85;40;31;9;;;;;wAIDE
284;École doctorale Droit et Science Politique;DSP;6;Sciences humaines et humanités;2015;2014-15;2014;2014;23;11;12;163;102;61;16;7;9;;;;;ahH92
285;École doctorale Sciences pratiques;;7;Sciences de la société;2015;2014-15;2014;2014;6;4;2;39;21;18;3;2;1;;;;;Jd3t2
286;École doctorale de l'Ehess;;7;Sciences de la société;2015;2014-15;2014;2014;167;93;74;1013;604;409;111;58;53;;;;;2S146
304;École doctorale Sciences et environnements;;7;Sciences de la société;2015;2014-15;2014;2014;1;1;0;9;8;1;3;2;1;;;;;2ywZn
305;École doctorale Énergie et environnement;E2;2;Physique;2015;2014-15;2014;2014;3;1;2;12;3;9;0;0;0;;;;;Kbt8I
306;École doctorale Sciences des procédés, sciences des aliments;;3;Sciences de la terre et de l'univers, espace;2015;2014-15;2014;2014;1;0;1;1;0;1;0;0;0;;;;;adF7W
306;École doctorale Sciences des procédés, sciences des aliments;;8;Sciences pour l'ingénieur;2015;2014-15;2014;2014;14;6;8;55;25;30;22;14;8;;;;;adF7W
327;École doctorale Temps, espaces, sociétés, cultures;TESC;7;Sciences de la société;2015;2014-15;2014;2014;15;10;5;125;68;57;19;9;10;;;;;IjgiJ
341;École doctorale Évolution, écosystèmes, microbiologie, modélisation;E2M2;3;Sciences de la terre et de l'univers, espace;2015;2014-15;2014;2014;0;0;0;4;2;2;5;3;2;;;;;J83I0
341;École doctorale Évolution, écosystèmes, microbiologie, modélisation;E2M2;5;Biologie, médecine et santé;2015;2014-15;2014;2014;30;14;16;131;69;62;33;18;15;;;;;J83I0
341;École doctorale Évolution, écosystèmes, microbiologie, modélisation;E2M2;10;Sciences agronomiques et écologiques;2015;2014-15;2014;2014;13;6;7;55;24;31;15;7;8;;;;;J83I0
364;École doctorale Sciences fondamentales et appliquées;EDSFA;2;Physique;2015;2014-15;2014;2014;16;7;9;53;15;38;12;5;7;;;;;E483q
370;École doctorale Lettres, sciences humaines et sociales;LSHS;6;Sciences humaines et humanités;2015;2014-15;2014;2014;37;20;17;235;132;103;20;8;12;;;;;xAXXx
372;École doctorale Sciences économiques et de gestion;;6;Sciences humaines et humanités;2015;2014-15;2014;2014;39;18;21;201;89;112;49;21;28;;;;;JK63A
373;École doctorale Santé, information/communications et mathématiques, matière;SICMA;8;Sciences pour l'ingénieur;2015;2014-15;2014;2014;23;3;20;57;17;40;21;5;16;;;;;hTJF5
396;École doctorale Économie, organisations, société;EOS;6;Sciences humaines et humanités;2015;2014-15;2014;2014;4;1;3;25;7;18;5;2;3;;;;;Es5e7
396;École doctorale Économie, organisations, société;EOS;7;Sciences de la société;2015;2014-15;2014;2014;59;23;36;268;137;131;41;20;21;;;;;Es5e7
400;École doctorale Savoirs scientifiques : épistémologie, histoire des sciences, didactique des disciplines;;3;Sciences de la terre et de l'univers, espace;2015;2014-15;2014;2014;1;0;1;5;2;3;0;0;0;;;;;nRax3
400;École doctorale Savoirs scientifiques : épistémologie, histoire des sciences, didactique des disciplines;;4;Chimie;2015;2014-15;2014;2014;0;0;0;0;0;0;1;0;1;;;;;nRax3
400;École doctorale Savoirs scientifiques : épistémologie, histoire des sciences, didactique des disciplines;;6;Sciences humaines et humanités;2015;2014-15;2014;2014;0;0;0;6;4;2;0;0;0;;;;;nRax3
409;École doctorale Énergie, mécanique, matériaux;EMMA;2;Physique;2015;2014-15;2014;2014;7;3;4;25;10;15;4;1;3;;;;;KXlbK
409;École doctorale Énergie, mécanique, matériaux;EMMA;4;Chimie;2015;2014-15;2014;2014;35;11;24;101;31;70;32;10;22;;;;;KXlbK
410;École doctorale Sciences et ingénierie des ressources, procédés, produits, environnement;RP2E;10;Sciences agronomiques et écologiques;2015;2014-15;2014;2014;27;16;11;85;48;37;34;14;20;;;;;Q5fxV
411;École doctorale Humanités nouvelles : Fernand Braudel;;6;Sciences humaines et humanités;2015;2014-15;2014;2014;52;26;26;238;119;119;30;16;14;;;;;l2rFh
411;École doctorale Humanités nouvelles : Fernand Braudel;;7;Sciences de la société;2015;2014-15;2014;2014;7;3;4;22;13;9;5;4;1;;;;;l2rFh
413;École doctorale Sciences de la terre et de l'environnement;STE;8;Sciences pour l'ingénieur;2015;2014-15;2014;2014;0;0;0;1;1;0;0;0;0;;;;;u9BA9
414;École doctorale Sciences de la vie et de la santé;;7;Sciences de la société;2015;2014-15;2014;2014;1;1;0;1;1;0;0;0;0;;;;;YI4xS
420;École doctorale Santé publique Paris 11 - Paris 5;;7;Sciences de la société;2015;2014-15;2014;2014;4;4;0;18;14;4;4;3;1;;;;;3BNdi
435;École doctorale Agriculture, alimentation, biologie, environnement et santé;;1;Mathématiques et leurs interactions;2015;2014-15;2014;2014;3;2;1;13;5;8;1;0;1;;;;;mC35U
435;École doctorale Agriculture, alimentation, biologie, environnement et santé;;6;Sciences humaines et humanités;2015;2014-15;2014;2014;1;1;0;4;4;0;0;0;0;;;;;mC35U
435;École doctorale Agriculture, alimentation, biologie, environnement et santé;;7;Sciences de la société;2015;2014-15;2014;2014;13;9;4;56;30;26;13;7;6;;;;;mC35U
435;École doctorale Agriculture, alimentation, biologie, environnement et santé;;8;Sciences pour l'ingénieur;2015;2014-15;2014;2014;11;4;7;56;33;23;19;14;5;;;;;mC35U
447;École doctorale de l'école polytechnique;;1;Mathématiques et leurs interactions;2015;2014-15;2014;2014;19;4;15;89;19;70;17;1;16;;;;;zgCCh
455;École doctorale Économie, Gestion, Information et Communication;EGIC;9;Sciences et technologies de l'information et de la communication;2015;2014-15;2014;2014;4;3;1;11;6;5;1;0;1;;;;;qCOg3
456;École doctorale Sciences du sport, de la motricité et du mouvement humain;;6;Sciences humaines et humanités;2015;2014-15;2014;2014;17;8;9;63;32;31;7;3;4;;;;;GqvEI
463;École doctorale Sciences du mouvement humain;SMH;8;Sciences pour l'ingénieur;2015;2014-15;2014;2014;6;1;5;19;3;16;4;2;2;;;;;UbtlY
467;École doctorale Aéronautique, astronautique;AA;7;Sciences de la société;2015;2014-15;2014;2014;2;1;1;3;1;2;1;1;0;;;;;U7l45
469;École doctorale du Pacifique;EDP;1;Mathématiques et leurs interactions;2015;2014-15;2014;2014;1;0;1;1;0;1;1;0;1;;;;;t9Z2n
469;École doctorale du Pacifique;EDP;4;Chimie;2015;2014-15;2014;2014;1;1;0;7;4;3;3;2;1;;;;;t9Z2n
472;École doctorale de l'EPHE;;5;Biologie, médecine et santé;2015;2014-15;2014;2014;12;7;5;36;26;10;6;1;5;;;;;27zK4
474;École doctorale Interdisciplinaire européenne frontières du vivant;FDV;5;Biologie, médecine et santé;2015;2014-15;2014;2014;26;13;13;97;42;55;23;12;11;;;;;E727j
474;École doctorale Interdisciplinaire européenne frontières du vivant;FDV;7;Sciences de la société;2015;2014-15;2014;2014;1;1;0;2;1;1;0;0;0;;;;;E727j
477;École doctorale Systèmes intégrés en biologie, agronomie, géosciences, hydrosciences, environnement;SIBAGHE;3;Sciences de la terre et de l'univers, espace;2015;2014-15;2014;2014;17;7;10;77;32;45;19;7;12;;;;;zfN3N
477;École doctorale Systèmes intégrés en biologie, agronomie, géosciences, hydrosciences, environnement;SIBAGHE;10;Sciences agronomiques et écologiques;2015;2014-15;2014;2014;68;32;36;284;149;135;77;44;33;;;;;zfN3N
482;École doctorale Sciences de la matière;SDM;4;Chimie;2015;2014-15;2014;2014;56;21;35;231;99;132;50;20;30;;;;;kmeZ4
482;École doctorale Sciences de la matière;SDM;8;Sciences pour l'ingénieur;2015;2014-15;2014;2014;16;7;9;52;20;32;3;2;1;;;;;kmeZ4
485;École doctorale Éducation, Psychologie, Information et Communication;EPIC;6;Sciences humaines et humanités;2015;2014-15;2014;2014;54;34;20;333;210;123;50;33;17;;;;;O82eL
488;École doctorale Sciences, ingénierie, santé;SIS;1;Mathématiques et leurs interactions;2015;2014-15;2014;2014;1;0;1;11;4;7;0;0;0;;;;;Fy2lK
488;École doctorale Sciences, ingénierie, santé;SIS;9;Sciences et technologies de l'information et de la communication;2015;2014-15;2014;2014;33;7;26;146;30;116;42;11;31;;;;;Fy2lK
489;École doctorale Sciences et ingénierie des systèmes, de l'environnement et des organisations;SISEO;7;Sciences de la société;2015;2014-15;2014;2014;6;5;1;37;23;14;8;5;3;;;;;6pT77
496;École doctorale Sociétés, cultures, échanges;SCE;7;Sciences de la société;2015;2014-15;2014;2014;0;0;0;2;1;1;0;0;0;;;;;633tC
497;École doctorale Normande de Biologie Intégrative, Santé, Environnement;Ed NBISE;4;Chimie;2015;2014-15;2014;2014;1;0;1;3;1;2;1;0;1;;;;;0D9Je
497;École doctorale Normande de Biologie Intégrative, Santé, Environnement;Ed NBISE;6;Sciences humaines et humanités;2015;2014-15;2014;2014;1;1;0;5;2;3;0;0;0;;;;;0D9Je
498;École doctorale Sciences pour l'ingénieur, géosciences, architecture;SPIGA;8;Sciences pour l'ingénieur;2015;2014-15;2014;2014;89;26;63;374;93;281;79;20;59;;;;;0vlKH
498;École doctorale Sciences pour l'ingénieur, géosciences, architecture;SPIGA;9;Sciences et technologies de l'information et de la communication;2015;2014-15;2014;2014;12;1;11;12;1;11;0;0;0;;;;;0vlKH
502;École doctorale Biologie - Santé;;4;Chimie;2015;2014-15;2014;2014;1;0;1;6;4;2;3;1;2;;;;;JCFV7
503;École doctorale Sciences et technologies de l'information et de mathématiques;STIM;8;Sciences pour l'ingénieur;2015;2014-15;2014;2014;5;1;4;24;4;20;8;1;7;;;;;JQevP
507;École doctorale Sciences humaines et sociales;;6;Sciences humaines et humanités;2015;2014-15;2014;2014;93;41;52;426;225;201;48;19;29;;;;;3e7VM
511;École doctorale Sciences et ingénierie;S&I;4;Chimie;2015;2014-15;2014;2014;3;1;2;11;6;5;6;6;0;;;;;7aXuB
511;École doctorale Sciences et ingénierie;S&I;8;Sciences pour l'ingénieur;2015;2014-15;2014;2014;4;2;2;16;2;14;2;1;1;;;;;7aXuB
514;École doctorale Études anglophones, germanophones et européennes;EDEAGE;6;Sciences humaines et humanités;2015;2014-15;2014;2014;27;22;5;179;134;45;32;23;9;;;;;fuIQs
515;École doctorale Complexité du vivant;CdV;5;Biologie, médecine et santé;2015;2014-15;2014;2014;77;39;38;325;186;139;71;38;33;;;;;CbV9s
517;École doctorale Particules, noyaux, cosmologie;;3;Sciences de la terre et de l'univers, espace;2015;2014-15;2014;2014;0;0;0;3;1;2;1;1;0;;;;;9kK48
517;École doctorale Particules, noyaux, cosmologie;;8;Sciences pour l'ingénieur;2015;2014-15;2014;2014;1;1;0;4;2;2;3;1;2;;;;;9kK48
522;École doctorale Sciences et ingénierie en matériaux, mécanique, énergétique et aéronautique;SI-MMEA;8;Sciences pour l'ingénieur;2015;2014-15;2014;2014;58;9;49;213;46;167;54;12;42;;;;;82F19
523;École doctorale Sciences pour l'environnement - Gay Lussac;;4;Chimie;2015;2014-15;2014;2014;21;6;15;82;38;44;27;11;16;;;;;6xD69
524;École doctorale Biologie - santé;;5;Biologie, médecine et santé;2015;2014-15;2014;2014;26;15;11;124;73;51;36;14;22;;;;;S7Kk6
527;École doctorale Cognition, comportement, langage(s);CCL;6;Sciences humaines et humanités;2015;2014-15;2014;2014;18;11;7;94;61;33;9;5;4;;;;;MvpY8
528;École doctorale Ville, transports et territoires;VTT;8;Sciences pour l'ingénieur;2015;2014-15;2014;2014;5;2;3;19;8;11;0;0;0;;;;;68zCc
530;École doctorale Organisations, marchés, institutions;OMI;6;Sciences humaines et humanités;2015;2014-15;2014;2014;25;13;12;111;58;53;5;2;3;;;;;4htv7
530;École doctorale Organisations, marchés, institutions;OMI;9;Sciences et technologies de l'information et de la communication;2015;2014-15;2014;2014;0;0;0;2;2;0;1;1;0;;;;;4htv7
531;École doctorale Sciences, ingénierie et environnement;SIE;2;Physique;2015;2014-15;2014;2014;11;2;9;34;10;24;5;2;3;;;;;b5BYq
531;École doctorale Sciences, ingénierie et environnement;SIE;8;Sciences pour l'ingénieur;2015;2014-15;2014;2014;66;22;44;191;57;134;40;10;30;;;;;b5BYq
532;École doctorale Mathématiques et sciences et technologies de l'information et de la communication;MSTIC;3;Sciences de la terre et de l'univers, espace;2015;2014-15;2014;2014;2;0;2;13;4;9;3;2;1;;;;;t43KM
533;École doctorale Sciences du management : Gestion, organisation, décision, information;GODI;7;Sciences de la société;2015;2014-15;2014;2014;13;5;8;62;29;33;17;7;10;;;;;ld7FG
534;École doctorale Modélisation et instrumentation en physique, énergie, géosciences et environnement;MIPEGE;4;Chimie;2015;2014-15;2014;2014;1;1;0;9;6;3;0;0;0;;;;;K93eR
535;École doctorale Sciences de la société;SDS;6;Sciences humaines et humanités;2015;2014-15;2014;2014;5;3;2;24;14;10;0;0;0;;;;;iEUOV
536;École doctorale Sciences et agrosciences;;5;Biologie, médecine et santé;2015;2014-15;2014;2014;3;0;3;10;2;8;2;1;1;;;;;pHfqe
546;École doctorale Abbé Grégoire;;8;Sciences pour l'ingénieur;2015;2014-15;2014;2014;1;1;0;3;2;1;7;0;7;;;;;ZSn7q
547;École doctorale Sciences, Technologie, Santé;EDSTS;9;Sciences et technologies de l'information et de la communication;2015;2014-15;2014;2014;13;1;12;63;17;46;13;4;9;;;;;wEdn2
549;École doctorale Santé, Sciences Biologiques et Chimie du Vivant;SSBCV;10;Sciences agronomiques et écologiques;2015;2014-15;2014;2014;13;12;1;27;15;12;0;0;0;;;;;B9ggO
551;École doctorale Mathématiques, Informatique, Physique Théorique et Ingénierie des Systèmes;MIPTIS;9;Sciences et technologies de l'information et de la communication;2015;2014-15;2014;2014;19;3;16;75;17;58;20;3;17;;;;;Mpudz
553;École doctorale Carnot - Pasteur;;1;Mathématiques et leurs interactions;2015;2014-15;2014;2014;13;6;7;47;14;33;9;0;9;;;;;6h4Z7
553;École doctorale Carnot - Pasteur;;7;Sciences de la société;2015;2014-15;2014;2014;1;1;0;11;4;7;0;0;0;;;;;6h4Z7
554;École doctorale Environnements - Santé;E-S;6;Sciences humaines et humanités;2015;2014-15;2014;2014;3;3;0;10;7;3;5;3;2;;;;;ElyFU
554;École doctorale Environnements - Santé;E-S;9;Sciences et technologies de l'information et de la communication;2015;2014-15;2014;2014;0;0;0;3;1;2;0;0;0;;;;;ElyFU
554;École doctorale Environnements - Santé;E-S;10;Sciences agronomiques et écologiques;2015;2014-15;2014;2014;28;13;15;127;69;58;41;20;21;;;;;ElyFU
558;École doctorale Histoire, Mémoire, Patrimoine, Langage;HMPL;7;Sciences de la société;2015;2014-15;2014;2014;0;0;0;4;1;3;1;1;0;;;;;uX3jT
31;École doctorale Pratiques et théories du sens;;7;Sciences de la société;2014;2013-14;2013;2013;5;2;3;15;9;6;2;0;2;;;;;1S466
34;École doctorale Matériaux;;2;Physique;2014;2013-14;2013;2013;3;2;1;11;5;6;5;2;3;;;;;1Iufh
39;École doctorale Mathématiques et Informatique;EDMIB;9;Sciences et technologies de l'information et de la communication;2014;2013-14;2013;2013;27;6;21;106;23;83;32;4;28;;;;;TBj2X
41;École doctorale Droit;;7;Sciences de la société;2014;2013-14;2013;2013;62;35;27;330;158;172;34;13;21;;;;;KnOQK
58;École doctorale Langues, littératures, cultures, civilisations;LLCC;6;Sciences humaines et humanités;2014;2013-14;2013;2013;126;79;47;489;282;207;52;30;22;;;;;I9ATR
67;École doctorale Sciences juridiques et politiques;;7;Sciences de la société;2014;2013-14;2013;2013;127;67;60;661;349;312;76;33;43;;;;;qrOj1
71;École doctorale Sciences pour l'ingénieur;;7;Sciences de la société;2014;2013-14;2013;2013;8;5;3;27;14;13;4;2;2;;;;;H6UYp
101;École doctorale de Sciences juridiques;;6;Sciences humaines et humanités;2014;2013-14;2013;2013;1;0;1;7;2;5;1;1;0;;;;;569G2
101;École doctorale de Sciences juridiques;;7;Sciences de la société;2014;2013-14;2013;2013;50;28;22;258;148;110;38;16;22;;;;;569G2
101;École doctorale de Sciences juridiques;;9;Sciences et technologies de l'information et de la communication;2014;2013-14;2013;2013;0;0;0;0;0;0;2;0;2;;;;;569G2
104;École doctorale Sciences de la matière, du rayonnement et de l'environnement;SMRE;4;Chimie;2014;2013-14;2013;2013;54;21;33;216;82;134;64;22;42;;;;;Q5iFz
104;École doctorale Sciences de la matière, du rayonnement et de l'environnement;SMRE;5;Biologie, médecine et santé;2014;2013-14;2013;2013;3;1;2;17;8;9;2;0;2;;;;;Q5iFz
104;École doctorale Sciences de la matière, du rayonnement et de l'environnement;SMRE;10;Sciences agronomiques et écologiques;2014;2013-14;2013;2013;18;7;11;65;25;40;13;8;5;;;;;Q5iFz
120;École doctorale Littérature française et comparée;;6;Sciences humaines et humanités;2014;2013-14;2013;2013;44;31;13;292;214;78;39;33;6;;;;;3ULpe
131;École doctorale Langue, littérature, image, civilisations et sciences humaines (domaines francophone et anglophone);LLI;6;Sciences humaines et humanités;2014;2013-14;2013;2013;47;29;18;278;180;98;33;20;13;;;;;a47aW
139;École doctorale Connaissance, langage, modélisation;CLM;9;Sciences et technologies de l'information et de la communication;2014;2013-14;2013;2013;0;0;0;18;11;7;1;0;1;;;;;1lxGH
142;École doctorale Mathématiques de la région Paris-Sud;;1;Mathématiques et leurs interactions;2014;2013-14;2013;2013;26;5;21;105;23;82;21;5;16;;;;;5XlH9
156;École doctorale Sciences de la mer;;7;Sciences de la société;2014;2013-14;2013;2013;3;0;3;21;9;12;5;2;3;;;;;EGY9P
159;École doctorale Esthétique, sciences et technologies des arts;EDESTA;6;Sciences humaines et humanités;2014;2013-14;2013;2013;68;39;29;300;182;118;28;17;11;;;;;zj1Vj
160;École doctorale Électronique, électrotechnique, automatique;EEA;8;Sciences pour l'ingénieur;2014;2013-14;2013;2013;20;5;15;92;18;74;56;10;46;;;;;EgfMQ
180;École doctorale Sciences humaines et sociales : cultures, individus, sociétés;SHS;6;Sciences humaines et humanités;2014;2013-14;2013;2013;35;27;8;118;82;36;16;14;2;;;;;D2BT3
181;École doctorale Structure, informations, matière et matériaux;Simem;1;Mathématiques et leurs interactions;2014;2013-14;2013;2013;4;1;3;12;4;8;3;0;3;;;;;c1D6f
181;École doctorale Structure, informations, matière et matériaux;Simem;3;Sciences de la terre et de l'univers, espace;2014;2013-14;2013;2013;1;0;1;4;2;2;3;2;1;;;;;c1D6f
182;École doctorale Physique et chimie-physique;;3;Sciences de la terre et de l'univers, espace;2014;2013-14;2013;2013;4;1;3;9;3;6;0;0;0;;;;;3My6I
182;École doctorale Physique et chimie-physique;;4;Chimie;2014;2013-14;2013;2013;17;4;13;72;26;46;17;6;11;;;;;3My6I
205;École doctorale Interdisciplinaire Sciences-Santé;EDISS;8;Sciences pour l'ingénieur;2014;2013-14;2013;2013;3;3;0;10;7;3;1;0;1;;;;;69W38
206;École doctorale Chimie : chimie, procédés, environnement;;5;Biologie, médecine et santé;2014;2013-14;2013;2013;0;0;0;7;5;2;1;1;0;;;;;m0UhD
209;École doctorale Sciences physiques et de L'ingénieur;SPI;9;Sciences et technologies de l'information et de la communication;2014;2013-14;2013;2013;33;9;24;128;26;102;38;9;29;;;;;tZcIZ
211;École doctorale Sciences exactes et leurs applications;ED SEA;9;Sciences et technologies de l'information et de la communication;2014;2013-14;2013;2013;2;1;1;18;5;13;4;0;4;;;;;1G1iC
216;École doctorale Ingénierie pour la santé, la cognition, l'environnement;EDISCE;2;Physique;2014;2013-14;2013;2013;1;1;0;3;1;2;1;1;0;;;;;fPs1t
217;École doctorale Mathématiques, sciences et technologies de l'information, informatique;MSTII;1;Mathématiques et leurs interactions;2014;2013-14;2013;2013;29;10;19;92;24;68;22;6;16;;;;;Ehx7v
217;École doctorale Mathématiques, sciences et technologies de l'information, informatique;MSTII;9;Sciences et technologies de l'information et de la communication;2014;2013-14;2013;2013;74;17;57;313;70;243;68;16;52;;;;;Ehx7v
218;École doctorale Chimie et sciences du vivant;EDCSV;10;Sciences agronomiques et écologiques;2014;2013-14;2013;2013;4;2;2;19;8;11;6;2;4;;;;;8bcJh
220;École doctorale Électronique, électrotechnique, automatique, traitement du signal;EEATS;8;Sciences pour l'ingénieur;2014;2013-14;2013;2013;28;2;26;111;21;90;24;2;22;;;;;IxEaw
222;École doctorale Sciences chimiques;EDSC;5;Biologie, médecine et santé;2014;2013-14;2013;2013;3;3;0;8;3;5;1;1;0;;;;;AdU8Q
224;École doctorale Cognition, langage, interaction;;9;Sciences et technologies de l'information et de la communication;2014;2013-14;2013;2013;1;1;0;11;3;8;1;0;1;;;;;7v43e
227;École doctorale Sciences de la nature et de l'homme;;7;Sciences de la société;2014;2013-14;2013;2013;0;0;0;4;4;0;0;0;0;;;;;xiDA5
251;École doctorale Sciences de l'environnement;;8;Sciences pour l'ingénieur;2014;2013-14;2013;2013;5;3;2;21;10;11;3;2;1;;;;;VR28y
254;École doctorale Sciences de la matière;;2;Physique;2014;2013-14;2013;2013;17;3;14;64;16;48;15;3;12;;;;;365F2
254;École doctorale Sciences de la matière;;8;Sciences pour l'ingénieur;2014;2013-14;2013;2013;14;3;11;44;7;37;14;1;13;;;;;365F2
260;École doctorale pluridisciplinaire;;4;Chimie;2014;2013-14;2013;2013;3;2;1;20;11;9;2;2;0;;;;;sCk1f
262;École doctorale Sciences juridiques, politiques, économiques et de gestion;DEG;7;Sciences de la société;2014;2013-14;2013;2013;45;22;23;203;106;97;22;8;14;;;;;H7GyL
269;École doctorale Mathématiques, sciences de l'information et de l'ingénieur;MSII;4;Chimie;2014;2013-14;2013;2013;0;0;0;1;0;1;0;0;0;;;;;5E625
283;École doctorale Droit international et européen;;7;Sciences de la société;2014;2013-14;2013;2013;32;19;13;160;89;71;22;11;11;;;;;uIq4K
284;École doctorale Droit et Science Politique;DSP;6;Sciences humaines et humanités;2014;2013-14;2013;2013;26;17;9;163;100;63;19;12;7;;;;;ahH92
285;École doctorale Sciences pratiques;;6;Sciences humaines et humanités;2014;2013-14;2013;2013;1;1;0;18;7;11;2;1;1;;;;;Jd3t2
285;École doctorale Sciences pratiques;;8;Sciences pour l'ingénieur;2014;2013-14;2013;2013;33;13;20;128;34;94;29;5;24;;;;;Jd3t2
285;École doctorale Sciences pratiques;;9;Sciences et technologies de l'information et de la communication;2014;2013-14;2013;2013;7;0;7;27;6;21;11;1;10;;;;;Jd3t2
286;École doctorale de l'Ehess;;7;Sciences de la société;2014;2013-14;2013;2013;149;89;60;810;486;324;76;50;26;;;;;2S146
287;École doctorale Sciences pour l'ingénieur;;1;Mathématiques et leurs interactions;2014;2013-14;2013;2013;14;3;11;42;9;33;14;7;7;;;;;48Q1j
288;École doctorale Ondes et matière;EDOM;2;Physique;2014;2013-14;2013;2013;48;17;31;170;45;125;28;5;23;;;;;kJrcx
305;École doctorale Énergie et environnement;E2;5;Biologie, médecine et santé;2014;2013-14;2013;2013;4;3;1;16;12;4;3;2;1;;;;;Kbt8I
306;École doctorale Sciences des procédés, sciences des aliments;;8;Sciences pour l'ingénieur;2014;2013-14;2013;2013;11;6;5;61;31;30;9;4;5;;;;;adF7W
306;École doctorale Sciences des procédés, sciences des aliments;;9;Sciences et technologies de l'information et de la communication;2014;2013-14;2013;2013;0;0;0;3;1;2;0;0;0;;;;;adF7W
306;École doctorale Sciences des procédés, sciences des aliments;;10;Sciences agronomiques et écologiques;2014;2013-14;2013;2013;7;4;3;29;19;10;13;8;5;;;;;adF7W
323;École doctorale Génie électrique, électronique et télécommunications;GEET;5;Biologie, médecine et santé;2014;2013-14;2013;2013;5;2;3;22;13;9;5;1;4;;;;;arcz6
341;École doctorale Évolution, écosystèmes, microbiologie, modélisation;E2M2;5;Biologie, médecine et santé;2014;2013-14;2013;2013;12;6;6;36;23;13;11;7;4;;;;;J83I0
341;École doctorale Évolution, écosystèmes, microbiologie, modélisation;E2M2;10;Sciences agronomiques et écologiques;2014;2013-14;2013;2013;28;14;14;139;76;63;26;15;11;;;;;J83I0
351;École doctorale Sciences physiques, mathématiques et de l'information pour l'ingénieur;SPMII;4;Chimie;2014;2013-14;2013;2013;2;1;1;8;3;5;2;1;1;;;;;rY4EP
353;École doctorale Sciences pour l'ingénieur : mécanique, physique, micro et nanoélectronique;;2;Physique;2014;2013-14;2013;2013;9;1;8;9;1;8;11;3;8;;;;;vk5Kp
353;École doctorale Sciences pour l'ingénieur : mécanique, physique, micro et nanoélectronique;;3;Sciences de la terre et de l'univers, espace;2014;2013-14;2013;2013;0;0;0;8;4;4;0;0;0;;;;;vk5Kp
353;École doctorale Sciences pour l'ingénieur : mécanique, physique, micro et nanoélectronique;;5;Biologie, médecine et santé;2014;2013-14;2013;2013;0;0;0;5;1;4;2;1;1;;;;;vk5Kp
364;École doctorale Sciences fondamentales et appliquées;EDSFA;8;Sciences pour l'ingénieur;2014;2013-14;2013;2013;20;9;11;140;35;105;25;5;20;;;;;E483q
372;École doctorale Sciences économiques et de gestion;;7;Sciences de la société;2014;2013-14;2013;2013;55;30;25;218;97;121;62;30;32;;;;;JK63A
373;École doctorale Santé, information/communications et mathématiques, matière;SICMA;2;Physique;2014;2013-14;2013;2013;3;2;1;21;12;9;2;1;1;;;;;hTJF5
377;École doctorale Environnement et société;;4;Chimie;2014;2013-14;2013;2013;2;1;1;18;12;6;3;1;2;;;;;ZMG5u
378;École doctorale Sciences de l'homme et de la société;SHS;7;Sciences de la société;2014;2013-14;2013;2013;14;6;8;92;37;55;4;2;2;;;;;3XKuF
389;École doctorale La physique, de la particule à la matière condensée;;2;Physique;2014;2013-14;2013;2013;35;10;25;120;30;90;28;7;21;;;;;2ydfg
409;École doctorale Énergie, mécanique, matériaux;EMMA;2;Physique;2014;2013-14;2013;2013;5;2;3;23;8;15;14;3;11;;;;;KXlbK
411;École doctorale Humanités nouvelles : Fernand Braudel;;6;Sciences humaines et humanités;2014;2013-14;2013;2013;62;33;29;282;151;131;30;14;16;;;;;l2rFh
414;École doctorale Sciences de la vie et de la santé;;2;Physique;2014;2013-14;2013;2013;1;1;0;1;1;0;1;1;0;;;;;YI4xS
417;École doctorale Sciences et Ingénierie;S&I;3;Sciences de la terre et de l'univers, espace;2014;2013-14;2013;2013;2;1;1;8;4;4;1;1;0;;;;;SSBvE
420;École doctorale Santé publique Paris 11 - Paris 5;;1;Mathématiques et leurs interactions;2014;2013-14;2013;2013;2;0;2;11;7;4;4;2;2;;;;;3BNdi
422;École doctorale Sciences et technologies de l'information, des télécommunications et des systèmes;;5;Biologie, médecine et santé;2014;2013-14;2013;2013;4;1;3;49;23;26;11;9;2;;;;;998UM
432;École doctorale Sciences des métiers de l'ingénieur;SMI;8;Sciences pour l'ingénieur;2014;2013-14;2013;2013;142;30;112;478;105;373;114;31;83;;;;;nSsHB
435;École doctorale Agriculture, alimentation, biologie, environnement et santé;;8;Sciences pour l'ingénieur;2014;2013-14;2013;2013;5;2;3;19;5;14;0;0;0;;;;;mC35U
436;École doctorale Médicament, toxicologie, chimie, environnement;MTCE;5;Biologie, médecine et santé;2014;2013-14;2013;2013;48;30;18;133;80;53;28;16;12;;;;;dPsg3
447;École doctorale de l'école polytechnique;;3;Sciences de la terre et de l'univers, espace;2014;2013-14;2013;2013;1;0;1;7;4;3;3;0;3;;;;;zgCCh
454;École doctorale Sciences de l'homme, du politique et du territoire;SHPT;3;Sciences de la terre et de l'univers, espace;2014;2013-14;2013;2013;1;0;1;2;1;1;0;0;0;;;;;Opv31
454;École doctorale Sciences de l'homme, du politique et du territoire;SHPT;8;Sciences pour l'ingénieur;2014;2013-14;2013;2013;0;0;0;1;1;0;0;0;0;;;;;Opv31
456;École doctorale Sciences du sport, de la motricité et du mouvement humain;;5;Biologie, médecine et santé;2014;2013-14;2013;2013;12;4;8;38;14;24;6;2;4;;;;;GqvEI
463;École doctorale Sciences du mouvement humain;SMH;5;Biologie, médecine et santé;2014;2013-14;2013;2013;24;9;15;62;19;43;18;6;12;;;;;UbtlY
465;École doctorale Économie Panthéon Sorbonne;EPS;7;Sciences de la société;2014;2013-14;2013;2013;79;30;49;347;142;205;60;22;38;;;;;MV68S
467;École doctorale Aéronautique, astronautique;AA;1;Mathématiques et leurs interactions;2014;2013-14;2013;2013;3;0;3;10;0;10;2;0;2;;;;;U7l45
467;École doctorale Aéronautique, astronautique;AA;8;Sciences pour l'ingénieur;2014;2013-14;2013;2013;2;0;2;23;6;17;6;0;6;;;;;U7l45
469;École doctorale du Pacifique;EDP;4;Chimie;2014;2013-14;2013;2013;2;0;2;9;5;4;0;0;0;;;;;t9Z2n
474;École doctorale Interdisciplinaire européenne frontières du vivant;FDV;6;Sciences humaines et humanités;2014;2013-14;2013;2013;0;0;0;1;0;1;0;0;0;;;;;E727j
474;École doctorale Interdisciplinaire européenne frontières du vivant;FDV;10;Sciences agronomiques et écologiques;2014;2013-14;2013;2013;2;2;0;5;4;1;0;0;0;;;;;E727j
478;École doctorale Sciences de Gestion;;7;Sciences de la société;2014;2013-14;2013;2013;12;7;5;57;30;27;12;6;6;;;;;q34kB
480;École doctorale Montaigne-humanités;;6;Sciences humaines et humanités;2014;2013-14;2013;2013;127;84;43;636;353;283;67;37;30;;;;;f3SeZ
491;École doctorale Langages, idées, sociétés, institutions, territoires;LISIT;6;Sciences humaines et humanités;2014;2013-14;2013;2013;75;39;36;330;180;150;39;18;21;;;;;iB25j
497;École doctorale Normande de Biologie Intégrative, Santé, Environnement;Ed NBISE;6;Sciences humaines et humanités;2014;2013-14;2013;2013;2;1;1;4;1;3;2;1;1;;;;;0D9Je
502;École doctorale Biologie - Santé;;5;Biologie, médecine et santé;2014;2013-14;2013;2013;102;64;38;360;211;149;74;36;38;;;;;JCFV7
503;École doctorale Sciences et technologies de l'information et de mathématiques;STIM;2;Physique;2014;2013-14;2013;2013;1;0;1;2;0;2;1;0;1;;;;;JQevP
503;École doctorale Sciences et technologies de l'information et de mathématiques;STIM;6;Sciences humaines et humanités;2014;2013-14;2013;2013;2;2;0;9;5;4;0;0;0;;;;;JQevP
503;École doctorale Sciences et technologies de l'information et de mathématiques;STIM;8;Sciences pour l'ingénieur;2014;2013-14;2013;2013;3;0;3;23;3;20;4;0;4;;;;;JQevP
509;École doctorale Civilisations et sociétés euro-méditerranéennes et comparées;;6;Sciences humaines et humanités;2014;2013-14;2013;2013;16;9;7;59;33;26;5;2;3;;;;;9tbyG
511;École doctorale Sciences et ingénierie;S&I;8;Sciences pour l'ingénieur;2014;2013-14;2013;2013;7;0;7;16;2;14;2;1;1;;;;;7aXuB
517;École doctorale Particules, noyaux, cosmologie;;2;Physique;2014;2013-14;2013;2013;22;6;16;89;30;59;46;13;33;;;;;9kK48
519;École doctorale Sciences humaines et sociales - Perspectives européennes;SHS-PE;7;Sciences de la société;2014;2013-14;2013;2013;10;1;9;62;32;30;4;2;2;;;;;2f5qs
520;École doctorale Humanités;;6;Sciences humaines et humanités;2014;2013-14;2013;2013;79;46;33;381;226;155;44;27;17;;;;;rI175
522;École doctorale Sciences et ingénierie en matériaux, mécanique, énergétique et aéronautique;SI-MMEA;2;Physique;2014;2013-14;2013;2013;2;1;1;8;4;4;2;0;2;;;;;82F19
523;École doctorale Sciences pour l'environnement - Gay Lussac;;4;Chimie;2014;2013-14;2013;2013;23;14;9;79;36;43;29;15;14;;;;;6xD69
523;École doctorale Sciences pour l'environnement - Gay Lussac;;10;Sciences agronomiques et écologiques;2014;2013-14;2013;2013;17;8;9;61;39;22;16;10;6;;;;;6xD69
529;École doctorale Cultures et sociétés;CS;7;Sciences de la société;2014;2013-14;2013;2013;13;6;7;57;32;25;6;1;5;;;;;XU9tb
529;École doctorale Cultures et sociétés;CS;9;Sciences et technologies de l'information et de la communication;2014;2013-14;2013;2013;9;6;3;21;16;5;3;1;2;;;;;XU9tb
531;École doctorale Sciences, ingénierie et environnement;SIE;5;Biologie, médecine et santé;2014;2013-14;2013;2013;1;0;1;4;3;1;0;0;0;;;;;b5BYq
531;École doctorale Sciences, ingénierie et environnement;SIE;8;Sciences pour l'ingénieur;2014;2013-14;2013;2013;39;11;28;163;44;119;53;15;38;;;;;b5BYq
536;École doctorale Sciences et agrosciences;;4;Chimie;2014;2013-14;2013;2013;0;0;0;0;0;0;2;1;1;;;;;pHfqe
537;École doctorale Culture et patrimoine;C&P;6;Sciences humaines et humanités;2014;2013-14;2013;2013;4;2;2;27;12;15;5;4;1;;;;;GxI4a
538;École doctorale Culture, régulation, institutions et territoire;CRIT;7;Sciences de la société;2014;2013-14;2013;2013;48;28;20;245;117;128;34;12;22;;;;;8T505
541;École doctorale de sciences humaines et sociales de La Réunion;SHS;10;Sciences agronomiques et écologiques;2014;2013-14;2013;2013;2;0;2;4;2;2;0;0;0;;;;;21SpE
542;École doctorale de sciences de La Réunion;STS;5;Biologie, médecine et santé;2014;2013-14;2013;2013;7;4;3;25;11;14;6;1;5;;;;;2pAql
542;École doctorale de sciences de La Réunion;STS;7;Sciences de la société;2014;2013-14;2013;2013;0;0;0;0;0;0;3;2;1;;;;;2pAql
546;École doctorale Abbé Grégoire;;2;Physique;2014;2013-14;2013;2013;1;0;1;8;3;5;4;2;2;;;;;ZSn7q
546;École doctorale Abbé Grégoire;;7;Sciences de la société;2014;2013-14;2013;2013;35;19;16;120;63;57;21;12;9;;;;;ZSn7q
546;École doctorale Abbé Grégoire;;9;Sciences et technologies de l'information et de la communication;2014;2013-14;2013;2013;0;0;0;1;1;0;0;0;0;;;;;ZSn7q
551;École doctorale Mathématiques, Informatique, Physique Théorique et Ingénierie des Systèmes;MIPTIS;6;Sciences humaines et humanités;2014;2013-14;2013;2013;0;0;0;1;1;0;0;0;0;;;;;Mpudz
554;École doctorale Environnements - Santé;E-S;3;Sciences de la terre et de l'univers, espace;2014;2013-14;2013;2013;9;4;5;24;8;16;4;1;3;;;;;ElyFU
554;École doctorale Environnements - Santé;E-S;5;Biologie, médecine et santé;2014;2013-14;2013;2013;51;31;20;216;110;106;69;42;27;;;;;ElyFU
558;École doctorale Histoire, Mémoire, Patrimoine, Langage;HMPL;7;Sciences de la société;2014;2013-14;2013;2013;0;0;0;5;2;3;1;0;1;;;;;uX3jT
34;École doctorale Matériaux;;2;Physique;2021;2020-21;2020;2020;5;2;3;40;15;25;9;4;5;1;8;0;0;1Iufh
47;École doctorale Physique;;1;Mathématiques et leurs interactions;2021;2020-21;2020;2020;0;0;0;1;0;1;0;0;0;0;0;0;0;8kNpd
47;École doctorale Physique;;2;Physique;2021;2020-21;2020;2020;89;19;70;359;77;282;70;17;53;43;26;1;0;8kNpd
47;École doctorale Physique;;5;Biologie, médecine et santé;2021;2020-21;2020;2020;4;2;2;11;4;7;2;2;0;2;0;0;0;8kNpd
47;École doctorale Physique;;9;Sciences et technologies de l'information et de la communication;2021;2020-21;2020;2020;1;0;1;3;1;2;0;0;0;0;0;0;0;8kNpd
62;École doctorale Sciences de la vie et de la santé;;6;Sciences humaines et humanités;2021;2020-21;2020;2020;3;1;2;7;4;3;0;0;0;0;0;0;0;vZzE7
62;École doctorale Sciences de la vie et de la santé;;8;Sciences pour l'ingénieur;2021;2020-21;2020;2020;1;0;1;1;0;1;2;0;2;1;1;0;0;vZzE7
62;École doctorale Sciences de la vie et de la santé;;10;Sciences agronomiques et écologiques;2021;2020-21;2020;2020;3;2;1;6;3;3;0;0;0;0;0;0;0;vZzE7
71;École doctorale Sciences pour l'ingénieur;;6;Sciences humaines et humanités;2021;2020-21;2020;2020;4;3;1;11;5;6;2;2;0;1;0;1;0;H6UYp
71;École doctorale Sciences pour l'ingénieur;;10;Sciences agronomiques et écologiques;2021;2020-21;2020;2020;2;2;0;3;2;1;0;0;0;0;0;0;0;H6UYp
72;École doctorale Sciences pour l'ingénieur;SPI;1;Mathématiques et leurs interactions;2021;2020-21;2020;2020;15;4;11;48;13;35;13;6;7;8;5;0;0;47QPx
73;École doctorale Sciences économiques, sociales, de l'aménagement et du management;SESAM;1;Mathématiques et leurs interactions;2021;2020-21;2020;2020;0;0;0;1;1;0;0;0;0;0;0;0;0;IQ0Hk
73;École doctorale Sciences économiques, sociales, de l'aménagement et du management;SESAM;7;Sciences de la société;2021;2020-21;2020;2020;27;12;15;147;62;85;21;15;6;3;9;4;5;IQ0Hk
78;École doctorale Sociétés, langages, temps, connaissances;STLC;7;Sciences de la société;2021;2020-21;2020;2020;13;6;7;57;37;20;7;3;4;2;0;2;3;vLU3i
79;École doctorale Sciences juridiques, politiques, économiques et de gestion;SJPEG;7;Sciences de la société;2021;2020-21;2020;2020;45;19;26;190;98;92;17;4;13;1;5;6;5;ea4x6
86;École doctorale Sociétés, humanités, arts, lettres;LSHS;6;Sciences humaines et humanités;2021;2020-21;2020;2020;72;35;37;252;147;105;32;21;11;5;10;13;4;O8E6y
101;École doctorale de Sciences juridiques;;6;Sciences humaines et humanités;2021;2020-21;2020;2020;2;1;1;2;1;1;0;0;0;0;0;0;0;569G2
104;École doctorale Sciences de la matière, du rayonnement et de l'environnement;SMRE;4;Chimie;2021;2020-21;2020;2020;59;30;29;206;94;112;41;23;18;23;18;0;0;Q5iFz
104;École doctorale Sciences de la matière, du rayonnement et de l'environnement;SMRE;10;Sciences agronomiques et écologiques;2021;2020-21;2020;2020;21;13;8;69;48;21;20;11;9;11;6;3;0;Q5iFz
122;École doctorale Europe latine - Amérique latine;;6;Sciences humaines et humanités;2021;2020-21;2020;2020;17;9;8;101;67;34;12;7;5;1;2;4;5;z9lZY
127;École doctorale Astronomie et astrophysique d'Ile de France;A&A;3;Sciences de la terre et de l'univers, espace;2021;2020-21;2020;2020;56;21;35;163;54;109;40;11;29;36;4;0;0;cPXrq
129;École doctorale Sciences de l'environnement d'Ile de France;SEIF;8;Sciences pour l'ingénieur;2021;2020-21;2020;2020;1;0;1;4;2;2;0;0;0;0;0;0;0;TnAPh
129;École doctorale Sciences de l'environnement d'Ile de France;SEIF;10;Sciences agronomiques et écologiques;2021;2020-21;2020;2020;0;0;0;2;1;1;0;0;0;0;0;0;0;TnAPh
130;École doctorale Informatique, télécommunications et électronique de Paris;EDITE;8;Sciences pour l'ingénieur;2021;2020-21;2020;2020;14;4;10;27;6;21;2;0;2;0;2;0;0;O5ysj
131;École doctorale Langue, littérature, image, civilisations et sciences humaines (domaines francophone et anglophone);LLI;7;Sciences de la société;2021;2020-21;2020;2020;47;30;17;143;98;45;11;8;3;2;6;2;1;a47aW
139;École doctorale Connaissance, langage, modélisation;CLM;5;Biologie, médecine et santé;2021;2020-21;2020;2020;1;1;0;2;2;0;0;0;0;0;0;0;0;1lxGH
139;École doctorale Connaissance, langage, modélisation;CLM;9;Sciences et technologies de l'information et de la communication;2021;2020-21;2020;2020;1;1;0;1;1;0;1;0;1;0;0;1;0;1lxGH
151;École doctorale Biologie, santé, biotechnologies;;5;Biologie, médecine et santé;2021;2020-21;2020;2020;100;73;27;362;236;126;83;56;27;30;47;3;3;yP8w4
162;École doctorale Mécanique, énergétique, génie civil, acoustique;MEGA;2;Physique;2021;2020-21;2020;2020;4;1;3;6;2;4;0;0;0;0;0;0;0;7wCke
166;École doctorale Information, structures et systèmes;I2S;7;Sciences de la société;2021;2020-21;2020;2020;0;0;0;2;1;1;0;0;0;0;0;0;0;2uO68
173;École doctorale Sciences de l'univers, de l'environnement et de l'espace;SDU2E;3;Sciences de la terre et de l'univers, espace;2021;2020-21;2020;2020;62;29;33;233;86;147;65;20;45;44;16;5;0;R0Z9c
182;École doctorale Physique et chimie-physique;;5;Biologie, médecine et santé;2021;2020-21;2020;2020;1;1;0;3;1;2;0;0;0;0;0;0;0;3My6I
184;École doctorale Mathématiques et informatique de Marseille;;2;Physique;2021;2020-21;2020;2020;0;0;0;0;0;0;1;0;1;0;1;0;0;DDObG
205;École doctorale Interdisciplinaire Sciences-Santé;EDISS;9;Sciences et technologies de l'information et de la communication;2021;2020-21;2020;2020;0;0;0;10;5;5;3;1;2;2;0;1;0;69W38
206;École doctorale Chimie : chimie, procédés, environnement;;4;Chimie;2021;2020-21;2020;2020;73;34;39;347;161;186;75;31;44;52;21;2;0;m0UhD
209;École doctorale Sciences physiques et de L'ingénieur;SPI;3;Sciences de la terre et de l'univers, espace;2021;2020-21;2020;2020;3;1;2;9;2;7;6;1;5;6;0;0;0;tZcIZ
209;École doctorale Sciences physiques et de L'ingénieur;SPI;9;Sciences et technologies de l'information et de la communication;2021;2020-21;2020;2020;49;12;37;152;35;117;34;6;28;16;18;0;0;tZcIZ
211;École doctorale Sciences exactes et leurs applications;ED SEA;1;Mathématiques et leurs interactions;2021;2020-21;2020;2020;11;3;8;32;11;21;5;1;4;5;0;0;0;1G1iC
211;École doctorale Sciences exactes et leurs applications;ED SEA;8;Sciences pour l'ingénieur;2021;2020-21;2020;2020;28;10;18;77;27;50;14;2;12;8;5;1;0;1G1iC
216;École doctorale Ingénierie pour la santé, la cognition, l'environnement;EDISCE;4;Chimie;2021;2020-21;2020;2020;0;0;0;0;0;0;1;0;1;0;1;0;0;fPs1t
216;École doctorale Ingénierie pour la santé, la cognition, l'environnement;EDISCE;9;Sciences et technologies de l'information et de la communication;2021;2020-21;2020;2020;4;4;0;10;8;2;4;2;2;1;2;1;0;fPs1t
218;École doctorale Chimie et sciences du vivant;EDCSV;4;Chimie;2021;2020-21;2020;2020;35;15;20;120;50;70;16;5;11;11;5;0;0;8bcJh
218;École doctorale Chimie et sciences du vivant;EDCSV;10;Sciences agronomiques et écologiques;2021;2020-21;2020;2020;3;0;3;20;11;9;1;0;1;0;0;1;0;8bcJh
220;École doctorale Électronique, électrotechnique, automatique, traitement du signal;EEATS;2;Physique;2021;2020-21;2020;2020;18;7;11;57;16;41;19;6;13;6;13;0;0;IxEaw
220;École doctorale Électronique, électrotechnique, automatique, traitement du signal;EEATS;6;Sciences humaines et humanités;2021;2020-21;2020;2020;1;1;0;1;1;0;0;0;0;0;0;0;0;IxEaw
220;École doctorale Électronique, électrotechnique, automatique, traitement du signal;EEATS;8;Sciences pour l'ingénieur;2021;2020-21;2020;2020;55;7;48;210;36;174;31;8;23;12;17;2;0;IxEaw
222;École doctorale Sciences chimiques;EDSC;6;Sciences humaines et humanités;2021;2020-21;2020;2020;0;0;0;2;1;1;0;0;0;0;0;0;0;AdU8Q
224;École doctorale Cognition, langage, interaction;;6;Sciences humaines et humanités;2021;2020-21;2020;2020;22;15;7;153;97;56;18;13;5;1;6;2;9;7v43e
224;École doctorale Cognition, langage, interaction;;9;Sciences et technologies de l'information et de la communication;2021;2020-21;2020;2020;5;4;1;37;16;21;2;0;2;0;2;0;0;7v43e
227;École doctorale Sciences de la nature et de l'homme;;3;Sciences de la terre et de l'univers, espace;2021;2020-21;2020;2020;1;1;0;17;8;9;6;0;6;6;0;0;0;xiDA5
231;École doctorale Économie et gestion;EDEG;7;Sciences de la société;2021;2020-21;2020;2020;33;16;17;160;83;77;34;15;19;4;11;14;5;KT720
245;École doctorale Sciences économiques, juridiques, politiques et de gestion;;7;Sciences de la société;2021;2020-21;2020;2020;25;13;12;172;68;104;28;8;20;6;9;8;5;ShLUg
267;École doctorale Arts et médias;;9;Sciences et technologies de l'information et de la communication;2021;2020-21;2020;2020;4;3;1;43;29;14;5;3;2;0;0;2;3;eCF5C
269;École doctorale Mathématiques, sciences de l'information et de l'ingénieur;MSII;6;Sciences humaines et humanités;2021;2020-21;2020;2020;1;1;0;3;2;1;2;0;2;1;1;0;0;5E625
300;École doctorale Sciences Économiques;ED SE;6;Sciences humaines et humanités;2021;2020-21;2020;2020;6;1;5;13;3;10;0;0;0;0;0;0;0;5x3fM
304;École doctorale Sciences et environnements;;10;Sciences agronomiques et écologiques;2021;2020-21;2020;2020;13;9;4;51;22;29;11;7;4;4;7;0;0;2ywZn
305;École doctorale Énergie et environnement;E2;2;Physique;2021;2020-21;2020;2020;0;0;0;7;0;7;0;0;0;0;0;0;0;Kbt8I
323;École doctorale Génie électrique, électronique et télécommunications;GEET;5;Biologie, médecine et santé;2021;2020-21;2020;2020;0;0;0;8;4;4;0;0;0;0;0;0;0;arcz6
327;École doctorale Temps, espaces, sociétés, cultures;TESC;7;Sciences de la société;2021;2020-21;2020;2020;18;8;10;91;55;36;10;3;7;2;2;3;3;IjgiJ
327;École doctorale Temps, espaces, sociétés, cultures;TESC;8;Sciences pour l'ingénieur;2021;2020-21;2020;2020;0;0;0;4;2;2;0;0;0;0;0;0;0;IjgiJ
328;École doctorale Arts, lettres, langues, philosophie et communication;ALLPH@;5;Biologie, médecine et santé;2021;2020-21;2020;2020;0;0;0;1;1;0;0;0;0;0;0;0;0;xLxMh
328;École doctorale Arts, lettres, langues, philosophie et communication;ALLPH@;9;Sciences et technologies de l'information et de la communication;2021;2020-21;2020;2020;6;6;0;36;21;15;2;1;1;0;0;1;1;xLxMh
361;École doctorale Sciences et Technologies;ED ST;8;Sciences pour l'ingénieur;2021;2020-21;2020;2020;9;1;8;39;10;29;7;4;3;2;3;2;0;cOUmL
364;École doctorale Sciences fondamentales et appliquées;EDSFA;2;Physique;2021;2020-21;2020;2020;18;1;17;67;8;59;12;2;10;8;3;1;0;E483q
370;École doctorale Lettres, sciences humaines et sociales;LSHS;6;Sciences humaines et humanités;2021;2020-21;2020;2020;37;20;17;179;95;84;21;13;8;3;3;2;13;xAXXx
377;École doctorale Environnement et société;;5;Biologie, médecine et santé;2021;2020-21;2020;2020;2;2;0;4;2;2;1;1;0;1;0;0;0;ZMG5u
377;École doctorale Environnement et société;;7;Sciences de la société;2021;2020-21;2020;2020;8;3;5;41;29;12;3;1;2;0;1;1;1;ZMG5u
377;École doctorale Environnement et société;;8;Sciences pour l'ingénieur;2021;2020-21;2020;2020;3;1;2;8;5;3;1;0;1;0;1;0;0;ZMG5u
377;École doctorale Environnement et société;;10;Sciences agronomiques et écologiques;2021;2020-21;2020;2020;2;1;1;9;5;4;4;3;1;1;2;0;1;ZMG5u
397;École doctorale Physique et chimie des matériaux;;2;Physique;2021;2020-21;2020;2020;27;9;18;98;33;65;19;6;13;15;4;0;0;WxSt9
397;École doctorale Physique et chimie des matériaux;;4;Chimie;2021;2020-21;2020;2020;45;18;27;160;77;83;29;15;14;22;7;0;0;WxSt9
401;École doctorale Sciences sociales;;6;Sciences humaines et humanités;2021;2020-21;2020;2020;13;6;7;146;71;75;10;5;5;0;0;6;4;raQ7K
401;École doctorale Sciences sociales;;7;Sciences de la société;2021;2020-21;2020;2020;38;20;18;182;97;85;11;4;7;2;1;5;3;raQ7K
402;École doctorale Sciences de la vie et de la santé;SVS;8;Sciences pour l'ingénieur;2021;2020-21;2020;2020;1;1;0;2;1;1;0;0;0;0;0;0;0;YKgsU
405;École doctorale Économie, management,mathématiques et physique de Cergy;EM2C;1;Mathématiques et leurs interactions;2021;2020-21;2020;2020;3;0;3;17;4;13;3;2;1;1;2;0;0;QbwSB
406;École doctorale Chimie moléculaire de Paris centre;;4;Chimie;2021;2020-21;2020;2020;30;17;13;97;47;50;34;14;20;26;8;0;0;a5dKy
417;École doctorale Sciences et Ingénierie;S&I;3;Sciences de la terre et de l'univers, espace;2021;2020-21;2020;2020;4;1;3;9;4;5;1;0;1;1;0;0;0;SSBvE
417;École doctorale Sciences et Ingénierie;S&I;9;Sciences et technologies de l'information et de la communication;2021;2020-21;2020;2020;2;0;2;7;3;4;0;0;0;0;0;0;0;SSBvE
432;École doctorale Sciences des métiers de l'ingénieur;SMI;5;Biologie, médecine et santé;2021;2020-21;2020;2020;0;0;0;1;0;1;1;1;0;1;0;0;0;nSsHB
446;École doctorale Biologie - Santé;EDBSL;4;Chimie;2021;2020-21;2020;2020;3;1;2;12;6;6;1;1;0;1;0;0;0;4iEUF
446;École doctorale Biologie - Santé;EDBSL;5;Biologie, médecine et santé;2021;2020-21;2020;2020;103;61;42;339;195;144;64;36;28;34;27;2;1;4iEUF
450;École doctorale Recherches en psychanalyse et psychopathologie;PSY²;6;Sciences humaines et humanités;2021;2020-21;2020;2020;21;15;6;133;86;47;16;6;10;4;5;4;3;8jI3f
465;École doctorale Économie Panthéon Sorbonne;EPS;7;Sciences de la société;2021;2020-21;2020;2020;46;21;25;264;113;151;50;23;27;8;19;18;5;MV68S
467;École doctorale Aéronautique, astronautique;AA;1;Mathématiques et leurs interactions;2021;2020-21;2020;2020;3;0;3;21;2;19;8;1;7;6;2;0;0;U7l45
467;École doctorale Aéronautique, astronautique;AA;8;Sciences pour l'ingénieur;2021;2020-21;2020;2020;10;2;8;29;9;20;4;1;3;2;2;0;0;U7l45
467;École doctorale Aéronautique, astronautique;AA;9;Sciences et technologies de l'information et de la communication;2021;2020-21;2020;2020;2;1;1;10;3;7;2;1;1;1;1;0;0;U7l45
469;École doctorale du Pacifique;EDP;3;Sciences de la terre et de l'univers, espace;2021;2020-21;2020;2020;0;0;0;2;2;0;0;0;0;0;0;0;0;t9Z2n
472;École doctorale de l'EPHE;;10;Sciences agronomiques et écologiques;2021;2020-21;2020;2020;2;2;0;8;5;3;4;2;2;0;4;0;0;27zK4
473;École doctorale Sciences de l'homme et de la société;SHS;6;Sciences humaines et humanités;2021;2020-21;2020;2020;128;75;53;593;344;249;78;46;32;16;11;27;24;8qKD9
474;École doctorale Interdisciplinaire européenne frontières du vivant;FDV;7;Sciences de la société;2021;2020-21;2020;2020;3;1;2;7;4;3;1;1;0;1;0;0;0;E727j
474;École doctorale Interdisciplinaire européenne frontières du vivant;FDV;9;Sciences et technologies de l'information et de la communication;2021;2020-21;2020;2020;0;0;0;10;4;6;0;0;0;0;0;0;0;E727j
474;École doctorale Interdisciplinaire européenne frontières du vivant;FDV;10;Sciences agronomiques et écologiques;2021;2020-21;2020;2020;0;0;0;13;5;8;0;0;0;0;0;0;0;E727j
475;École doctorale Mathématiques, informatique, télécommunications de Toulouse;MITT;1;Mathématiques et leurs interactions;2021;2020-21;2020;2020;43;4;39;149;33;116;23;5;18;16;5;2;0;xcp2r
482;École doctorale Sciences de la matière;SDM;2;Physique;2021;2020-21;2020;2020;28;7;21;71;24;47;23;9;14;18;5;0;0;kmeZ4
482;École doctorale Sciences de la matière;SDM;10;Sciences agronomiques et écologiques;2021;2020-21;2020;2020;0;0;0;3;2;1;0;0;0;0;0;0;0;kmeZ4
484;École doctorale Lettres, langues, linguistique, arts;3LA;6;Sciences humaines et humanités;2021;2020-21;2020;2020;86;51;35;461;284;177;59;30;29;6;13;20;20;BlCQD
485;École doctorale Éducation, Psychologie, Information et Communication;EPIC;6;Sciences humaines et humanités;2021;2020-21;2020;2020;35;20;15;205;130;75;24;16;8;5;7;5;7;O82eL
485;École doctorale Éducation, Psychologie, Information et Communication;EPIC;9;Sciences et technologies de l'information et de la communication;2021;2020-21;2020;2020;0;0;0;1;1;0;1;0;1;0;0;0;1;O82eL
486;École doctorale Sciences économiques et de gestion;SEG;7;Sciences de la société;2021;2020-21;2020;2020;35;18;17;146;71;75;29;16;13;9;13;6;1;h1GZ3
488;École doctorale Sciences, ingénierie, santé;SIS;3;Sciences de la terre et de l'univers, espace;2021;2020-21;2020;2020;2;1;1;9;6;3;2;1;1;1;1;0;0;Fy2lK
488;École doctorale Sciences, ingénierie, santé;SIS;8;Sciences pour l'ingénieur;2021;2020-21;2020;2020;27;9;18;112;38;74;22;8;14;6;13;2;1;Fy2lK
493;École doctorale Erasme;;7;Sciences de la société;2021;2020-21;2020;2020;26;11;15;137;66;71;19;6;13;6;1;7;5;FPW4T
509;École doctorale Civilisations et sociétés euro-méditerranéennes et comparées;;6;Sciences humaines et humanités;2021;2020-21;2020;2020;3;1;2;34;19;15;6;4;2;1;2;1;2;9tbyG
512;École doctorale Informatique et mathématiques;InfoMaths;9;Sciences et technologies de l'information et de la communication;2021;2020-21;2020;2020;52;7;45;189;41;148;52;9;43;25;26;1;0;t86bi
513;École doctorale Droit et sciences politiques, économiques et de gestion;DESPEG;7;Sciences de la société;2021;2020-21;2020;2020;43;25;18;259;124;135;22;10;12;5;3;6;8;aVHGU
519;École doctorale Sciences humaines et sociales - Perspectives européennes;SHS-PE;6;Sciences humaines et humanités;2021;2020-21;2020;2020;40;22;18;250;140;110;41;25;16;5;8;15;13;2f5qs
528;École doctorale Ville, transports et territoires;VTT;7;Sciences de la société;2021;2020-21;2020;2020;14;7;7;43;24;19;2;1;1;0;0;1;1;68zCc
529;École doctorale Cultures et sociétés;CS;6;Sciences humaines et humanités;2021;2020-21;2020;2020;44;21;23;220;118;102;20;8;12;1;2;12;5;XU9tb
530;École doctorale Organisations, marchés, institutions;OMI;5;Biologie, médecine et santé;2021;2020-21;2020;2020;1;0;1;2;0;2;0;0;0;0;0;0;0;4htv7
530;École doctorale Organisations, marchés, institutions;OMI;6;Sciences humaines et humanités;2021;2020-21;2020;2020;35;13;22;153;60;93;17;9;8;1;5;6;5;4htv7
530;École doctorale Organisations, marchés, institutions;OMI;7;Sciences de la société;2021;2020-21;2020;2020;12;5;7;80;40;40;16;8;8;2;2;5;7;4htv7
531;École doctorale Sciences, ingénierie et environnement;SIE;4;Chimie;2021;2020-21;2020;2020;8;4;4;26;17;9;3;0;3;3;0;0;0;b5BYq
532;École doctorale Mathématiques et sciences et technologies de l'information et de la communication;MSTIC;9;Sciences et technologies de l'information et de la communication;2021;2020-21;2020;2020;48;13;35;152;41;111;30;3;27;15;14;0;1;t43KM
536;École doctorale Sciences et agrosciences;;1;Mathématiques et leurs interactions;2021;2020-21;2020;2020;1;1;0;5;3;2;0;0;0;0;0;0;0;pHfqe
536;École doctorale Sciences et agrosciences;;4;Chimie;2021;2020-21;2020;2020;4;3;1;15;9;6;2;2;0;2;0;0;0;pHfqe
536;École doctorale Sciences et agrosciences;;10;Sciences agronomiques et écologiques;2021;2020-21;2020;2020;11;2;9;61;28;33;8;4;4;5;2;1;0;pHfqe
540;"École doctorale École transdisciplinaire ""lettres/sciences""";;7;Sciences de la société;2021;2020-21;2020;2020;3;2;1;14;7;7;0;0;0;0;0;0;0;tWWw7
540;"École doctorale École transdisciplinaire ""lettres/sciences""";;8;Sciences pour l'ingénieur;2021;2020-21;2020;2020;0;0;0;3;3;0;0;0;0;0;0;0;0;tWWw7
541;École doctorale de sciences humaines et sociales de La Réunion;SHS;3;Sciences de la terre et de l'univers, espace;2021;2020-21;2020;2020;1;1;0;1;1;0;0;0;0;0;0;0;0;21SpE
542;École doctorale de sciences de La Réunion;STS;5;Biologie, médecine et santé;2021;2020-21;2020;2020;18;8;10;48;27;21;4;1;3;2;1;0;1;2pAql
543;École doctorale de Dauphine;;9;Sciences et technologies de l'information et de la communication;2021;2020-21;2020;2020;11;2;9;44;9;35;7;2;5;3;3;1;0;u8w6A
544;École doctorale Inter-Med : Espaces, temps, cultures;INTER-MED;6;Sciences humaines et humanités;2021;2020-21;2020;2020;31;14;17;117;58;59;12;5;7;4;2;6;0;7VjtD
545;École doctorale Sociétés, politique et santé publique;SP2;5;Biologie, médecine et santé;2021;2020-21;2020;2020;36;23;13;109;60;49;16;7;9;7;8;1;0;IAKR4
548;École doctorale Mer et Sciences;;3;Sciences de la terre et de l'univers, espace;2021;2020-21;2020;2020;2;2;0;7;4;3;2;1;1;1;0;1;0;QX0fS
548;École doctorale Mer et Sciences;;4;Chimie;2021;2020-21;2020;2020;5;1;4;19;9;10;1;0;1;0;0;1;0;QX0fS
549;École doctorale Santé, Sciences Biologiques et Chimie du Vivant;SSBCV;2;Physique;2021;2020-21;2020;2020;0;0;0;1;0;1;1;1;0;1;0;0;0;B9ggO
551;École doctorale Mathématiques, Informatique, Physique Théorique et Ingénierie des Systèmes;MIPTIS;1;Mathématiques et leurs interactions;2021;2020-21;2020;2020;6;0;6;28;6;22;5;1;4;2;3;0;0;Mpudz
552;École doctorale Énergie - Matériaux - Sciences de la Terre et de l'Univers;EMTSU;3;Sciences de la terre et de l'univers, espace;2021;2020-21;2020;2020;16;8;8;56;22;34;13;7;6;8;4;0;1;NTZhw
553;École doctorale Carnot - Pasteur;;1;Mathématiques et leurs interactions;2021;2020-21;2020;2020;17;5;12;57;11;46;6;1;5;3;2;0;1;6h4Z7
553;École doctorale Carnot - Pasteur;;3;Sciences de la terre et de l'univers, espace;2021;2020-21;2020;2020;0;0;0;2;2;0;2;0;2;2;0;0;0;6h4Z7
554;École doctorale Environnements - Santé;E-S;5;Biologie, médecine et santé;2021;2020-21;2020;2020;61;38;23;262;138;124;47;27;20;18;25;4;0;ElyFU
560;École doctorale Sciences de la terre et de l'environnement et Physique de l'univers, Paris;STEP'UP;2;Physique;2021;2020-21;2020;2020;17;5;12;66;16;50;17;5;12;17;0;0;0;Z2VI9
563;École doctorale Médicament - Toxicologie - Chimie - Imageries;MTCI;4;Chimie;2021;2020-21;2020;2020;32;22;10;49;24;25;9;3;6;3;6;0;0;j8uk1
566;École doctorale Sciences du Sport, de la Motricité et du Mouvement Humain;SMMH;7;Sciences de la société;2021;2020-21;2020;2020;0;0;0;2;0;2;0;0;0;0;0;0;0;3iv8y
567;École doctorale Sciences du Végétal : du gène à l'écosystème;;10;Sciences agronomiques et écologiques;2021;2020-21;2020;2020;19;10;9;48;24;24;9;6;3;3;5;0;1;tuDkA
570;École doctorale Santé Publique;EDSP;5;Biologie, médecine et santé;2021;2020-21;2020;2020;38;23;15;145;91;54;32;17;15;18;12;2;0;9lgE4
572;École doctorale Ondes et matière;EDOM;2;Physique;2021;2020-21;2020;2020;47;12;35;174;50;124;36;10;26;23;12;1;0;etSIi
573;École doctorale Interfaces : Approches Interdisciplinaires, Fondements, Applications et Innovation;ED INTERFACES;8;Sciences pour l'ingénieur;2021;2020-21;2020;2020;10;2;8;44;15;29;9;4;5;3;4;2;0;gG820
575;École doctorale Electrical, Optical, Bio : Physics and Engineering;EOBE;1;Mathématiques et leurs interactions;2021;2020-21;2020;2020;0;0;0;1;0;1;0;0;0;0;0;0;0;dfhyn
575;École doctorale Electrical, Optical, Bio : Physics and Engineering;EOBE;2;Physique;2021;2020-21;2020;2020;26;9;17;94;39;55;23;10;13;9;11;3;0;dfhyn
577;École doctorale Structure et dynamique des systèmes vivants;SDSV;10;Sciences agronomiques et écologiques;2021;2020-21;2020;2020;2;0;2;6;2;4;1;1;0;0;1;0;0;4bsxJ
580;École doctorale Sciences et technologies de l'information et de la communication;STIC;9;Sciences et technologies de l'information et de la communication;2021;2020-21;2020;2020;113;25;88;442;108;334;86;28;58;54;28;4;0;AzCC0
581;École doctorale Agriculture, alimentation, biologie, environnement, santé;ABIES;4;Chimie;2021;2020-21;2020;2020;6;4;2;17;11;6;7;2;5;1;5;1;0;c1x56
581;École doctorale Agriculture, alimentation, biologie, environnement, santé;ABIES;5;Biologie, médecine et santé;2021;2020-21;2020;2020;23;15;8;67;48;19;14;9;5;8;5;1;0;c1x56
582;École doctorale Cancérologie, Biologie, Médecine, Santé;CBMS;5;Biologie, médecine et santé;2021;2020-21;2020;2020;46;27;19;213;119;94;47;30;17;16;26;4;1;75bj4
583;École doctorale Risques et Société;;4;Chimie;2021;2020-21;2020;2020;2;1;1;5;3;2;0;0;0;0;0;0;0;wUBi9
583;École doctorale Risques et Société;;5;Biologie, médecine et santé;2021;2020-21;2020;2020;1;0;1;4;3;1;0;0;0;0;0;0;0;wUBi9
583;École doctorale Risques et Société;;9;Sciences et technologies de l'information et de la communication;2021;2020-21;2020;2020;2;2;0;12;7;5;2;1;1;0;2;0;0;wUBi9
584;École doctorale Biodiversité, Agriculture, Alimentation, Environnement, Terre, Eau;GAIA;3;Sciences de la terre et de l'univers, espace;2021;2020-21;2020;2020;16;7;9;69;27;42;13;4;9;11;2;0;0;F1h5f
584;École doctorale Biodiversité, Agriculture, Alimentation, Environnement, Terre, Eau;GAIA;5;Biologie, médecine et santé;2021;2020-21;2020;2020;24;14;10;68;38;30;12;7;5;6;6;0;0;F1h5f
585;École doctorale Sciences, Technologie,  Sante;EDSTS;2;Physique;2021;2020-21;2020;2020;11;4;7;26;12;14;2;2;0;1;1;0;0;NM3Dl
587;École doctorale Diversites, santé et développement en Amazonie;;7;Sciences de la société;2021;2020-21;2020;2020;3;2;1;11;6;5;1;0;1;1;0;0;0;V14tj
587;École doctorale Diversites, santé et développement en Amazonie;;9;Sciences et technologies de l'information et de la communication;2021;2020-21;2020;2020;0;0;0;3;1;2;0;0;0;0;0;0;0;V14tj
589;École doctorale Milieu insulaire tropical à risques : protection, valorisation , santé et développement;;1;Mathématiques et leurs interactions;2021;2020-21;2020;2020;5;0;5;11;1;10;1;0;1;1;0;0;0;2cqi3
589;École doctorale Milieu insulaire tropical à risques : protection, valorisation , santé et développement;;3;Sciences de la terre et de l'univers, espace;2021;2020-21;2020;2020;0;0;0;4;2;2;0;0;0;0;0;0;0;2cqi3
589;École doctorale Milieu insulaire tropical à risques : protection, valorisation , santé et développement;;6;Sciences humaines et humanités;2021;2020-21;2020;2020;3;2;1;3;2;1;2;1;1;0;1;1;0;2cqi3
590;École doctorale Mathematiques, Information, Ingenierie des Systemes;MIIS;1;Mathématiques et leurs interactions;2021;2020-21;2020;2020;10;2;8;49;18;31;11;2;9;6;4;1;0;L20t5
591;École doctorale Physique, Sciences de l'Ingenieur, Materiaux, Énergie;PSIME;2;Physique;2021;2020-21;2020;2020;31;11;20;96;34;62;17;8;9;13;3;1;0;Hn5Om
591;École doctorale Physique, Sciences de l'Ingenieur, Materiaux, Énergie;PSIME;4;Chimie;2021;2020-21;2020;2020;12;3;9;41;15;26;7;2;5;6;1;0;0;Hn5Om
591;École doctorale Physique, Sciences de l'Ingenieur, Materiaux, Énergie;PSIME;8;Sciences pour l'ingénieur;2021;2020-21;2020;2020;28;8;20;159;50;109;35;9;26;17;17;1;0;Hn5Om
595;École doctorale Arts, Lettres, Langues;ED ALL;6;Sciences humaines et humanités;2021;2020-21;2020;2020;64;45;19;362;237;125;45;28;17;3;8;13;21;a8f9b
596;École doctorale Matière, Molécules et Matériaux;ED 3M;2;Physique;2021;2020-21;2020;2020;21;4;17;108;38;70;27;9;18;18;8;1;0;77947
598;École doctorale Sciences de La Mer et du Littoral;SML;3;Sciences de la terre et de l'univers, espace;2021;2020-21;2020;2020;20;7;13;76;39;37;19;6;13;11;7;1;0;Smen6
598;École doctorale Sciences de La Mer et du Littoral;SML;5;Biologie, médecine et santé;2021;2020-21;2020;2020;11;6;5;48;27;21;7;3;4;3;3;1;0;Smen6
598;École doctorale Sciences de La Mer et du Littoral;SML;6;Sciences humaines et humanités;2021;2020-21;2020;2020;5;3;2;18;10;8;3;3;0;0;0;2;1;Smen6
600;École doctorale Écologie, Géosciences, Agronomie et Alimentation;EGAAL;5;Biologie, médecine et santé;2021;2020-21;2020;2020;5;2;3;25;14;11;14;6;8;10;3;1;0;urS33
600;École doctorale Écologie, Géosciences, Agronomie et Alimentation;EGAAL;8;Sciences pour l'ingénieur;2021;2020-21;2020;2020;2;1;1;4;3;1;0;0;0;0;0;0;0;urS33
600;École doctorale Écologie, Géosciences, Agronomie et Alimentation;EGAAL;9;Sciences et technologies de l'information et de la communication;2021;2020-21;2020;2020;1;0;1;3;0;3;0;0;0;0;0;0;0;urS33
601;École doctorale Mathématiques et Sciences et Technologies de l'information et de la Communication;MathSTIC;6;Sciences humaines et humanités;2021;2020-21;2020;2020;0;0;0;5;1;4;0;0;0;0;0;0;0;3Ue20
602;École doctorale Sciences pour l'Ingénieur;SPI;6;Sciences humaines et humanités;2021;2020-21;2020;2020;4;2;2;4;2;2;2;0;2;2;0;0;0;8yWbu
606;École doctorale Chimie - Mécanique - Matériaux - Physique;C2MP;4;Chimie;2021;2020-21;2020;2020;19;10;9;80;45;35;18;7;11;12;4;2;0;UkNR2
606;École doctorale Chimie - Mécanique - Matériaux - Physique;C2MP;8;Sciences pour l'ingénieur;2021;2020-21;2020;2020;28;7;21;92;23;69;24;4;20;9;14;1;0;UkNR2
607;École doctorale Sciences et Ingénierie des Ressources Naturelles;SIReNA;5;Biologie, médecine et santé;2021;2020-21;2020;2020;1;0;1;1;0;1;0;0;0;0;0;0;0;vi9w2
608;École doctorale Sciences et Ingénierie des Molécules, des Produits, des Procédés et de l'Énergie;SIMPPÉ;8;Sciences pour l'ingénieur;2021;2020-21;2020;2020;41;14;27;173;65;108;37;7;30;19;16;2;0;TyNjM
612;École doctorale Humanités;;6;Sciences humaines et humanités;2021;2020-21;2020;2020;54;31;23;283;155;128;26;16;10;6;7;8;5;v30I8
614;École doctorale Chimie, Écologie, Géosciences, Agrosciences - Théodore Monod;CEGA;4;Chimie;2021;2020-21;2020;2020;19;11;8;61;32;29;19;10;9;13;5;1;0;uc10I
617;École doctorale Sciences de la Société : Territoires, Economie et Droit;SSTED;7;Sciences de la société;2021;2020-21;2020;2020;43;19;24;165;83;82;17;6;11;3;1;8;5;Kl9ZX
618;École doctorale EUCLIDE;;3;Sciences de la terre et de l'univers, espace;2021;2020-21;2020;2020;2;0;2;11;4;7;0;0;0;0;0;0;0;qveTN
618;École doctorale EUCLIDE;;5;Biologie, médecine et santé;2021;2020-21;2020;2020;0;0;0;7;2;5;1;0;1;1;0;0;0;qveTN
618;École doctorale EUCLIDE;;8;Sciences pour l'ingénieur;2021;2020-21;2020;2020;7;0;7;39;14;25;14;3;11;7;6;1;0;qveTN
618;École doctorale EUCLIDE;;10;Sciences agronomiques et écologiques;2021;2020-21;2020;2020;15;11;4;46;27;19;10;7;3;9;1;0;0;qveTN
619;École doctorale Sciences Fondamentales et Santé;SFS;3;Sciences de la terre et de l'univers, espace;2021;2020-21;2020;2020;0;0;0;2;1;1;0;0;0;0;0;0;0;JiZVW
619;École doctorale Sciences Fondamentales et Santé;SFS;4;Chimie;2021;2020-21;2020;2020;4;1;3;20;7;13;2;2;0;2;0;0;0;JiZVW
619;École doctorale Sciences Fondamentales et Santé;SFS;9;Sciences et technologies de l'information et de la communication;2021;2020-21;2020;2020;0;0;0;1;1;0;0;0;0;0;0;0;0;JiZVW
622;École doctorale Sciences du langage;SDL;7;Sciences de la société;2021;2020-21;2020;2020;0;0;0;2;0;2;0;0;0;0;0;0;0;9DsG2
626;École doctorale de l’Institut Polytechnique de Paris;;4;Chimie;2021;2020-21;2020;2020;10;6;4;42;20;22;7;2;5;6;1;0;0;DL5fO
626;École doctorale de l’Institut Polytechnique de Paris;;6;Sciences humaines et humanités;2021;2020-21;2020;2020;11;4;7;25;9;16;2;1;1;0;2;0;0;DL5fO
626;École doctorale de l’Institut Polytechnique de Paris;;10;Sciences agronomiques et écologiques;2021;2020-21;2020;2020;1;1;0;1;1;0;0;0;0;0;0;0;0;DL5fO
628;École doctorale Arts Humanités et Sciences sociales;AHSS;6;Sciences humaines et humanités;2021;2020-21;2020;2020;48;29;19;188;97;91;0;0;0;0;0;0;0;vwwRK
630;École doctorale Droit, Economie et Management;DEM;7;Sciences de la société;2021;2020-21;2020;2020;33;14;19;221;98;123;22;5;17;1;8;7;6;78n8c
6;École doctorale Droit privé;;7;Sciences de la société;2019;2018-19;2018;2018;40;22;18;295;146;149;37;19;18;;;;;UMnW1
34;École doctorale Matériaux;;2;Physique;2019;2018-19;2018;2018;10;6;4;70;30;40;14;4;10;;;;;1Iufh
34;École doctorale Matériaux;;4;Chimie;2019;2018-19;2018;2018;7;5;2;27;12;15;4;2;2;;;;;1Iufh
34;École doctorale Matériaux;;8;Sciences pour l'ingénieur;2019;2018-19;2018;2018;27;11;16;119;49;70;35;17;18;;;;;1Iufh
47;École doctorale Physique;;4;Chimie;2019;2018-19;2018;2018;2;1;1;3;1;2;0;0;0;;;;;8kNpd
47;École doctorale Physique;;5;Biologie, médecine et santé;2019;2018-19;2018;2018;1;0;1;6;3;3;1;1;0;;;;;8kNpd
50;École doctorale Langues, littératures et sciences humaines;LLSH;7;Sciences de la société;2019;2018-19;2018;2018;1;1;0;1;1;0;0;0;0;;;;;8THzQ
52;École doctorale Physique et astrophysique de Lyon;PHAST;3;Sciences de la terre et de l'univers, espace;2019;2018-19;2018;2018;7;3;4;24;11;13;3;2;1;;;;;61XPb
62;École doctorale Sciences de la vie et de la santé;;2;Physique;2019;2018-19;2018;2018;0;0;0;2;1;1;0;0;0;;;;;vZzE7
62;École doctorale Sciences de la vie et de la santé;;9;Sciences et technologies de l'information et de la communication;2019;2018-19;2018;2018;1;0;1;2;0;2;0;0;0;;;;;vZzE7
65;École doctorale Sciences de la Vie, Santé, Agronomie, Environnement;;10;Sciences agronomiques et écologiques;2019;2018-19;2018;2018;0;0;0;46;25;21;17;11;6;;;;;MAOG4
70;École doctorale Sciences pour l'ingénieur;EDSPI;9;Sciences et technologies de l'information et de la communication;2019;2018-19;2018;2018;0;0;0;51;17;34;0;0;0;;;;;G413P
71;École doctorale Sciences pour l'ingénieur;;1;Mathématiques et leurs interactions;2019;2018-19;2018;2018;3;1;2;13;6;7;1;1;0;;;;;H6UYp
71;École doctorale Sciences pour l'ingénieur;;8;Sciences pour l'ingénieur;2019;2018-19;2018;2018;36;9;27;181;67;114;35;15;20;;;;;H6UYp
72;École doctorale Sciences pour l'ingénieur;SPI;8;Sciences pour l'ingénieur;2019;2018-19;2018;2018;68;25;43;253;73;180;61;15;46;;;;;47QPx
73;École doctorale Sciences économiques, sociales, de l'aménagement et du management;SESAM;1;Mathématiques et leurs interactions;2019;2018-19;2018;2018;0;0;0;1;1;0;1;1;0;;;;;IQ0Hk
73;École doctorale Sciences économiques, sociales, de l'aménagement et du management;SESAM;7;Sciences de la société;2019;2018-19;2018;2018;50;20;30;191;89;102;33;14;19;;;;;IQ0Hk
77;École doctorale Informatique, automatique, électronique, électrotechnique, mathématiques;IAEM;1;Mathématiques et leurs interactions;2019;2018-19;2018;2018;9;0;9;44;10;34;11;2;9;;;;;TCHTA
78;École doctorale Sociétés, langages, temps, connaissances;STLC;6;Sciences humaines et humanités;2019;2018-19;2018;2018;52;32;20;184;112;72;21;13;8;;;;;vLU3i
84;École doctorale Sciences et technologies de l'information et de la communication;STIC;9;Sciences et technologies de l'information et de la communication;2019;2018-19;2018;2018;53;17;36;220;30;190;47;14;33;;;;;9wS2W
104;École doctorale Sciences de la matière, du rayonnement et de l'environnement;SMRE;5;Biologie, médecine et santé;2019;2018-19;2018;2018;1;1;0;4;3;1;1;1;0;;;;;Q5iFz
130;École doctorale Informatique, télécommunications et électronique de Paris;EDITE;9;Sciences et technologies de l'information et de la communication;2019;2018-19;2018;2018;125;24;101;430;95;335;98;25;73;;;;;O5ysj
139;École doctorale Connaissance, langage, modélisation;CLM;1;Mathématiques et leurs interactions;2019;2018-19;2018;2018;0;0;0;6;0;6;1;1;0;;;;;1lxGH
154;École doctorale Sciences de la vie et de la santé;SVS;5;Biologie, médecine et santé;2019;2018-19;2018;2018;95;60;35;313;188;125;85;52;33;;;;;hLn36
158;École doctorale Cerveau, cognition, comportement;3C;5;Biologie, médecine et santé;2019;2018-19;2018;2018;104;45;59;374;198;176;88;59;29;;;;;Il62F
160;École doctorale Électronique, électrotechnique, automatique;EEA;5;Biologie, médecine et santé;2019;2018-19;2018;2018;2;1;1;12;6;6;1;1;0;;;;;EgfMQ
160;École doctorale Électronique, électrotechnique, automatique;EEA;9;Sciences et technologies de l'information et de la communication;2019;2018-19;2018;2018;35;8;27;108;24;84;13;2;11;;;;;EgfMQ
166;École doctorale Information, structures et systèmes;I2S;10;Sciences agronomiques et écologiques;2019;2018-19;2018;2018;0;0;0;3;1;2;0;0;0;;;;;2uO68
184;École doctorale Mathématiques et informatique de Marseille;;5;Biologie, médecine et santé;2019;2018-19;2018;2018;0;0;0;1;0;1;0;0;0;;;;;DDObG
205;École doctorale Interdisciplinaire Sciences-Santé;EDISS;8;Sciences pour l'ingénieur;2019;2018-19;2018;2018;0;0;0;3;0;3;1;0;1;;;;;69W38
205;École doctorale Interdisciplinaire Sciences-Santé;EDISS;9;Sciences et technologies de l'information et de la communication;2019;2018-19;2018;2018;2;1;1;5;2;3;0;0;0;;;;;69W38
206;École doctorale Chimie : chimie, procédés, environnement;;4;Chimie;2019;2018-19;2018;2018;90;42;48;339;164;175;74;32;42;;;;;m0UhD
209;École doctorale Sciences physiques et de L'ingénieur;SPI;3;Sciences de la terre et de l'univers, espace;2019;2018-19;2018;2018;2;0;2;10;2;8;2;0;2;;;;;tZcIZ
209;École doctorale Sciences physiques et de L'ingénieur;SPI;8;Sciences pour l'ingénieur;2019;2018-19;2018;2018;28;5;23;84;32;52;24;5;19;;;;;tZcIZ
209;École doctorale Sciences physiques et de L'ingénieur;SPI;9;Sciences et technologies de l'information et de la communication;2019;2018-19;2018;2018;29;9;20;128;29;99;44;11;33;;;;;tZcIZ
216;École doctorale Ingénierie pour la santé, la cognition, l'environnement;EDISCE;4;Chimie;2019;2018-19;2018;2018;0;0;0;2;1;1;0;0;0;;;;;fPs1t
216;École doctorale Ingénierie pour la santé, la cognition, l'environnement;EDISCE;6;Sciences humaines et humanités;2019;2018-19;2018;2018;15;11;4;56;36;20;12;8;4;;;;;fPs1t
216;École doctorale Ingénierie pour la santé, la cognition, l'environnement;EDISCE;9;Sciences et technologies de l'information et de la communication;2019;2018-19;2018;2018;2;2;0;12;8;4;7;3;4;;;;;fPs1t
218;École doctorale Chimie et sciences du vivant;EDCSV;10;Sciences agronomiques et écologiques;2019;2018-19;2018;2018;7;4;3;20;9;11;4;1;3;;;;;8bcJh
220;École doctorale Électronique, électrotechnique, automatique, traitement du signal;EEATS;3;Sciences de la terre et de l'univers, espace;2019;2018-19;2018;2018;0;0;0;1;0;1;1;0;1;;;;;IxEaw
220;École doctorale Électronique, électrotechnique, automatique, traitement du signal;EEATS;5;Biologie, médecine et santé;2019;2018-19;2018;2018;0;0;0;1;1;0;0;0;0;;;;;IxEaw
227;École doctorale Sciences de la nature et de l'homme;;5;Biologie, médecine et santé;2019;2018-19;2018;2018;12;8;4;33;21;12;23;8;15;;;;;xiDA5
227;École doctorale Sciences de la nature et de l'homme;;7;Sciences de la société;2019;2018-19;2018;2018;0;0;0;3;2;1;0;0;0;;;;;xiDA5
234;École doctorale de Sciences Po;;6;Sciences humaines et humanités;2019;2018-19;2018;2018;59;24;35;325;165;160;45;26;19;;;;;ux756
242;École doctorale Économie - Gestion - Normandie;;7;Sciences de la société;2019;2018-19;2018;2018;18;5;13;82;40;42;9;4;5;;;;;z35ku
251;École doctorale Sciences de l'environnement;;3;Sciences de la terre et de l'univers, espace;2019;2018-19;2018;2018;25;11;14;77;36;41;27;13;14;;;;;VR28y
265;École doctorale Langues, littératures et sociétés du monde;;6;Sciences humaines et humanités;2019;2018-19;2018;2018;52;28;24;277;174;103;36;21;15;;;;;4YWGW
267;École doctorale Arts et médias;;6;Sciences humaines et humanités;2019;2018-19;2018;2018;37;23;14;226;149;77;47;33;14;;;;;eCF5C
280;École doctorale Philosophie;;6;Sciences humaines et humanités;2019;2018-19;2018;2018;36;16;20;237;84;153;33;16;17;;;;;kJxnm
284;École doctorale Droit et Science Politique;DSP;6;Sciences humaines et humanités;2019;2018-19;2018;2018;76;40;36;260;141;119;25;12;13;;;;;ahH92
305;École doctorale Énergie et environnement;E2;2;Physique;2019;2018-19;2018;2018;1;0;1;7;1;6;3;1;2;;;;;Kbt8I
323;École doctorale Génie électrique, électronique et télécommunications;GEET;9;Sciences et technologies de l'information et de la communication;2019;2018-19;2018;2018;12;4;8;55;11;44;13;4;9;;;;;arcz6
326;École doctorale Comportement, langage, éducation, socialisation, cognition;CLESCO;6;Sciences humaines et humanités;2019;2018-19;2018;2018;70;47;23;300;194;106;41;25;16;;;;;nWIlG
327;École doctorale Temps, espaces, sociétés, cultures;TESC;1;Mathématiques et leurs interactions;2019;2018-19;2018;2018;0;0;0;0;0;0;1;0;1;;;;;IjgiJ
327;École doctorale Temps, espaces, sociétés, cultures;TESC;3;Sciences de la terre et de l'univers, espace;2019;2018-19;2018;2018;1;1;0;5;3;2;2;0;2;;;;;IjgiJ
328;École doctorale Arts, lettres, langues, philosophie et communication;ALLPH@;3;Sciences de la terre et de l'univers, espace;2019;2018-19;2018;2018;0;0;0;1;1;0;1;1;0;;;;;xLxMh
328;École doctorale Arts, lettres, langues, philosophie et communication;ALLPH@;7;Sciences de la société;2019;2018-19;2018;2018;2;2;0;11;9;2;3;1;2;;;;;xLxMh
340;École doctorale Biologie moléculaire, intégrative et cellulaire;BMIC;5;Biologie, médecine et santé;2019;2018-19;2018;2018;64;39;25;280;172;108;69;44;25;;;;;db7xq
353;École doctorale Sciences pour l'ingénieur : mécanique, physique, micro et nanoélectronique;;8;Sciences pour l'ingénieur;2019;2018-19;2018;2018;43;10;33;161;35;126;40;6;34;;;;;vk5Kp
353;École doctorale Sciences pour l'ingénieur : mécanique, physique, micro et nanoélectronique;;9;Sciences et technologies de l'information et de la communication;2019;2018-19;2018;2018;0;0;0;1;0;1;2;0;2;;;;;vk5Kp
364;École doctorale Sciences fondamentales et appliquées;EDSFA;1;Mathématiques et leurs interactions;2019;2018-19;2018;2018;12;5;7;62;15;47;14;6;8;;;;;E483q
364;École doctorale Sciences fondamentales et appliquées;EDSFA;3;Sciences de la terre et de l'univers, espace;2019;2018-19;2018;2018;17;4;13;55;12;43;24;5;19;;;;;E483q
370;École doctorale Lettres, sciences humaines et sociales;LSHS;6;Sciences humaines et humanités;2019;2018-19;2018;2018;39;18;21;202;107;95;21;9;12;;;;;xAXXx
372;École doctorale Sciences économiques et de gestion;;7;Sciences de la société;2019;2018-19;2018;2018;33;21;12;162;87;75;42;21;21;;;;;JK63A
377;École doctorale Environnement et société;;9;Sciences et technologies de l'information et de la communication;2019;2018-19;2018;2018;2;0;2;8;0;8;2;1;1;;;;;ZMG5u
386;École doctorale Sciences mathématiques de Paris centre;SMPC;1;Mathématiques et leurs interactions;2019;2018-19;2018;2018;121;24;97;445;83;362;116;19;97;;;;;wMj98
393;École doctorale Pierre Louis de Santé Publique : Épidémiologie et Sciences de l'information biomédicale;PLSP;5;Biologie, médecine et santé;2019;2018-19;2018;2018;52;31;21;225;123;102;37;16;21;;;;;69445
395;École doctorale Milieux, cultures et sociétés du passé et du présent;MCSPP;7;Sciences de la société;2019;2018-19;2018;2018;14;11;3;66;50;16;2;2;0;;;;;2quEb
396;École doctorale Économie, organisations, société;EOS;1;Mathématiques et leurs interactions;2019;2018-19;2018;2018;0;0;0;2;2;0;2;1;1;;;;;Es5e7
397;École doctorale Physique et chimie des matériaux;;4;Chimie;2019;2018-19;2018;2018;53;26;27;150;78;72;30;11;19;;;;;WxSt9
400;École doctorale Savoirs scientifiques : épistémologie, histoire des sciences, didactique des disciplines;;2;Physique;2019;2018-19;2018;2018;0;0;0;12;3;9;3;2;1;;;;;nRax3
400;École doctorale Savoirs scientifiques : épistémologie, histoire des sciences, didactique des disciplines;;5;Biologie, médecine et santé;2019;2018-19;2018;2018;1;1;0;17;13;4;1;1;0;;;;;nRax3
402;École doctorale Sciences de la vie et de la santé;SVS;5;Biologie, médecine et santé;2019;2018-19;2018;2018;33;18;15;117;75;42;27;18;9;;;;;YKgsU
402;École doctorale Sciences de la vie et de la santé;SVS;6;Sciences humaines et humanités;2019;2018-19;2018;2018;1;1;0;1;1;0;0;0;0;;;;;YKgsU
405;École doctorale Économie, management,mathématiques et physique de Cergy;EM2C;7;Sciences de la société;2019;2018-19;2018;2018;16;10;6;82;36;46;23;12;11;;;;;QbwSB
406;École doctorale Chimie moléculaire de Paris centre;;4;Chimie;2019;2018-19;2018;2018;26;11;15;111;49;62;29;9;20;;;;;a5dKy
409;École doctorale Énergie, mécanique, matériaux;EMMA;8;Sciences pour l'ingénieur;2019;2018-19;2018;2018;0;0;0;0;0;0;19;4;15;;;;;KXlbK
411;École doctorale Humanités nouvelles : Fernand Braudel;;6;Sciences humaines et humanités;2019;2018-19;2018;2018;53;21;32;279;153;126;33;19;14;;;;;l2rFh
417;École doctorale Sciences et Ingénierie;S&I;4;Chimie;2019;2018-19;2018;2018;9;5;4;27;12;15;5;3;2;;;;;SSBvE
433;École doctorale Concepts et langages;;6;Sciences humaines et humanités;2019;2018-19;2018;2018;73;42;31;471;258;213;44;30;14;;;;;v8q34
433;École doctorale Concepts et langages;;9;Sciences et technologies de l'information et de la communication;2019;2018-19;2018;2018;10;5;5;56;33;23;2;0;2;;;;;v8q34
446;École doctorale Biologie - Santé;EDBSL;6;Sciences humaines et humanités;2019;2018-19;2018;2018;2;0;2;9;5;4;2;2;0;;;;;4iEUF
454;École doctorale Sciences de l'homme, du politique et du territoire;SHPT;6;Sciences humaines et humanités;2019;2018-19;2018;2018;21;11;10;176;88;88;26;13;13;;;;;Opv31
455;École doctorale Économie, Gestion, Information et Communication;EGIC;6;Sciences humaines et humanités;2019;2018-19;2018;2018;8;5;3;51;36;15;6;3;3;;;;;qCOg3
455;École doctorale Économie, Gestion, Information et Communication;EGIC;9;Sciences et technologies de l'information et de la communication;2019;2018-19;2018;2018;0;0;0;3;0;3;0;0;0;;;;;qCOg3
458;École doctorale Sciences écologiques, vétérinaires, agronomiques et bioingénieries;SEVAB;10;Sciences agronomiques et écologiques;2019;2018-19;2018;2018;62;36;26;241;131;110;48;26;22;;;;;Yf3TI
459;École doctorale Sciences chimiques Balard;;4;Chimie;2019;2018-19;2018;2018;67;38;29;238;115;123;60;23;37;;;;;YFs2W
459;École doctorale Sciences chimiques Balard;;8;Sciences pour l'ingénieur;2019;2018-19;2018;2018;1;0;1;1;0;1;0;0;0;;;;;YFs2W
463;École doctorale Sciences du mouvement humain;SMH;6;Sciences humaines et humanités;2019;2018-19;2018;2018;3;3;0;17;13;4;7;2;5;;;;;UbtlY
463;École doctorale Sciences du mouvement humain;SMH;8;Sciences pour l'ingénieur;2019;2018-19;2018;2018;8;4;4;32;14;18;6;2;4;;;;;UbtlY
467;École doctorale Aéronautique, astronautique;AA;8;Sciences pour l'ingénieur;2019;2018-19;2018;2018;10;4;6;29;7;22;4;0;4;;;;;U7l45
469;École doctorale du Pacifique;EDP;2;Physique;2019;2018-19;2018;2018;0;0;0;0;0;0;1;0;1;;;;;t9Z2n
469;École doctorale du Pacifique;EDP;8;Sciences pour l'ingénieur;2019;2018-19;2018;2018;0;0;0;2;0;2;0;0;0;;;;;t9Z2n
469;École doctorale du Pacifique;EDP;9;Sciences et technologies de l'information et de la communication;2019;2018-19;2018;2018;2;1;1;7;1;6;1;0;1;;;;;t9Z2n
469;École doctorale du Pacifique;EDP;10;Sciences agronomiques et écologiques;2019;2018-19;2018;2018;0;0;0;11;5;6;0;0;0;;;;;t9Z2n
472;École doctorale de l'EPHE;;5;Biologie, médecine et santé;2019;2018-19;2018;2018;7;5;2;41;27;14;4;1;3;;;;;27zK4
472;École doctorale de l'EPHE;;7;Sciences de la société;2019;2018-19;2018;2018;5;3;2;30;14;16;4;1;3;;;;;27zK4
474;École doctorale Interdisciplinaire européenne frontières du vivant;FDV;10;Sciences agronomiques et écologiques;2019;2018-19;2018;2018;1;0;1;2;1;1;1;0;1;;;;;E727j
487;École doctorale Philosophie;PHCR;6;Sciences humaines et humanités;2019;2018-19;2018;2018;24;10;14;137;66;71;24;11;13;;;;;3BRzJ
488;École doctorale Sciences, ingénierie, santé;SIS;1;Mathématiques et leurs interactions;2019;2018-19;2018;2018;2;0;2;12;3;9;3;0;3;;;;;Fy2lK
488;École doctorale Sciences, ingénierie, santé;SIS;5;Biologie, médecine et santé;2019;2018-19;2018;2018;16;8;8;63;27;36;13;4;9;;;;;Fy2lK
488;École doctorale Sciences, ingénierie, santé;SIS;6;Sciences humaines et humanités;2019;2018-19;2018;2018;0;0;0;1;0;1;0;0;0;;;;;Fy2lK
488;École doctorale Sciences, ingénierie, santé;SIS;8;Sciences pour l'ingénieur;2019;2018-19;2018;2018;28;12;16;104;38;66;17;4;13;;;;;Fy2lK
489;École doctorale Sciences et ingénierie des systèmes, de l'environnement et des organisations;SISEO;9;Sciences et technologies de l'information et de la communication;2019;2018-19;2018;2018;3;1;2;22;10;12;6;4;2;;;;;6pT77
508;École doctorale Normande de chimie;EDNC;4;Chimie;2019;2018-19;2018;2018;36;14;22;133;52;81;43;27;16;;;;;E52OO
509;École doctorale Civilisations et sociétés euro-méditerranéennes et comparées;;6;Sciences humaines et humanités;2019;2018-19;2018;2018;7;3;4;46;28;18;7;4;3;;;;;9tbyG
510;École doctorale Ingénierie - Matériaux, mécanique, environnement, énergétique, procédés, production;IMEP2;4;Chimie;2019;2018-19;2018;2018;0;0;0;18;7;11;11;3;8;;;;;Ce7NF
510;École doctorale Ingénierie - Matériaux, mécanique, environnement, énergétique, procédés, production;IMEP2;9;Sciences et technologies de l'information et de la communication;2019;2018-19;2018;2018;0;0;0;0;0;0;2;0;2;;;;;Ce7NF
512;École doctorale Informatique et mathématiques;InfoMaths;8;Sciences pour l'ingénieur;2019;2018-19;2018;2018;3;1;2;8;1;7;0;0;0;;;;;t86bi
522;École doctorale Sciences et ingénierie en matériaux, mécanique, énergétique et aéronautique;SI-MMEA;4;Chimie;2019;2018-19;2018;2018;0;0;0;0;0;0;7;3;4;;;;;82F19
522;École doctorale Sciences et ingénierie en matériaux, mécanique, énergétique et aéronautique;SI-MMEA;8;Sciences pour l'ingénieur;2019;2018-19;2018;2018;0;0;0;0;0;0;46;7;39;;;;;82F19
523;École doctorale Sciences pour l'environnement - Gay Lussac;;4;Chimie;2019;2018-19;2018;2018;0;0;0;0;0;0;17;6;11;;;;;6xD69
524;École doctorale Biologie - santé;;5;Biologie, médecine et santé;2019;2018-19;2018;2018;0;0;0;0;0;0;46;26;20;;;;;S7Kk6
525;"École doctorale Lettres, pensée, arts et histoire, ""Civilisation de l'antiquité à nos jours""";LPAH;6;Sciences humaines et humanités;2019;2018-19;2018;2018;0;0;0;0;0;0;26;18;8;;;;;19Rpr
526;École doctorale Sociétés et organisations;SORG;6;Sciences humaines et humanités;2019;2018-19;2018;2018;0;0;0;0;0;0;5;2;3;;;;;5F3Fd
528;École doctorale Ville, transports et territoires;VTT;7;Sciences de la société;2019;2018-19;2018;2018;15;9;6;26;13;13;3;1;2;;;;;68zCc
530;École doctorale Organisations, marchés, institutions;OMI;7;Sciences de la société;2019;2018-19;2018;2018;10;6;4;94;52;42;15;5;10;;;;;4htv7
532;École doctorale Mathématiques et sciences et technologies de l'information et de la communication;MSTIC;1;Mathématiques et leurs interactions;2019;2018-19;2018;2018;25;7;18;72;14;58;22;7;15;;;;;t43KM
536;École doctorale Sciences et agrosciences;;4;Chimie;2019;2018-19;2018;2018;7;3;4;19;11;8;7;5;2;;;;;pHfqe
537;École doctorale Culture et patrimoine;C&P;6;Sciences humaines et humanités;2019;2018-19;2018;2018;9;6;3;15;8;7;13;10;3;;;;;GxI4a
540;"École doctorale École transdisciplinaire ""lettres/sciences""";;1;Mathématiques et leurs interactions;2019;2018-19;2018;2018;1;0;1;1;0;1;0;0;0;;;;;tWWw7
542;École doctorale de sciences de La Réunion;STS;8;Sciences pour l'ingénieur;2019;2018-19;2018;2018;3;1;2;3;1;2;0;0;0;;;;;2pAql
545;École doctorale Sociétés, politique et santé publique;SP2;5;Biologie, médecine et santé;2019;2018-19;2018;2018;27;15;12;81;40;41;13;9;4;;;;;IAKR4
546;École doctorale Abbé Grégoire;;6;Sciences humaines et humanités;2019;2018-19;2018;2018;34;18;16;134;75;59;20;14;6;;;;;ZSn7q
546;École doctorale Abbé Grégoire;;9;Sciences et technologies de l'information et de la communication;2019;2018-19;2018;2018;4;3;1;7;5;2;0;0;0;;;;;ZSn7q
548;École doctorale Mer et Sciences;;3;Sciences de la terre et de l'univers, espace;2019;2018-19;2018;2018;2;1;1;7;3;4;1;1;0;;;;;QX0fS
548;École doctorale Mer et Sciences;;4;Chimie;2019;2018-19;2018;2018;4;1;3;18;8;10;5;1;4;;;;;QX0fS
552;École doctorale Énergie - Matériaux - Sciences de la Terre et de l'Univers;EMTSU;1;Mathématiques et leurs interactions;2019;2018-19;2018;2018;0;0;0;0;0;0;1;0;1;;;;;NTZhw
552;École doctorale Énergie - Matériaux - Sciences de la Terre et de l'Univers;EMTSU;3;Sciences de la terre et de l'univers, espace;2019;2018-19;2018;2018;14;5;9;48;21;27;16;4;12;;;;;NTZhw
552;École doctorale Énergie - Matériaux - Sciences de la Terre et de l'Univers;EMTSU;4;Chimie;2019;2018-19;2018;2018;11;6;5;50;24;26;13;5;8;;;;;NTZhw
552;École doctorale Énergie - Matériaux - Sciences de la Terre et de l'Univers;EMTSU;8;Sciences pour l'ingénieur;2019;2018-19;2018;2018;23;6;17;90;22;68;31;6;25;;;;;NTZhw
554;École doctorale Environnements - Santé;E-S;10;Sciences agronomiques et écologiques;2019;2018-19;2018;2018;38;19;19;145;75;70;34;25;9;;;;;ElyFU
555;École doctorale Sciences de l'Homme et de la Société;SHS;6;Sciences humaines et humanités;2019;2018-19;2018;2018;17;8;9;102;56;46;11;6;5;;;;;44G6m
556;École doctorale Homme, Sociétés, Risques, Territoire;HSRT;7;Sciences de la société;2019;2018-19;2018;2018;9;2;7;55;24;31;12;5;7;;;;;5QEaX
559;École doctorale Management Panthéon-Sorbonne;;7;Sciences de la société;2019;2018-19;2018;2018;42;17;25;153;81;72;29;13;16;;;;;4SP7k
565;École doctorale Droit de la Sorbonne;DS;7;Sciences de la société;2019;2018-19;2018;2018;116;63;53;576;289;287;77;36;41;;;;;aXJ7L
566;École doctorale Sciences du Sport, de la Motricité et du Mouvement Humain;SMMH;5;Biologie, médecine et santé;2019;2018-19;2018;2018;19;6;13;74;33;41;6;1;5;;;;;3iv8y
566;École doctorale Sciences du Sport, de la Motricité et du Mouvement Humain;SMMH;6;Sciences humaines et humanités;2019;2018-19;2018;2018;7;4;3;42;18;24;8;3;5;;;;;3iv8y
568;École doctorale Signalisations et Réseaux Intégratifs en Biologie;BIOSIGNE;5;Biologie, médecine et santé;2019;2018-19;2018;2018;22;15;7;108;69;39;38;24;14;;;;;CGttG
569;École doctorale Innovation thérapeutique : du fondamental à l'appliqué;;4;Chimie;2019;2018-19;2018;2018;7;1;6;34;15;19;10;5;5;;;;;jx8ET
569;École doctorale Innovation thérapeutique : du fondamental à l'appliqué;;5;Biologie, médecine et santé;2019;2018-19;2018;2018;55;38;17;259;152;107;63;33;30;;;;;jx8ET
570;École doctorale Santé Publique;EDSP;7;Sciences de la société;2019;2018-19;2018;2018;2;1;1;6;4;2;2;2;0;;;;;9lgE4
571;École doctorale Sciences Chimiques : Molécules, Matériaux, Instrumentation et Biosystemes;2MIB;2;Physique;2019;2018-19;2018;2018;6;3;3;14;7;7;1;1;0;;;;;zbi37
573;École doctorale Interfaces : Approches Interdisciplinaires, Fondements, Applications et Innovation;ED INTERFACES;1;Mathématiques et leurs interactions;2019;2018-19;2018;2018;3;1;2;20;3;17;9;0;9;;;;;gG820
573;École doctorale Interfaces : Approches Interdisciplinaires, Fondements, Applications et Innovation;ED INTERFACES;2;Physique;2019;2018-19;2018;2018;26;7;19;90;26;64;22;10;12;;;;;gG820
573;École doctorale Interfaces : Approches Interdisciplinaires, Fondements, Applications et Innovation;ED INTERFACES;9;Sciences et technologies de l'information et de la communication;2019;2018-19;2018;2018;7;1;6;36;7;29;6;2;4;;;;;gG820
575;École doctorale Electrical, Optical, Bio : Physics and Engineering;EOBE;8;Sciences pour l'ingénieur;2019;2018-19;2018;2018;31;7;24;150;41;109;38;14;24;;;;;dfhyn
577;École doctorale Structure et dynamique des systèmes vivants;SDSV;1;Mathématiques et leurs interactions;2019;2018-19;2018;2018;0;0;0;2;1;1;0;0;0;;;;;4bsxJ
579;École doctorale Sciences mécaniques et energétiques, matériaux et géosciences;SMEMaG;5;Biologie, médecine et santé;2019;2018-19;2018;2018;2;1;1;9;6;3;0;0;0;;;;;atMj7
580;École doctorale Sciences et technologies de l'information et de la communication;STIC;1;Mathématiques et leurs interactions;2019;2018-19;2018;2018;6;4;2;15;6;9;3;1;2;;;;;AzCC0
580;École doctorale Sciences et technologies de l'information et de la communication;STIC;9;Sciences et technologies de l'information et de la communication;2019;2018-19;2018;2018;180;49;131;770;199;571;154;37;117;;;;;AzCC0
581;École doctorale Agriculture, alimentation, biologie, environnement, santé;ABIES;1;Mathématiques et leurs interactions;2019;2018-19;2018;2018;1;1;0;8;4;4;1;0;1;;;;;c1x56
581;École doctorale Agriculture, alimentation, biologie, environnement, santé;ABIES;9;Sciences et technologies de l'information et de la communication;2019;2018-19;2018;2018;0;0;0;2;0;2;1;0;1;;;;;c1x56
583;École doctorale Risques et Société;;1;Mathématiques et leurs interactions;2019;2018-19;2018;2018;0;0;0;1;0;1;0;0;0;;;;;wUBi9
583;École doctorale Risques et Société;;9;Sciences et technologies de l'information et de la communication;2019;2018-19;2018;2018;2;1;1;7;4;3;0;0;0;;;;;wUBi9
583;École doctorale Risques et Société;;10;Sciences agronomiques et écologiques;2019;2018-19;2018;2018;0;0;0;1;0;1;0;0;0;;;;;wUBi9
585;École doctorale Sciences, Technologie,  Sante;EDSTS;5;Biologie, médecine et santé;2019;2018-19;2018;2018;24;11;13;91;41;50;19;11;8;;;;;NM3Dl
586;École doctorale Sciences Humaines et Sociales;EDSHS;6;Sciences humaines et humanités;2019;2018-19;2018;2018;50;27;23;200;110;90;19;8;11;;;;;0RKVX
587;École doctorale Diversites, santé et développement en Amazonie;;3;Sciences de la terre et de l'univers, espace;2019;2018-19;2018;2018;0;0;0;0;0;0;1;0;1;;;;;V14tj
589;École doctorale Milieu insulaire tropical à risques : protection, valorisation , santé et développement;;2;Physique;2019;2018-19;2018;2018;4;1;3;10;1;9;2;1;1;;;;;2cqi3
590;École doctorale Mathematiques, Information, Ingenierie des Systemes;MIIS;1;Mathématiques et leurs interactions;2019;2018-19;2018;2018;13;4;9;55;18;37;20;11;9;;;;;L20t5
590;École doctorale Mathematiques, Information, Ingenierie des Systemes;MIIS;2;Physique;2019;2018-19;2018;2018;0;0;0;0;0;0;1;0;1;;;;;L20t5
596;École doctorale Matière, Molécules et Matériaux;ED 3M;8;Sciences pour l'ingénieur;2019;2018-19;2018;2018;0;0;0;3;0;3;2;0;2;;;;;77947
597;École doctorale Sciences économiques et sciences de Gestion;EDGE;7;Sciences de la société;2019;2018-19;2018;2018;41;16;25;239;99;140;45;16;29;;;;;d8Zuu
599;École doctorale Droit et Science Politique;DSP;7;Sciences de la société;2019;2018-19;2018;2018;69;34;35;397;176;221;29;8;21;;;;;6rwtT
600;École doctorale Écologie, Géosciences, Agronomie et Alimentation;EGAAL;1;Mathématiques et leurs interactions;2019;2018-19;2018;2018;0;0;0;1;0;1;0;0;0;;;;;urS33
600;École doctorale Écologie, Géosciences, Agronomie et Alimentation;EGAAL;3;Sciences de la terre et de l'univers, espace;2019;2018-19;2018;2018;13;5;8;61;30;31;20;8;12;;;;;urS33
600;École doctorale Écologie, Géosciences, Agronomie et Alimentation;EGAAL;8;Sciences pour l'ingénieur;2019;2018-19;2018;2018;1;1;0;2;2;0;0;0;0;;;;;urS33
601;École doctorale Mathématiques et Sciences et Technologies de l'information et de la Communication;MathSTIC;8;Sciences pour l'ingénieur;2019;2018-19;2018;2018;3;0;3;27;7;20;1;0;1;;;;;3Ue20
601;École doctorale Mathématiques et Sciences et Technologies de l'information et de la Communication;MathSTIC;9;Sciences et technologies de l'information et de la communication;2019;2018-19;2018;2018;220;49;171;872;209;663;228;48;180;;;;;3Ue20
605;École doctorale Biologie Santé;ED BS;5;Biologie, médecine et santé;2019;2018-19;2018;2018;147;89;58;534;293;241;134;71;63;;;;;w8CxU
607;École doctorale Sciences et Ingénierie des Ressources Naturelles;SIReNA;4;Chimie;2019;2018-19;2018;2018;0;0;0;0;0;0;1;0;1;;;;;vi9w2
607;École doctorale Sciences et Ingénierie des Ressources Naturelles;SIReNA;8;Sciences pour l'ingénieur;2019;2018-19;2018;2018;3;2;1;17;5;12;14;6;8;;;;;vi9w2
607;École doctorale Sciences et Ingénierie des Ressources Naturelles;SIReNA;10;Sciences agronomiques et écologiques;2019;2018-19;2018;2018;30;17;13;108;58;50;5;3;2;;;;;vi9w2
612;École doctorale Humanités;;6;Sciences humaines et humanités;2019;2018-19;2018;2018;37;20;17;233;139;94;0;0;0;;;;;v30I8
614;École doctorale Chimie, Écologie, Géosciences, Agrosciences - Théodore Monod;CEGA;4;Chimie;2019;2018-19;2018;2018;16;6;10;67;30;37;0;0;0;;;;;uc10I
614;École doctorale Chimie, Écologie, Géosciences, Agrosciences - Théodore Monod;CEGA;8;Sciences pour l'ingénieur;2019;2018-19;2018;2018;0;0;0;1;1;0;0;0;0;;;;;uc10I
618;École doctorale EUCLIDE;;7;Sciences de la société;2019;2018-19;2018;2018;8;5;3;38;23;15;0;0;0;;;;;qveTN
618;École doctorale EUCLIDE;;9;Sciences et technologies de l'information et de la communication;2019;2018-19;2018;2018;9;3;6;35;10;25;6;1;5;;;;;qveTN
621;École doctorale Ingénierie des Systèmes, Matériaux, Mécanique, Énergétique;ISMME;6;Sciences humaines et humanités;2019;2018-19;2018;2018;0;0;0;1;1;0;0;0;0;;;;;B2549
621;École doctorale Ingénierie des Systèmes, Matériaux, Mécanique, Énergétique;ISMME;8;Sciences pour l'ingénieur;2019;2018-19;2018;2018;57;16;41;187;36;151;0;0;0;;;;;B2549
621;École doctorale Ingénierie des Systèmes, Matériaux, Mécanique, Énergétique;ISMME;9;Sciences et technologies de l'information et de la communication;2019;2018-19;2018;2018;0;0;0;4;2;2;0;0;0;;;;;B2549
6;École doctorale Droit privé;;7;Sciences de la société;2018;2017-18;2017;2017;63;31;32;304;148;156;28;14;14;;;;;UMnW1
7;École doctorale Georges Vedel - Droit public interne, science administrative et science politique;;7;Sciences de la société;2018;2017-18;2017;2017;33;18;15;192;74;118;17;8;9;;;;;Dw881
20;École doctorale Civilisations, cultures, littératures et sociétés;;6;Sciences humaines et humanités;2018;2017-18;2017;2017;40;24;16;200;115;85;38;30;8;;;;;agjNi
34;École doctorale Matériaux;;4;Chimie;2018;2017-18;2017;2017;3;1;2;31;13;18;8;1;7;;;;;1Iufh
34;École doctorale Matériaux;;8;Sciences pour l'ingénieur;2018;2017-18;2017;2017;25;10;15;100;40;60;11;7;4;;;;;1Iufh
47;École doctorale Physique;;4;Chimie;2018;2017-18;2017;2017;0;0;0;2;0;2;1;0;1;;;;;8kNpd
50;École doctorale Langues, littératures et sciences humaines;LLSH;9;Sciences et technologies de l'information et de la communication;2018;2017-18;2017;2017;18;8;10;59;33;26;8;6;2;;;;;8THzQ
60;École doctorale Territoires, temps, sociétés et développement;TTSD;10;Sciences agronomiques et écologiques;2018;2017-18;2017;2017;0;0;0;0;0;0;2;2;0;;;;;fkIh6
62;École doctorale Sciences de la vie et de la santé;;1;Mathématiques et leurs interactions;2018;2017-18;2017;2017;0;0;0;1;0;1;0;0;0;;;;;vZzE7
65;École doctorale Sciences de la Vie, Santé, Agronomie, Environnement;;10;Sciences agronomiques et écologiques;2018;2017-18;2017;2017;0;0;0;98;37;61;26;16;10;;;;;MAOG4
67;École doctorale Sciences juridiques et politiques;;7;Sciences de la société;2018;2017-18;2017;2017;108;52;56;524;253;271;81;49;32;;;;;qrOj1
70;École doctorale Sciences pour l'ingénieur;EDSPI;9;Sciences et technologies de l'information et de la communication;2018;2017-18;2017;2017;0;0;0;89;23;66;20;7;13;;;;;G413P
71;École doctorale Sciences pour l'ingénieur;;7;Sciences de la société;2018;2017-18;2017;2017;4;1;3;27;13;14;2;1;1;;;;;H6UYp
71;École doctorale Sciences pour l'ingénieur;;8;Sciences pour l'ingénieur;2018;2017-18;2017;2017;51;21;30;187;76;111;60;22;38;;;;;H6UYp
72;École doctorale Sciences pour l'ingénieur;SPI;9;Sciences et technologies de l'information et de la communication;2018;2017-18;2017;2017;123;26;97;396;113;283;104;28;76;;;;;47QPx
77;École doctorale Informatique, automatique, électronique, électrotechnique, mathématiques;IAEM;6;Sciences humaines et humanités;2018;2017-18;2017;2017;0;0;0;4;3;1;2;0;2;;;;;TCHTA
86;École doctorale Sociétés, humanités, arts, lettres;LSHS;6;Sciences humaines et humanités;2018;2017-18;2017;2017;65;39;26;240;146;94;40;23;17;;;;;O8E6y
92;École doctorale Vie -  Agro - Santé;;6;Sciences humaines et humanités;2018;2017-18;2017;2017;0;0;0;0;0;0;1;0;1;;;;;RjvXY
98;École doctorale Droit-Normandie;EDDN;7;Sciences de la société;2018;2017-18;2017;2017;25;11;14;147;77;70;17;7;10;;;;;9fYyW
104;École doctorale Sciences de la matière, du rayonnement et de l'environnement;SMRE;6;Sciences humaines et humanités;2018;2017-18;2017;2017;0;0;0;3;2;1;1;0;1;;;;;Q5iFz
105;École doctorale Terre, univers, environnement;;3;Sciences de la terre et de l'univers, espace;2018;2017-18;2017;2017;40;15;25;164;71;93;41;15;26;;;;;lcWAf
113;École doctorale Histoire;;6;Sciences humaines et humanités;2018;2017-18;2017;2017;39;20;19;289;150;139;43;19;24;;;;;G5wHs
119;École doctorale Science politique;;7;Sciences de la société;2018;2017-18;2017;2017;16;10;6;92;45;47;12;6;6;;;;;eyibb
122;École doctorale Europe latine - Amérique latine;;6;Sciences humaines et humanités;2018;2017-18;2017;2017;13;11;2;111;76;35;22;14;8;;;;;z9lZY
129;École doctorale Sciences de l'environnement d'Ile de France;SEIF;3;Sciences de la terre et de l'univers, espace;2018;2017-18;2017;2017;45;16;29;178;91;87;35;17;18;;;;;TnAPh
138;École doctorale Lettres, langues, spectacles;LLS;6;Sciences humaines et humanités;2018;2017-18;2017;2017;52;36;16;319;208;111;40;26;14;;;;;y9O3k
139;École doctorale Connaissance, langage, modélisation;CLM;1;Mathématiques et leurs interactions;2018;2017-18;2017;2017;3;0;3;7;1;6;3;0;3;;;;;1lxGH
146;École doctorale Galilée;GALILEE;8;Sciences pour l'ingénieur;2018;2017-18;2017;2017;4;1;3;9;3;6;9;4;5;;;;;71hqm
146;École doctorale Galilée;GALILEE;9;Sciences et technologies de l'information et de la communication;2018;2017-18;2017;2017;21;11;10;51;19;32;11;4;7;;;;;71hqm
156;École doctorale Sciences de la mer;;3;Sciences de la terre et de l'univers, espace;2018;2017-18;2017;2017;0;0;0;0;0;0;5;2;3;;;;;EGY9P
160;École doctorale Électronique, électrotechnique, automatique;EEA;8;Sciences pour l'ingénieur;2018;2017-18;2017;2017;17;5;12;89;25;64;23;6;17;;;;;EgfMQ
160;École doctorale Électronique, électrotechnique, automatique;EEA;9;Sciences et technologies de l'information et de la communication;2018;2017-18;2017;2017;24;6;18;91;22;69;21;8;13;;;;;EgfMQ
162;École doctorale Mécanique, énergétique, génie civil, acoustique;MEGA;1;Mathématiques et leurs interactions;2018;2017-18;2017;2017;0;0;0;1;1;0;0;0;0;;;;;7wCke
166;École doctorale Information, structures et systèmes;I2S;1;Mathématiques et leurs interactions;2018;2017-18;2017;2017;19;3;16;58;14;44;13;6;7;;;;;2uO68
166;École doctorale Information, structures et systèmes;I2S;3;Sciences de la terre et de l'univers, espace;2018;2017-18;2017;2017;1;0;1;4;2;2;0;0;0;;;;;2uO68
166;École doctorale Information, structures et systèmes;I2S;4;Chimie;2018;2017-18;2017;2017;1;1;0;4;4;0;2;1;1;;;;;2uO68
166;École doctorale Information, structures et systèmes;I2S;7;Sciences de la société;2018;2017-18;2017;2017;0;0;0;2;0;2;0;0;0;;;;;2uO68
178;École doctorale Sciences fondamentales;;1;Mathématiques et leurs interactions;2018;2017-18;2017;2017;5;1;4;19;4;15;5;1;4;;;;;1AiR7
178;École doctorale Sciences fondamentales;;4;Chimie;2018;2017-18;2017;2017;17;9;8;54;26;28;17;10;7;;;;;1AiR7
205;École doctorale Interdisciplinaire Sciences-Santé;EDISS;7;Sciences de la société;2018;2017-18;2017;2017;1;1;0;1;1;0;2;0;2;;;;;69W38
209;École doctorale Sciences physiques et de L'ingénieur;SPI;2;Physique;2018;2017-18;2017;2017;28;3;25;109;20;89;26;9;17;;;;;tZcIZ
209;École doctorale Sciences physiques et de L'ingénieur;SPI;9;Sciences et technologies de l'information et de la communication;2018;2017-18;2017;2017;36;7;29;147;30;117;29;8;21;;;;;tZcIZ
211;École doctorale Sciences exactes et leurs applications;ED SEA;4;Chimie;2018;2017-18;2017;2017;22;9;13;71;30;41;13;5;8;;;;;1G1iC
217;École doctorale Mathématiques, sciences et technologies de l'information, informatique;MSTII;9;Sciences et technologies de l'information et de la communication;2018;2017-18;2017;2017;58;10;48;287;67;220;79;18;61;;;;;Ehx7v
220;École doctorale Électronique, électrotechnique, automatique, traitement du signal;EEATS;8;Sciences pour l'ingénieur;2018;2017-18;2017;2017;53;13;40;227;55;172;36;6;30;;;;;IxEaw
227;École doctorale Sciences de la nature et de l'homme;;9;Sciences et technologies de l'information et de la communication;2018;2017-18;2017;2017;0;0;0;2;1;1;0;0;0;;;;;xiDA5
231;École doctorale Économie et gestion;EDEG;7;Sciences de la société;2018;2017-18;2017;2017;41;28;13;185;91;94;32;20;12;;;;;KT720
240;École doctorale Sciences de l'homme et de la société;SHS;6;Sciences humaines et humanités;2018;2017-18;2017;2017;68;38;30;293;159;134;37;21;16;;;;;j345k
251;École doctorale Sciences de l'environnement;;5;Biologie, médecine et santé;2018;2017-18;2017;2017;0;0;0;1;1;0;3;2;1;;;;;VR28y
251;École doctorale Sciences de l'environnement;;10;Sciences agronomiques et écologiques;2018;2017-18;2017;2017;7;5;2;35;21;14;14;9;5;;;;;VR28y
266;École doctorale Biologie, santé, environnement;BIOSE;4;Chimie;2018;2017-18;2017;2017;0;0;0;1;1;0;0;0;0;;;;;386V9
269;École doctorale Mathématiques, sciences de l'information et de l'ingénieur;MSII;5;Biologie, médecine et santé;2018;2017-18;2017;2017;2;0;2;13;6;7;0;0;0;;;;;5E625
280;École doctorale Philosophie;;6;Sciences humaines et humanités;2018;2017-18;2017;2017;49;23;26;249;98;151;34;14;20;;;;;kJxnm
284;École doctorale Droit et Science Politique;DSP;6;Sciences humaines et humanités;2018;2017-18;2017;2017;58;30;28;235;123;112;16;12;4;;;;;ahH92
284;École doctorale Droit et Science Politique;DSP;7;Sciences de la société;2018;2017-18;2017;2017;0;0;0;4;2;2;1;0;1;;;;;ahH92
300;École doctorale Sciences Économiques;ED SE;6;Sciences humaines et humanités;2018;2017-18;2017;2017;3;1;2;3;1;2;0;0;0;;;;;5x3fM
300;École doctorale Sciences Économiques;ED SE;7;Sciences de la société;2018;2017-18;2017;2017;4;2;2;41;14;27;13;4;9;;;;;5x3fM
305;École doctorale Énergie et environnement;E2;2;Physique;2018;2017-18;2017;2017;2;0;2;11;2;9;8;2;6;;;;;Kbt8I
305;École doctorale Énergie et environnement;E2;4;Chimie;2018;2017-18;2017;2017;5;2;3;17;10;7;3;3;0;;;;;Kbt8I
323;École doctorale Génie électrique, électronique et télécommunications;GEET;9;Sciences et technologies de l'information et de la communication;2018;2017-18;2017;2017;10;2;8;42;6;36;15;4;11;;;;;arcz6
327;École doctorale Temps, espaces, sociétés, cultures;TESC;1;Mathématiques et leurs interactions;2018;2017-18;2017;2017;0;0;0;1;0;1;0;0;0;;;;;IjgiJ
327;École doctorale Temps, espaces, sociétés, cultures;TESC;6;Sciences humaines et humanités;2018;2017-18;2017;2017;59;33;26;259;142;117;33;18;15;;;;;IjgiJ
327;École doctorale Temps, espaces, sociétés, cultures;TESC;8;Sciences pour l'ingénieur;2018;2017-18;2017;2017;3;2;1;4;3;1;0;0;0;;;;;IjgiJ
340;École doctorale Biologie moléculaire, intégrative et cellulaire;BMIC;5;Biologie, médecine et santé;2018;2017-18;2017;2017;65;38;27;290;179;111;69;47;22;;;;;db7xq
341;École doctorale Évolution, écosystèmes, microbiologie, modélisation;E2M2;5;Biologie, médecine et santé;2018;2017-18;2017;2017;24;14;10;108;52;56;26;12;14;;;;;J83I0
353;École doctorale Sciences pour l'ingénieur : mécanique, physique, micro et nanoélectronique;;2;Physique;2018;2017-18;2017;2017;2;0;2;7;0;7;7;3;4;;;;;vk5Kp
354;École doctorale Langues, lettres et arts;LLA;6;Sciences humaines et humanités;2018;2017-18;2017;2017;52;28;24;248;156;92;37;21;16;;;;;RwcSv
355;École doctorale Espaces, cultures, sociétés;;7;Sciences de la société;2018;2017-18;2017;2017;5;5;0;33;22;11;8;5;3;;;;;2kMf5
356;École doctorale Cognition, langage, éducation;;6;Sciences humaines et humanités;2018;2017-18;2017;2017;57;33;24;264;140;124;41;30;11;;;;;55Cpz
356;École doctorale Cognition, langage, éducation;;9;Sciences et technologies de l'information et de la communication;2018;2017-18;2017;2017;8;5;3;32;19;13;7;2;5;;;;;55Cpz
364;École doctorale Sciences fondamentales et appliquées;EDSFA;4;Chimie;2018;2017-18;2017;2017;12;5;7;41;27;14;8;4;4;;;;;E483q
373;École doctorale Santé, information/communications et mathématiques, matière;SICMA;4;Chimie;2018;2017-18;2017;2017;0;0;0;0;0;0;2;1;1;;;;;hTJF5
373;École doctorale Santé, information/communications et mathématiques, matière;SICMA;8;Sciences pour l'ingénieur;2018;2017-18;2017;2017;0;0;0;0;0;0;8;1;7;;;;;hTJF5
373;École doctorale Santé, information/communications et mathématiques, matière;SICMA;9;Sciences et technologies de l'information et de la communication;2018;2017-18;2017;2017;0;0;0;0;0;0;29;7;22;;;;;hTJF5
377;École doctorale Environnement et société;;4;Chimie;2018;2017-18;2017;2017;0;0;0;4;3;1;6;4;2;;;;;ZMG5u
377;École doctorale Environnement et société;;7;Sciences de la société;2018;2017-18;2017;2017;8;7;1;42;27;15;2;1;1;;;;;ZMG5u
382;École doctorale Économie, espaces, sociétés, civilisations : pensée critique, politique et pratique sociale;EESC;6;Sciences humaines et humanités;2018;2017-18;2017;2017;22;10;12;143;83;60;19;12;7;;;;;9NI1W
393;École doctorale Pierre Louis de Santé Publique : Épidémiologie et Sciences de l'information biomédicale;PLSP;5;Biologie, médecine et santé;2018;2017-18;2017;2017;64;32;32;199;99;100;40;21;19;;;;;69445
394;École doctorale Physiologie et physiopathologie;p2t;5;Biologie, médecine et santé;2018;2017-18;2017;2017;54;29;25;242;145;97;58;33;25;;;;;VMYmT
395;École doctorale Milieux, cultures et sociétés du passé et du présent;MCSPP;6;Sciences humaines et humanités;2018;2017-18;2017;2017;56;36;20;319;214;105;43;29;14;;;;;2quEb
396;École doctorale Économie, organisations, société;EOS;7;Sciences de la société;2018;2017-18;2017;2017;46;18;28;196;84;112;39;18;21;;;;;Es5e7
396;École doctorale Économie, organisations, société;EOS;8;Sciences pour l'ingénieur;2018;2017-18;2017;2017;1;0;1;2;1;1;1;1;0;;;;;Es5e7
398;École doctorale Géosciences, ressources naturelles et environnement;GRNE;3;Sciences de la terre et de l'univers, espace;2018;2017-18;2017;2017;32;20;12;134;63;71;42;18;24;;;;;Zi4Zf
400;École doctorale Savoirs scientifiques : épistémologie, histoire des sciences, didactique des disciplines;;1;Mathématiques et leurs interactions;2018;2017-18;2017;2017;6;4;2;24;11;13;6;4;2;;;;;nRax3
400;École doctorale Savoirs scientifiques : épistémologie, histoire des sciences, didactique des disciplines;;2;Physique;2018;2017-18;2017;2017;4;0;4;14;5;9;4;1;3;;;;;nRax3
400;École doctorale Savoirs scientifiques : épistémologie, histoire des sciences, didactique des disciplines;;6;Sciences humaines et humanités;2018;2017-18;2017;2017;1;1;0;1;1;0;0;0;0;;;;;nRax3
405;École doctorale Économie, management,mathématiques et physique de Cergy;EM2C;1;Mathématiques et leurs interactions;2018;2017-18;2017;2017;6;2;4;21;6;15;6;1;5;;;;;QbwSB
409;École doctorale Énergie, mécanique, matériaux;EMMA;8;Sciences pour l'ingénieur;2018;2017-18;2017;2017;42;11;31;127;27;100;31;11;20;;;;;KXlbK
410;École doctorale Sciences et ingénierie des ressources, procédés, produits, environnement;RP2E;3;Sciences de la terre et de l'univers, espace;2018;2017-18;2017;2017;21;7;14;67;28;39;25;10;15;;;;;Q5fxV
414;École doctorale Sciences de la vie et de la santé;;4;Chimie;2018;2017-18;2017;2017;0;0;0;6;4;2;1;1;0;;;;;YI4xS
414;École doctorale Sciences de la vie et de la santé;;6;Sciences humaines et humanités;2018;2017-18;2017;2017;0;0;0;3;1;2;0;0;0;;;;;YI4xS
414;École doctorale Sciences de la vie et de la santé;;7;Sciences de la société;2018;2017-18;2017;2017;1;1;0;2;2;0;2;0;2;;;;;YI4xS
417;École doctorale Sciences et Ingénierie;S&I;4;Chimie;2018;2017-18;2017;2017;6;2;4;22;8;14;7;3;4;;;;;SSBvE
417;École doctorale Sciences et Ingénierie;S&I;8;Sciences pour l'ingénieur;2018;2017-18;2017;2017;17;7;10;49;18;31;11;2;9;;;;;SSBvE
417;École doctorale Sciences et Ingénierie;S&I;9;Sciences et technologies de l'information et de la communication;2018;2017-18;2017;2017;8;4;4;41;16;25;11;3;8;;;;;SSBvE
446;École doctorale Biologie - Santé;EDBSL;1;Mathématiques et leurs interactions;2018;2017-18;2017;2017;0;0;0;1;1;0;0;0;0;;;;;4iEUF
446;École doctorale Biologie - Santé;EDBSL;5;Biologie, médecine et santé;2018;2017-18;2017;2017;71;39;32;319;175;144;60;33;27;;;;;4iEUF
459;École doctorale Sciences chimiques Balard;;4;Chimie;2018;2017-18;2017;2017;71;39;32;237;101;136;68;33;35;;;;;YFs2W
460;École doctorale Sciences juridiques;SJ;7;Sciences de la société;2018;2017-18;2017;2017;9;4;5;118;59;59;15;5;10;;;;;ZB5I5
467;École doctorale Aéronautique, astronautique;AA;3;Sciences de la terre et de l'univers, espace;2018;2017-18;2017;2017;3;2;1;6;2;4;0;0;0;;;;;U7l45
467;École doctorale Aéronautique, astronautique;AA;9;Sciences et technologies de l'information et de la communication;2018;2017-18;2017;2017;1;1;0;4;3;1;1;0;1;;;;;U7l45
469;École doctorale du Pacifique;EDP;1;Mathématiques et leurs interactions;2018;2017-18;2017;2017;0;0;0;2;0;2;0;0;0;;;;;t9Z2n
469;École doctorale du Pacifique;EDP;3;Sciences de la terre et de l'univers, espace;2018;2017-18;2017;2017;0;0;0;5;2;3;1;1;0;;;;;t9Z2n
473;École doctorale Sciences de l'homme et de la société;SHS;6;Sciences humaines et humanités;2018;2017-18;2017;2017;149;89;60;638;362;276;62;37;25;;;;;8qKD9
474;École doctorale Interdisciplinaire européenne frontières du vivant;FDV;3;Sciences de la terre et de l'univers, espace;2018;2017-18;2017;2017;0;0;0;2;1;1;0;0;0;;;;;E727j
474;École doctorale Interdisciplinaire européenne frontières du vivant;FDV;4;Chimie;2018;2017-18;2017;2017;1;0;1;6;3;3;0;0;0;;;;;E727j
474;École doctorale Interdisciplinaire européenne frontières du vivant;FDV;6;Sciences humaines et humanités;2018;2017-18;2017;2017;3;2;1;10;5;5;3;1;2;;;;;E727j
474;École doctorale Interdisciplinaire européenne frontières du vivant;FDV;7;Sciences de la société;2018;2017-18;2017;2017;1;1;0;5;4;1;0;0;0;;;;;E727j
474;École doctorale Interdisciplinaire européenne frontières du vivant;FDV;9;Sciences et technologies de l'information et de la communication;2018;2017-18;2017;2017;1;0;1;2;0;2;1;0;1;;;;;E727j
479;École doctorale Sciences juridiques et politiques;;7;Sciences de la société;2018;2017-18;2017;2017;70;34;36;357;180;177;48;18;30;;;;;34mid
481;École doctorale Sciences sociales et humanités;SSH;6;Sciences humaines et humanités;2018;2017-18;2017;2017;28;15;13;134;77;57;15;9;6;;;;;E3z5j
483;École doctorale Histoire, géographie, aménagement, urbanisme, archéologie, science politique, sociologie, anthropologie;SCSO;6;Sciences humaines et humanités;2018;2017-18;2017;2017;63;36;27;410;199;211;61;28;33;;;;;hc6u4
483;École doctorale Histoire, géographie, aménagement, urbanisme, archéologie, science politique, sociologie, anthropologie;SCSO;7;Sciences de la société;2018;2017-18;2017;2017;35;20;15;249;142;107;25;14;11;;;;;hc6u4
489;École doctorale Sciences et ingénierie des systèmes, de l'environnement et des organisations;SISEO;4;Chimie;2018;2017-18;2017;2017;4;3;1;10;5;5;3;3;0;;;;;6pT77
489;École doctorale Sciences et ingénierie des systèmes, de l'environnement et des organisations;SISEO;7;Sciences de la société;2018;2017-18;2017;2017;5;4;1;24;13;11;8;5;3;;;;;6pT77
492;École doctorale Droit;;7;Sciences de la société;2018;2017-18;2017;2017;61;29;32;309;152;157;38;12;26;;;;;kOQsX
497;École doctorale Normande de Biologie Intégrative, Santé, Environnement;Ed NBISE;5;Biologie, médecine et santé;2018;2017-18;2017;2017;60;38;22;263;149;114;54;24;30;;;;;0D9Je
501;École doctorale Droit, économie-gestion, sociétés, territoires;;6;Sciences humaines et humanités;2018;2017-18;2017;2017;0;0;0;0;0;0;5;2;3;;;;;wE7WM
501;École doctorale Droit, économie-gestion, sociétés, territoires;;7;Sciences de la société;2018;2017-18;2017;2017;0;0;0;0;0;0;11;5;6;;;;;wE7WM
503;École doctorale Sciences et technologies de l'information et de mathématiques;STIM;8;Sciences pour l'ingénieur;2018;2017-18;2017;2017;0;0;0;0;0;0;1;0;1;;;;;JQevP
505;École doctorale Sciences de l'homme, des organisations et de la société;SHOS;7;Sciences de la société;2018;2017-18;2017;2017;0;0;0;0;0;0;17;8;9;;;;;qts78
514;École doctorale Études anglophones, germanophones et européennes;EDEAGE;6;Sciences humaines et humanités;2018;2017-18;2017;2017;25;18;7;147;113;34;17;12;5;;;;;fuIQs
520;École doctorale Humanités;;6;Sciences humaines et humanités;2018;2017-18;2017;2017;49;28;21;310;186;124;45;27;18;;;;;rI175
521;École doctorale Sciences et ingénierie pour l'information, mathématiques;S2I;2;Physique;2018;2017-18;2017;2017;4;0;4;15;1;14;11;0;11;;;;;V6i83
525;"École doctorale Lettres, pensée, arts et histoire, ""Civilisation de l'antiquité à nos jours""";LPAH;7;Sciences de la société;2018;2017-18;2017;2017;0;0;0;4;2;2;0;0;0;;;;;19Rpr
526;École doctorale Sociétés et organisations;SORG;6;Sciences humaines et humanités;2018;2017-18;2017;2017;6;2;4;49;19;30;8;3;5;;;;;5F3Fd
529;École doctorale Cultures et sociétés;CS;7;Sciences de la société;2018;2017-18;2017;2017;5;3;2;6;3;3;0;0;0;;;;;XU9tb
530;École doctorale Organisations, marchés, institutions;OMI;1;Mathématiques et leurs interactions;2018;2017-18;2017;2017;0;0;0;3;2;1;0;0;0;;;;;4htv7
530;École doctorale Organisations, marchés, institutions;OMI;5;Biologie, médecine et santé;2018;2017-18;2017;2017;0;0;0;4;2;2;0;0;0;;;;;4htv7
530;École doctorale Organisations, marchés, institutions;OMI;6;Sciences humaines et humanités;2018;2017-18;2017;2017;36;15;21;132;62;70;9;6;3;;;;;4htv7
531;École doctorale Sciences, ingénierie et environnement;SIE;1;Mathématiques et leurs interactions;2018;2017-18;2017;2017;3;1;2;6;2;4;0;0;0;;;;;b5BYq
531;École doctorale Sciences, ingénierie et environnement;SIE;8;Sciences pour l'ingénieur;2018;2017-18;2017;2017;62;20;42;204;71;133;62;21;41;;;;;b5BYq
532;École doctorale Mathématiques et sciences et technologies de l'information et de la communication;MSTIC;3;Sciences de la terre et de l'univers, espace;2018;2017-18;2017;2017;0;0;0;11;2;9;4;3;1;;;;;t43KM
536;École doctorale Sciences et agrosciences;;4;Chimie;2018;2017-18;2017;2017;8;8;0;23;16;7;4;2;2;;;;;pHfqe
536;École doctorale Sciences et agrosciences;;10;Sciences agronomiques et écologiques;2018;2017-18;2017;2017;20;8;12;51;24;27;12;9;3;;;;;pHfqe
540;"École doctorale École transdisciplinaire ""lettres/sciences""";;5;Biologie, médecine et santé;2018;2017-18;2017;2017;2;0;2;3;0;3;2;2;0;;;;;tWWw7
540;"École doctorale École transdisciplinaire ""lettres/sciences""";;8;Sciences pour l'ingénieur;2018;2017-18;2017;2017;2;2;0;3;2;1;1;0;1;;;;;tWWw7
540;"École doctorale École transdisciplinaire ""lettres/sciences""";;9;Sciences et technologies de l'information et de la communication;2018;2017-18;2017;2017;1;0;1;3;1;2;1;0;1;;;;;tWWw7
542;École doctorale de sciences de La Réunion;STS;3;Sciences de la terre et de l'univers, espace;2018;2017-18;2017;2017;2;1;1;33;12;21;4;3;1;;;;;2pAql
544;École doctorale Inter-Med : Espaces, temps, cultures;INTER-MED;6;Sciences humaines et humanités;2018;2017-18;2017;2017;18;11;7;96;56;40;13;9;4;;;;;7VjtD
545;École doctorale Sociétés, politique et santé publique;SP2;7;Sciences de la société;2018;2017-18;2017;2017;19;9;10;91;45;46;16;11;5;;;;;IAKR4
547;École doctorale Sciences, Technologie, Santé;EDSTS;1;Mathématiques et leurs interactions;2018;2017-18;2017;2017;3;2;1;6;3;3;4;0;4;;;;;wEdn2
547;École doctorale Sciences, Technologie, Santé;EDSTS;3;Sciences de la terre et de l'univers, espace;2018;2017-18;2017;2017;2;1;1;6;4;2;1;1;0;;;;;wEdn2
547;École doctorale Sciences, Technologie, Santé;EDSTS;8;Sciences pour l'ingénieur;2018;2017-18;2017;2017;6;3;3;51;14;37;9;2;7;;;;;wEdn2
548;École doctorale Mer et Sciences;;5;Biologie, médecine et santé;2018;2017-18;2017;2017;0;0;0;6;1;5;2;1;1;;;;;QX0fS
551;École doctorale Mathématiques, Informatique, Physique Théorique et Ingénierie des Systèmes;MIPTIS;1;Mathématiques et leurs interactions;2018;2017-18;2017;2017;5;0;5;21;7;14;8;2;6;;;;;Mpudz
552;École doctorale Énergie - Matériaux - Sciences de la Terre et de l'Univers;EMTSU;2;Physique;2018;2017-18;2017;2017;9;4;5;29;10;19;11;6;5;;;;;NTZhw
553;École doctorale Carnot - Pasteur;;3;Sciences de la terre et de l'univers, espace;2018;2017-18;2017;2017;1;0;1;3;0;3;1;0;1;;;;;6h4Z7
553;École doctorale Carnot - Pasteur;;8;Sciences pour l'ingénieur;2018;2017-18;2017;2017;0;0;0;1;1;0;1;0;1;;;;;6h4Z7
553;École doctorale Carnot - Pasteur;;9;Sciences et technologies de l'information et de la communication;2018;2017-18;2017;2017;0;0;0;1;0;1;0;0;0;;;;;6h4Z7
554;École doctorale Environnements - Santé;E-S;1;Mathématiques et leurs interactions;2018;2017-18;2017;2017;0;0;0;2;0;2;0;0;0;;;;;ElyFU
554;École doctorale Environnements - Santé;E-S;8;Sciences pour l'ingénieur;2018;2017-18;2017;2017;1;1;0;9;5;4;0;0;0;;;;;ElyFU
558;École doctorale Histoire, Mémoire, Patrimoine, Langage;HMPL;7;Sciences de la société;2018;2017-18;2017;2017;0;0;0;1;1;0;0;0;0;;;;;uX3jT
559;École doctorale Management Panthéon-Sorbonne;;9;Sciences et technologies de l'information et de la communication;2018;2017-18;2017;2017;2;2;0;24;13;11;1;0;1;;;;;4SP7k
560;École doctorale Sciences de la terre et de l'environnement et Physique de l'univers, Paris;STEP'UP;3;Sciences de la terre et de l'univers, espace;2018;2017-18;2017;2017;44;15;29;184;65;119;52;21;31;;;;;Z2VI9
568;École doctorale Signalisations et Réseaux Intégratifs en Biologie;BIOSIGNE;5;Biologie, médecine et santé;2018;2017-18;2017;2017;31;22;9;134;85;49;31;19;12;;;;;CGttG
569;École doctorale Innovation thérapeutique : du fondamental à l'appliqué;;4;Chimie;2018;2017-18;2017;2017;9;5;4;37;21;16;8;5;3;;;;;jx8ET
569;École doctorale Innovation thérapeutique : du fondamental à l'appliqué;;5;Biologie, médecine et santé;2018;2017-18;2017;2017;60;36;24;273;150;123;64;31;33;;;;;jx8ET
570;École doctorale Santé Publique;EDSP;1;Mathématiques et leurs interactions;2018;2017-18;2017;2017;0;0;0;3;2;1;0;0;0;;;;;9lgE4
570;École doctorale Santé Publique;EDSP;5;Biologie, médecine et santé;2018;2017-18;2017;2017;38;21;17;136;92;44;38;27;11;;;;;9lgE4
573;École doctorale Interfaces : Approches Interdisciplinaires, Fondements, Applications et Innovation;ED INTERFACES;8;Sciences pour l'ingénieur;2018;2017-18;2017;2017;15;8;7;71;28;43;18;8;10;;;;;gG820
576;École doctorale Particules, Hadrons, Énergie, Noyau, Instrumentation, Imagerie, Cosmos et Simulation;PHENIICS;2;Physique;2018;2017-18;2017;2017;53;16;37;218;70;148;53;15;38;;;;;qC4rf
576;École doctorale Particules, Hadrons, Énergie, Noyau, Instrumentation, Imagerie, Cosmos et Simulation;PHENIICS;3;Sciences de la terre et de l'univers, espace;2018;2017-18;2017;2017;0;0;0;4;1;3;1;0;1;;;;;qC4rf
577;École doctorale Structure et dynamique des systèmes vivants;SDSV;4;Chimie;2018;2017-18;2017;2017;1;1;0;3;3;0;1;1;0;;;;;4bsxJ
579;École doctorale Sciences mécaniques et energétiques, matériaux et géosciences;SMEMaG;1;Mathématiques et leurs interactions;2018;2017-18;2017;2017;0;0;0;4;0;4;0;0;0;;;;;atMj7
581;École doctorale Agriculture, alimentation, biologie, environnement, santé;ABIES;8;Sciences pour l'ingénieur;2018;2017-18;2017;2017;12;8;4;48;29;19;16;12;4;;;;;c1x56
581;École doctorale Agriculture, alimentation, biologie, environnement, santé;ABIES;10;Sciences agronomiques et écologiques;2018;2017-18;2017;2017;18;11;7;94;58;36;25;11;14;;;;;c1x56
582;École doctorale Cancérologie, Biologie, Médecine, Santé;CBMS;3;Sciences de la terre et de l'univers, espace;2018;2017-18;2017;2017;0;0;0;1;0;1;0;0;0;;;;;75bj4
583;École doctorale Risques et Société;;4;Chimie;2018;2017-18;2017;2017;1;0;1;4;1;3;0;0;0;;;;;wUBi9
583;École doctorale Risques et Société;;9;Sciences et technologies de l'information et de la communication;2018;2017-18;2017;2017;3;2;1;6;5;1;0;0;0;;;;;wUBi9
587;École doctorale Diversites, santé et développement en Amazonie;;10;Sciences agronomiques et écologiques;2018;2017-18;2017;2017;1;1;0;12;8;4;5;3;2;;;;;V14tj
588;École doctorale Milieu insulaire tropical : dynamiques de développement, sociétés, patrimoine et culture dans l'espace Caraïbes-Amériques;;6;Sciences humaines et humanités;2018;2017-18;2017;2017;20;14;6;132;80;52;14;11;3;;;;;4W5IO
591;École doctorale Physique, Sciences de l'Ingenieur, Materiaux, Énergie;PSIME;9;Sciences et technologies de l'information et de la communication;2018;2017-18;2017;2017;2;1;1;9;2;7;4;2;2;;;;;Hn5Om
592;École doctorale Lettres, Communication, Langues, Arts;LECLA;6;Sciences humaines et humanités;2018;2017-18;2017;2017;49;37;12;211;134;77;35;23;12;;;;;sY7f3
596;École doctorale Matière, Molécules et Matériaux;ED 3M;4;Chimie;2018;2017-18;2017;2017;86;39;47;264;118;146;63;23;40;;;;;77947
598;École doctorale Sciences de La Mer et du Littoral;SML;10;Sciences agronomiques et écologiques;2018;2017-18;2017;2017;19;10;9;78;39;39;8;3;5;;;;;Smen6
601;École doctorale Mathématiques et Sciences et Technologies de l'information et de la Communication;MathSTIC;1;Mathématiques et leurs interactions;2018;2017-18;2017;2017;31;9;22;130;44;86;27;9;18;;;;;3Ue20
601;École doctorale Mathématiques et Sciences et Technologies de l'information et de la Communication;MathSTIC;2;Physique;2018;2017-18;2017;2017;0;0;0;0;0;0;1;0;1;;;;;3Ue20
605;École doctorale Biologie Santé;ED BS;6;Sciences humaines et humanités;2018;2017-18;2017;2017;0;0;0;4;2;2;0;0;0;;;;;w8CxU
8;École doctorale Histoire du droit, philosophie du droit et sociologie du droit;;7;Sciences de la société;2022;2021-22;2021;2021;9;1;8;93;41;52;8;2;6;0;1;2;5;pGSed
9;École doctorale Droit international, droit européen, relations internationales et droit comparé;;7;Sciences de la société;2022;2021-22;2021;2021;35;17;18;256;147;109;22;16;6;0;2;6;14;v1emR
31;École doctorale Pratiques et théories du sens;;7;Sciences de la société;2022;2021-22;2021;2021;14;9;5;108;69;39;9;6;3;2;1;1;5;1S466
37;École doctorale Sciences physiques pour l'ingénieur et microtechniques;SPIM;2;Physique;2022;2021-22;2021;2021;0;0;0;0;0;0;1;1;0;0;1;0;0;F7G1B
37;École doctorale Sciences physiques pour l'ingénieur et microtechniques;SPIM;9;Sciences et technologies de l'information et de la communication;2022;2021-22;2021;2021;60;9;51;206;53;153;56;16;40;29;20;6;1;F7G1B
40;École doctorale Sciences chimiques;EDSC;4;Chimie;2022;2021-22;2021;2021;86;40;46;305;139;166;61;26;35;26;32;2;1;wde3D
65;École doctorale Sciences de la Vie, Santé, Agronomie, Environnement;;10;Sciences agronomiques et écologiques;2022;2021-22;2021;2021;0;0;0;2;2;0;4;3;1;0;1;3;0;MAOG4
70;École doctorale Sciences pour l'ingénieur;EDSPI;9;Sciences et technologies de l'information et de la communication;2022;2021-22;2021;2021;18;3;15;46;11;35;10;3;7;0;0;9;1;G413P
73;École doctorale Sciences économiques, sociales, de l'aménagement et du management;SESAM;6;Sciences humaines et humanités;2022;2021-22;2021;2021;7;1;6;42;17;25;10;5;5;0;1;5;4;IQ0Hk
77;École doctorale Informatique, automatique, électronique, électrotechnique, mathématiques;IAEM;9;Sciences et technologies de l'information et de la communication;2022;2021-22;2021;2021;67;20;47;273;70;203;65;17;48;25;29;11;0;TCHTA
78;École doctorale Sociétés, langages, temps, connaissances;STLC;7;Sciences de la société;2022;2021-22;2021;2021;6;3;3;54;30;24;5;5;0;0;1;2;2;vLU3i
88;École doctorale Droit et science politique;DSP;7;Sciences de la société;2022;2021-22;2021;2021;25;15;10;205;99;106;19;5;14;0;2;4;13;elnAJ
104;École doctorale Sciences de la matière, du rayonnement et de l'environnement;SMRE;2;Physique;2022;2021-22;2021;2021;8;1;7;59;15;44;10;5;5;5;5;0;0;Q5iFz
105;École doctorale Terre, univers, environnement;;3;Sciences de la terre et de l'univers, espace;2022;2021-22;2021;2021;53;23;30;176;62;114;37;14;23;19;16;2;0;lcWAf
124;École doctorale Histoire de l'art et archéologie;;6;Sciences humaines et humanités;2022;2021-22;2021;2021;15;9;6;134;89;45;23;20;3;1;3;10;9;MBN4L
129;École doctorale Sciences de l'environnement d'Ile de France;SEIF;10;Sciences agronomiques et écologiques;2022;2021-22;2021;2021;0;0;0;1;1;0;0;0;0;0;0;0;0;TnAPh
130;École doctorale Informatique, télécommunications et électronique de Paris;EDITE;9;Sciences et technologies de l'information et de la communication;2022;2021-22;2021;2021;87;21;66;416;75;341;105;28;77;44;50;11;0;O5ysj
139;École doctorale Connaissance, langage, modélisation;CLM;2;Physique;2022;2021-22;2021;2021;0;0;0;1;0;1;0;0;0;0;0;0;0;1lxGH
139;École doctorale Connaissance, langage, modélisation;CLM;5;Biologie, médecine et santé;2022;2021-22;2021;2021;1;1;0;8;8;0;1;1;0;0;1;0;0;1lxGH
139;École doctorale Connaissance, langage, modélisation;CLM;9;Sciences et technologies de l'information et de la communication;2022;2021-22;2021;2021;1;0;1;5;1;4;0;0;0;0;0;0;0;1lxGH
146;École doctorale Galilée;GALILEE;2;Physique;2022;2021-22;2021;2021;15;2;13;60;14;46;13;5;8;5;7;1;0;71hqm
166;École doctorale Information, structures et systèmes;I2S;4;Chimie;2022;2021-22;2021;2021;0;0;0;5;3;2;0;0;0;0;0;0;0;2uO68
166;École doctorale Information, structures et systèmes;I2S;10;Sciences agronomiques et écologiques;2022;2021-22;2021;2021;1;0;1;2;0;2;0;0;0;0;0;0;0;2uO68
168;École doctorale Sciences chimiques et biologiques pour la santé;SCBS;5;Biologie, médecine et santé;2022;2021-22;2021;2021;124;68;56;442;240;202;98;60;38;43;41;12;2;8cEME
173;École doctorale Sciences de l'univers, de l'environnement et de l'espace;SDU2E;2;Physique;2022;2021-22;2021;2021;1;0;1;8;2;6;0;0;0;0;0;0;0;R0Z9c
173;École doctorale Sciences de l'univers, de l'environnement et de l'espace;SDU2E;4;Chimie;2022;2021-22;2021;2021;1;0;1;1;0;1;0;0;0;0;0;0;0;R0Z9c
178;École doctorale Sciences fondamentales;;3;Sciences de la terre et de l'univers, espace;2022;2021-22;2021;2021;15;5;10;36;11;25;10;5;5;9;1;0;0;1AiR7
184;École doctorale Mathématiques et informatique de Marseille;;1;Mathématiques et leurs interactions;2022;2021-22;2021;2021;21;5;16;97;22;75;21;11;10;10;9;1;1;DDObG
205;École doctorale Interdisciplinaire Sciences-Santé;EDISS;4;Chimie;2022;2021-22;2021;2021;0;0;0;1;0;1;0;0;0;0;0;0;0;69W38
205;École doctorale Interdisciplinaire Sciences-Santé;EDISS;6;Sciences humaines et humanités;2022;2021-22;2021;2021;4;1;3;12;5;7;3;1;2;2;1;0;0;69W38
205;École doctorale Interdisciplinaire Sciences-Santé;EDISS;8;Sciences pour l'ingénieur;2022;2021-22;2021;2021;0;0;0;1;1;0;0;0;0;0;0;0;0;69W38
205;École doctorale Interdisciplinaire Sciences-Santé;EDISS;9;Sciences et technologies de l'information et de la communication;2022;2021-22;2021;2021;5;4;1;14;8;6;1;0;1;0;1;0;0;69W38
211;École doctorale Sciences exactes et leurs applications;ED SEA;2;Physique;2022;2021-22;2021;2021;6;0;6;19;3;16;2;1;1;1;1;0;0;1G1iC
211;École doctorale Sciences exactes et leurs applications;ED SEA;8;Sciences pour l'ingénieur;2022;2021-22;2021;2021;15;4;11;70;24;46;20;6;14;9;11;0;0;1G1iC
216;École doctorale Ingénierie pour la santé, la cognition, l'environnement;EDISCE;5;Biologie, médecine et santé;2022;2021-22;2021;2021;31;21;10;129;67;62;26;16;10;12;13;1;0;fPs1t
216;École doctorale Ingénierie pour la santé, la cognition, l'environnement;EDISCE;6;Sciences humaines et humanités;2022;2021-22;2021;2021;15;10;5;50;36;14;13;5;8;5;4;2;2;fPs1t
216;École doctorale Ingénierie pour la santé, la cognition, l'environnement;EDISCE;7;Sciences de la société;2022;2021-22;2021;2021;0;0;0;1;1;0;1;1;0;0;1;0;0;fPs1t
217;École doctorale Mathématiques, sciences et technologies de l'information, informatique;MSTII;5;Biologie, médecine et santé;2022;2021-22;2021;2021;0;0;0;5;0;5;2;0;2;1;1;0;0;Ehx7v
218;École doctorale Chimie et sciences du vivant;EDCSV;8;Sciences pour l'ingénieur;2022;2021-22;2021;2021;1;1;0;2;2;0;0;0;0;0;0;0;0;8bcJh
220;École doctorale Électronique, électrotechnique, automatique, traitement du signal;EEATS;4;Chimie;2022;2021-22;2021;2021;0;0;0;1;1;0;0;0;0;0;0;0;0;IxEaw
220;École doctorale Électronique, électrotechnique, automatique, traitement du signal;EEATS;5;Biologie, médecine et santé;2022;2021-22;2021;2021;0;0;0;1;1;0;2;1;1;1;1;0;0;IxEaw
220;École doctorale Électronique, électrotechnique, automatique, traitement du signal;EEATS;8;Sciences pour l'ingénieur;2022;2021-22;2021;2021;54;16;38;217;39;178;51;12;39;18;29;4;0;IxEaw
227;École doctorale Sciences de la nature et de l'homme;;4;Chimie;2022;2021-22;2021;2021;1;0;1;9;4;5;1;0;1;0;1;0;0;xiDA5
251;École doctorale Sciences de l'environnement;;6;Sciences humaines et humanités;2022;2021-22;2021;2021;3;3;0;12;9;3;1;1;0;0;1;0;0;VR28y
267;École doctorale Arts et médias;;6;Sciences humaines et humanités;2022;2021-22;2021;2021;27;13;14;179;104;75;20;12;8;0;2;9;9;eCF5C
270;École doctorale Théologie et sciences religieuses;;6;Sciences humaines et humanités;2022;2021-22;2021;2021;8;1;7;70;23;47;22;11;11;1;6;6;9;BRKC1
323;École doctorale Génie électrique, électronique et télécommunications;GEET;9;Sciences et technologies de l'information et de la communication;2022;2021-22;2021;2021;5;3;2;31;9;22;9;2;7;2;6;1;0;arcz6
326;École doctorale Comportement, langage, éducation, socialisation, cognition;CLESCO;8;Sciences pour l'ingénieur;2022;2021-22;2021;2021;0;0;0;1;0;1;0;0;0;0;0;0;0;nWIlG
327;École doctorale Temps, espaces, sociétés, cultures;TESC;6;Sciences humaines et humanités;2022;2021-22;2021;2021;40;27;13;256;151;105;27;15;12;0;5;12;10;IjgiJ
328;École doctorale Arts, lettres, langues, philosophie et communication;ALLPH@;9;Sciences et technologies de l'information et de la communication;2022;2021-22;2021;2021;3;1;2;33;20;13;3;2;1;1;1;1;0;xLxMh
340;École doctorale Biologie moléculaire, intégrative et cellulaire;BMIC;5;Biologie, médecine et santé;2022;2021-22;2021;2021;73;48;25;312;197;115;62;35;27;18;40;4;0;db7xq
341;École doctorale Évolution, écosystèmes, microbiologie, modélisation;E2M2;5;Biologie, médecine et santé;2022;2021-22;2021;2021;31;17;14;124;63;61;21;11;10;10;11;0;0;J83I0
353;École doctorale Sciences pour l'ingénieur : mécanique, physique, micro et nanoélectronique;;8;Sciences pour l'ingénieur;2022;2021-22;2021;2021;51;16;35;194;40;154;43;16;27;14;26;3;0;vk5Kp
355;École doctorale Espaces, cultures, sociétés;;7;Sciences de la société;2022;2021-22;2021;2021;14;7;7;72;41;31;10;8;2;0;0;5;5;2kMf5
364;École doctorale Sciences fondamentales et appliquées;EDSFA;4;Chimie;2022;2021-22;2021;2021;19;10;9;74;32;42;15;8;7;7;6;1;1;E483q
364;École doctorale Sciences fondamentales et appliquées;EDSFA;8;Sciences pour l'ingénieur;2022;2021-22;2021;2021;25;8;17;78;22;56;19;4;15;6;9;4;0;E483q
364;École doctorale Sciences fondamentales et appliquées;EDSFA;10;Sciences agronomiques et écologiques;2022;2021-22;2021;2021;0;0;0;0;0;0;1;0;1;1;0;0;0;E483q
377;École doctorale Environnement et société;;5;Biologie, médecine et santé;2022;2021-22;2021;2021;3;3;0;7;5;2;0;0;0;0;0;0;0;ZMG5u
377;École doctorale Environnement et société;;9;Sciences et technologies de l'information et de la communication;2022;2021-22;2021;2021;0;0;0;6;1;5;2;0;2;0;1;1;0;ZMG5u
393;École doctorale Pierre Louis de Santé Publique : Épidémiologie et Sciences de l'information biomédicale;PLSP;5;Biologie, médecine et santé;2022;2021-22;2021;2021;57;30;27;223;119;104;55;33;22;24;10;17;4;69445
395;École doctorale Milieux, cultures et sociétés du passé et du présent;MCSPP;7;Sciences de la société;2022;2021-22;2021;2021;8;6;2;71;49;22;11;8;3;0;1;4;6;2quEb
398;École doctorale Géosciences, ressources naturelles et environnement;GRNE;8;Sciences pour l'ingénieur;2022;2021-22;2021;2021;2;2;0;6;4;2;2;1;1;0;2;0;0;Zi4Zf
398;École doctorale Géosciences, ressources naturelles et environnement;GRNE;10;Sciences agronomiques et écologiques;2022;2021-22;2021;2021;0;0;0;1;0;1;0;0;0;0;0;0;0;Zi4Zf
411;École doctorale Humanités nouvelles : Fernand Braudel;;6;Sciences humaines et humanités;2022;2021-22;2021;2021;35;21;14;262;126;136;41;21;20;4;12;14;11;l2rFh
411;École doctorale Humanités nouvelles : Fernand Braudel;;7;Sciences de la société;2022;2021-22;2021;2021;2;1;1;3;1;2;0;0;0;0;0;0;0;l2rFh
414;École doctorale Sciences de la vie et de la santé;;7;Sciences de la société;2022;2021-22;2021;2021;0;0;0;3;1;2;0;0;0;0;0;0;0;YI4xS
417;École doctorale Sciences et Ingénierie;S&I;2;Physique;2022;2021-22;2021;2021;1;1;0;6;3;3;3;1;2;2;1;0;0;SSBvE
432;École doctorale Sciences des métiers de l'ingénieur;SMI;8;Sciences pour l'ingénieur;2022;2021-22;2021;2021;111;35;76;360;116;244;82;20;62;39;37;6;0;nSsHB
433;École doctorale Concepts et langages;;7;Sciences de la société;2022;2021-22;2021;2021;5;2;3;13;6;7;2;0;2;0;0;1;1;v8q34
446;École doctorale Biologie - Santé;EDBSL;4;Chimie;2022;2021-22;2021;2021;2;1;1;9;5;4;3;2;1;3;0;0;0;4iEUF
450;École doctorale Recherches en psychanalyse et psychopathologie;PSY²;6;Sciences humaines et humanités;2022;2021-22;2021;2021;17;10;7;129;86;43;33;20;13;1;9;10;13;8jI3f
455;École doctorale Économie, Gestion, Information et Communication;EGIC;7;Sciences de la société;2022;2021-22;2021;2021;24;8;16;92;39;53;10;6;4;0;2;7;1;qCOg3
468;École doctorale Mécanique, énergétique, génie civil, procédés;MEGEP;8;Sciences pour l'ingénieur;2022;2021-22;2021;2021;123;34;89;468;128;340;96;33;63;39;49;7;1;4XUTB
469;École doctorale du Pacifique;EDP;1;Mathématiques et leurs interactions;2022;2021-22;2021;2021;0;0;0;2;1;1;0;0;0;0;0;0;0;t9Z2n
469;École doctorale du Pacifique;EDP;2;Physique;2022;2021-22;2021;2021;0;0;0;2;0;2;0;0;0;0;0;0;0;t9Z2n
469;École doctorale du Pacifique;EDP;5;Biologie, médecine et santé;2022;2021-22;2021;2021;4;4;0;11;9;2;2;1;1;0;2;0;0;t9Z2n
472;École doctorale de l'EPHE;;4;Chimie;2022;2021-22;2021;2021;0;0;0;1;1;0;0;0;0;0;0;0;0;27zK4
472;École doctorale de l'EPHE;;6;Sciences humaines et humanités;2022;2021-22;2021;2021;96;34;62;515;261;254;81;36;45;10;19;26;26;27zK4
472;École doctorale de l'EPHE;;7;Sciences de la société;2022;2021-22;2021;2021;5;1;4;34;20;14;2;1;1;1;0;1;0;27zK4
472;École doctorale de l'EPHE;;9;Sciences et technologies de l'information et de la communication;2022;2021-22;2021;2021;1;0;1;6;2;4;1;0;1;1;0;0;0;27zK4
473;École doctorale Sciences de l'homme et de la société;SHS;6;Sciences humaines et humanités;2022;2021-22;2021;2021;84;53;31;497;295;202;72;37;35;7;14;26;25;8qKD9
474;École doctorale Interdisciplinaire européenne frontières du vivant;FDV;2;Physique;2022;2021-22;2021;2021;0;0;0;1;0;1;1;0;1;1;0;0;0;E727j
474;École doctorale Interdisciplinaire européenne frontières du vivant;FDV;5;Biologie, médecine et santé;2022;2021-22;2021;2021;34;16;18;108;56;52;28;11;17;2;26;0;0;E727j
474;École doctorale Interdisciplinaire européenne frontières du vivant;FDV;9;Sciences et technologies de l'information et de la communication;2022;2021-22;2021;2021;0;0;0;3;1;2;0;0;0;0;0;0;0;E727j
476;École doctorale Neurosciences et cognition;NSCO;6;Sciences humaines et humanités;2022;2021-22;2021;2021;8;5;3;24;16;8;12;9;3;6;5;1;0;B1H0x
480;École doctorale Montaigne-humanités;;6;Sciences humaines et humanités;2022;2021-22;2021;2021;94;54;40;535;302;233;61;41;20;6;6;27;22;f3SeZ
482;École doctorale Sciences de la matière;SDM;2;Physique;2022;2021-22;2021;2021;21;8;13;77;25;52;12;4;8;8;4;0;0;kmeZ4
482;École doctorale Sciences de la matière;SDM;4;Chimie;2022;2021-22;2021;2021;59;31;28;185;87;98;48;22;26;29;18;1;0;kmeZ4
482;École doctorale Sciences de la matière;SDM;8;Sciences pour l'ingénieur;2022;2021-22;2021;2021;8;4;4;38;17;21;12;1;11;6;5;1;0;kmeZ4
486;École doctorale Sciences économiques et de gestion;SEG;7;Sciences de la société;2022;2021-22;2021;2021;29;10;19;142;67;75;22;6;16;2;10;10;0;h1GZ3
488;École doctorale Sciences, ingénierie, santé;SIS;8;Sciences pour l'ingénieur;2022;2021-22;2021;2021;18;6;12;112;39;73;23;9;14;3;19;1;0;Fy2lK
488;École doctorale Sciences, ingénierie, santé;SIS;10;Sciences agronomiques et écologiques;2022;2021-22;2021;2021;0;0;0;3;2;1;0;0;0;0;0;0;0;Fy2lK
489;École doctorale Sciences et ingénierie des systèmes, de l'environnement et des organisations;SISEO;8;Sciences pour l'ingénieur;2022;2021-22;2021;2021;0;0;0;0;0;0;4;1;3;2;2;0;0;6pT77
497;École doctorale Normande de Biologie Intégrative, Santé, Environnement;Ed NBISE;10;Sciences agronomiques et écologiques;2022;2021-22;2021;2021;11;5;6;36;17;19;3;1;2;1;2;0;0;0D9Je
508;École doctorale Normande de chimie;EDNC;4;Chimie;2022;2021-22;2021;2021;42;20;22;170;69;101;39;15;24;25;14;0;0;E52OO
512;École doctorale Informatique et mathématiques;InfoMaths;1;Mathématiques et leurs interactions;2022;2021-22;2021;2021;29;7;22;96;17;79;19;2;17;15;3;0;1;t86bi
512;École doctorale Informatique et mathématiques;InfoMaths;8;Sciences pour l'ingénieur;2022;2021-22;2021;2021;3;3;0;10;6;4;1;0;1;1;0;0;0;t86bi
528;École doctorale Ville, transports et territoires;VTT;1;Mathématiques et leurs interactions;2022;2021-22;2021;2021;0;0;0;1;1;0;0;0;0;0;0;0;0;68zCc
530;École doctorale Organisations, marchés, institutions;OMI;5;Biologie, médecine et santé;2022;2021-22;2021;2021;0;0;0;3;0;3;0;0;0;0;0;0;0;4htv7
530;École doctorale Organisations, marchés, institutions;OMI;9;Sciences et technologies de l'information et de la communication;2022;2021-22;2021;2021;0;0;0;7;6;1;0;0;0;0;0;0;0;4htv7
530;École doctorale Organisations, marchés, institutions;OMI;10;Sciences agronomiques et écologiques;2022;2021-22;2021;2021;1;0;1;1;0;1;0;0;0;0;0;0;0;4htv7
531;École doctorale Sciences, ingénierie et environnement;SIE;10;Sciences agronomiques et écologiques;2022;2021-22;2021;2021;0;0;0;5;2;3;0;0;0;0;0;0;0;b5BYq
532;École doctorale Mathématiques et sciences et technologies de l'information et de la communication;MSTIC;3;Sciences de la terre et de l'univers, espace;2022;2021-22;2021;2021;0;0;0;1;0;1;1;1;0;1;0;0;0;t43KM
536;École doctorale Sciences et agrosciences;;9;Sciences et technologies de l'information et de la communication;2022;2021-22;2021;2021;12;2;10;38;8;30;7;4;3;3;2;1;1;pHfqe
537;École doctorale Culture et patrimoine;C&P;6;Sciences humaines et humanités;2022;2021-22;2021;2021;9;2;7;74;30;44;12;6;6;0;2;4;6;GxI4a
540;"École doctorale École transdisciplinaire ""lettres/sciences""";;2;Physique;2022;2021-22;2021;2021;0;0;0;2;1;1;0;0;0;0;0;0;0;tWWw7
542;École doctorale de sciences de La Réunion;STS;10;Sciences agronomiques et écologiques;2022;2021-22;2021;2021;5;4;1;16;11;5;4;2;2;0;4;0;0;2pAql
543;École doctorale de Dauphine;;1;Mathématiques et leurs interactions;2022;2021-22;2021;2021;16;1;15;53;8;45;7;0;7;4;3;0;0;u8w6A
543;École doctorale de Dauphine;;9;Sciences et technologies de l'information et de la communication;2022;2021-22;2021;2021;13;3;10;45;9;36;10;2;8;1;8;1;0;u8w6A
544;École doctorale Inter-Med : Espaces, temps, cultures;INTER-MED;6;Sciences humaines et humanités;2022;2021-22;2021;2021;23;10;13;118;63;55;15;6;9;3;2;4;6;7VjtD
546;École doctorale Abbé Grégoire;;7;Sciences de la société;2022;2021-22;2021;2021;0;0;0;42;25;17;15;12;3;4;2;5;4;ZSn7q
546;École doctorale Abbé Grégoire;;9;Sciences et technologies de l'information et de la communication;2022;2021-22;2021;2021;0;0;0;1;1;0;0;0;0;0;0;0;0;ZSn7q
549;École doctorale Santé, Sciences Biologiques et Chimie du Vivant;SSBCV;4;Chimie;2022;2021-22;2021;2021;11;4;7;48;20;28;11;5;6;5;6;0;0;B9ggO
549;École doctorale Santé, Sciences Biologiques et Chimie du Vivant;SSBCV;8;Sciences pour l'ingénieur;2022;2021-22;2021;2021;0;0;0;0;0;0;1;1;0;1;0;0;0;B9ggO
549;École doctorale Santé, Sciences Biologiques et Chimie du Vivant;SSBCV;10;Sciences agronomiques et écologiques;2022;2021-22;2021;2021;5;4;1;11;6;5;4;2;2;2;2;0;0;B9ggO
552;École doctorale Énergie - Matériaux - Sciences de la Terre et de l'Univers;EMTSU;3;Sciences de la terre et de l'univers, espace;2022;2021-22;2021;2021;15;5;10;57;23;34;11;4;7;5;6;0;0;NTZhw
553;École doctorale Carnot - Pasteur;;1;Mathématiques et leurs interactions;2022;2021-22;2021;2021;16;4;12;61;14;47;12;1;11;3;5;3;1;6h4Z7
558;École doctorale Histoire, Mémoire, Patrimoine, Langage;HMPL;6;Sciences humaines et humanités;2022;2021-22;2021;2021;69;41;28;307;151;156;29;16;13;2;4;13;10;uX3jT
560;École doctorale Sciences de la terre et de l'environnement et Physique de l'univers, Paris;STEP'UP;3;Sciences de la terre et de l'univers, espace;2022;2021-22;2021;2021;34;13;21;117;55;62;31;10;21;14;14;3;0;Z2VI9
568;École doctorale Signalisations et Réseaux Intégratifs en Biologie;BIOSIGNE;5;Biologie, médecine et santé;2022;2021-22;2021;2021;23;18;5;94;65;29;21;16;5;5;13;3;0;CGttG
570;École doctorale Santé Publique;EDSP;9;Sciences et technologies de l'information et de la communication;2022;2021-22;2021;2021;0;0;0;1;1;0;0;0;0;0;0;0;0;9lgE4
571;École doctorale Sciences Chimiques : Molécules, Matériaux, Instrumentation et Biosystemes;2MIB;2;Physique;2022;2021-22;2021;2021;6;5;1;18;9;9;3;1;2;2;1;0;0;zbi37
571;École doctorale Sciences Chimiques : Molécules, Matériaux, Instrumentation et Biosystemes;2MIB;4;Chimie;2022;2021-22;2021;2021;88;36;52;309;150;159;56;27;29;27;27;1;1;zbi37
572;École doctorale Ondes et matière;EDOM;2;Physique;2022;2021-22;2021;2021;52;12;40;185;48;137;41;13;28;12;25;4;0;etSIi
573;École doctorale Interfaces : Approches Interdisciplinaires, Fondements, Applications et Innovation;ED INTERFACES;4;Chimie;2022;2021-22;2021;2021;1;0;1;13;8;5;4;2;2;4;0;0;0;gG820
573;École doctorale Interfaces : Approches Interdisciplinaires, Fondements, Applications et Innovation;ED INTERFACES;5;Biologie, médecine et santé;2022;2021-22;2021;2021;2;0;2;18;6;12;2;1;1;1;1;0;0;gG820
574;École doctorale de Mathématiques Hadamard;EDMH;1;Mathématiques et leurs interactions;2022;2021-22;2021;2021;93;13;80;338;64;274;91;10;81;53;35;3;0;4pqal
579;École doctorale Sciences mécaniques et energétiques, matériaux et géosciences;SMEMaG;5;Biologie, médecine et santé;2022;2021-22;2021;2021;2;0;2;3;0;3;0;0;0;0;0;0;0;atMj7
579;École doctorale Sciences mécaniques et energétiques, matériaux et géosciences;SMEMaG;8;Sciences pour l'ingénieur;2022;2021-22;2021;2021;55;12;43;208;49;159;47;11;36;12;27;7;1;atMj7
582;École doctorale Cancérologie, Biologie, Médecine, Santé;CBMS;1;Mathématiques et leurs interactions;2022;2021-22;2021;2021;1;0;1;1;0;1;0;0;0;0;0;0;0;75bj4
582;École doctorale Cancérologie, Biologie, Médecine, Santé;CBMS;5;Biologie, médecine et santé;2022;2021-22;2021;2021;57;35;22;214;130;84;56;26;30;12;33;11;0;75bj4
583;École doctorale Risques et Société;;4;Chimie;2022;2021-22;2021;2021;0;0;0;5;2;3;1;1;0;1;0;0;0;wUBi9
586;École doctorale Sciences Humaines et Sociales;EDSHS;7;Sciences de la société;2022;2021-22;2021;2021;12;8;4;141;74;67;11;5;6;1;0;2;8;0RKVX
587;École doctorale Diversites, santé et développement en Amazonie;;5;Biologie, médecine et santé;2022;2021-22;2021;2021;6;6;0;20;14;6;7;4;3;1;1;4;1;V14tj
587;École doctorale Diversites, santé et développement en Amazonie;;7;Sciences de la société;2022;2021-22;2021;2021;5;3;2;16;10;6;0;0;0;0;0;0;0;V14tj
587;École doctorale Diversites, santé et développement en Amazonie;;10;Sciences agronomiques et écologiques;2022;2021-22;2021;2021;1;0;1;9;3;6;0;0;0;0;0;0;0;V14tj
588;École doctorale Milieu insulaire tropical : dynamiques de développement, sociétés, patrimoine et culture dans l'espace Caraïbes-Amériques;;6;Sciences humaines et humanités;2022;2021-22;2021;2021;14;11;3;87;61;26;8;5;3;0;0;1;7;4W5IO
591;École doctorale Physique, Sciences de l'Ingenieur, Materiaux, Énergie;PSIME;2;Physique;2022;2021-22;2021;2021;27;5;22;105;34;71;15;5;10;11;4;0;0;Hn5Om
591;École doctorale Physique, Sciences de l'Ingenieur, Materiaux, Énergie;PSIME;8;Sciences pour l'ingénieur;2022;2021-22;2021;2021;36;11;25;175;56;119;38;12;26;13;20;5;0;Hn5Om
596;École doctorale Matière, Molécules et Matériaux;ED 3M;9;Sciences et technologies de l'information et de la communication;2022;2021-22;2021;2021;13;5;8;28;7;21;8;1;7;2;4;1;1;77947
598;École doctorale Sciences de La Mer et du Littoral;SML;8;Sciences pour l'ingénieur;2022;2021-22;2021;2021;7;2;5;27;9;18;2;1;1;0;2;0;0;Smen6
598;École doctorale Sciences de La Mer et du Littoral;SML;10;Sciences agronomiques et écologiques;2022;2021-22;2021;2021;21;13;8;65;42;23;11;9;2;7;3;1;0;Smen6
602;École doctorale Sciences pour l'Ingénieur;SPI;8;Sciences pour l'ingénieur;2022;2021-22;2021;2021;116;32;84;492;148;344;136;45;91;71;58;7;0;8yWbu
605;École doctorale Biologie Santé;ED BS;5;Biologie, médecine et santé;2022;2021-22;2021;2021;141;75;66;548;304;244;153;80;73;73;60;18;2;w8CxU
606;École doctorale Chimie - Mécanique - Matériaux - Physique;C2MP;2;Physique;2022;2021-22;2021;2021;22;7;15;75;19;56;20;7;13;10;8;2;0;UkNR2
607;École doctorale Sciences et Ingénierie des Ressources Naturelles;SIReNA;3;Sciences de la terre et de l'univers, espace;2022;2021-22;2021;2021;23;7;16;77;26;51;17;9;8;4;11;1;1;vi9w2
607;École doctorale Sciences et Ingénierie des Ressources Naturelles;SIReNA;10;Sciences agronomiques et écologiques;2022;2021-22;2021;2021;34;23;11;112;59;53;32;17;15;11;17;4;0;vi9w2
608;École doctorale Sciences et Ingénierie des Molécules, des Produits, des Procédés et de l'Énergie;SIMPPÉ;8;Sciences pour l'ingénieur;2022;2021-22;2021;2021;55;19;36;207;79;128;38;16;22;20;16;2;0;TyNjM
610;École doctorale Sciences et Ingénierie des Systèmes, Mathématiques, Informatique;SISMI;9;Sciences et technologies de l'information et de la communication;2022;2021-22;2021;2021;24;6;18;111;23;88;20;5;15;11;4;5;0;dBCUB
613;École doctorale Sciences de la Société, Territoires, Sciences Economiques et de Gestion;SSTSEG;7;Sciences de la société;2022;2021-22;2021;2021;21;11;10;153;72;81;16;2;14;2;6;4;4;6eLRF
616;École doctorale Humanités et Langues;H&L;6;Sciences humaines et humanités;2022;2021-22;2021;2021;64;30;34;245;124;121;38;26;12;3;6;22;7;FYOlf
617;École doctorale Sciences de la Société : Territoires, Economie et Droit;SSTED;10;Sciences agronomiques et écologiques;2022;2021-22;2021;2021;0;0;0;1;0;1;0;0;0;0;0;0;0;Kl9ZX
619;École doctorale Sciences Fondamentales et Santé;SFS;1;Mathématiques et leurs interactions;2022;2021-22;2021;2021;1;0;1;6;1;5;2;1;1;2;0;0;0;JiZVW
619;École doctorale Sciences Fondamentales et Santé;SFS;3;Sciences de la terre et de l'univers, espace;2022;2021-22;2021;2021;2;0;2;4;1;3;2;1;1;0;2;0;0;JiZVW
619;École doctorale Sciences Fondamentales et Santé;SFS;4;Chimie;2022;2021-22;2021;2021;2;0;2;17;4;13;4;1;3;2;2;0;0;JiZVW
619;École doctorale Sciences Fondamentales et Santé;SFS;7;Sciences de la société;2022;2021-22;2021;2021;0;0;0;1;0;1;0;0;0;0;0;0;0;JiZVW
620;École doctorale Sciences du Numérique et de l'Ingénieur;SNI;9;Sciences et technologies de l'information et de la communication;2022;2021-22;2021;2021;6;2;4;45;10;35;6;2;4;0;4;2;0;Dr40w
626;École doctorale de l’Institut Polytechnique de Paris;;10;Sciences agronomiques et écologiques;2022;2021-22;2021;2021;0;0;0;1;1;0;0;0;0;0;0;0;0;DL5fO
630;École doctorale Droit, Economie et Management;DEM;6;Sciences humaines et humanités;2022;2021-22;2021;2021;4;3;1;13;7;6;0;0;0;0;0;0;0;78n8c
630;École doctorale Droit, Economie et Management;DEM;7;Sciences de la société;2022;2021-22;2021;2021;41;20;21;227;106;121;34;15;19;5;9;12;8;78n8c
634;École doctorale Sciences, Ingénierie, Environnement;SIE;6;Sciences humaines et humanités;2022;2021-22;2021;2021;0;0;0;2;1;1;0;0;0;0;0;0;0;TOc8f
7;École doctorale Georges Vedel - Droit public interne, science administrative et science politique;;7;Sciences de la société;2023;2022-23;2022;2022;20;11;9;140;61;79;19;7;12;2;4;6;7;Dw881
9;École doctorale Droit international, droit européen, relations internationales et droit comparé;;7;Sciences de la société;2023;2022-23;2022;2022;28;16;12;243;135;108;19;12;7;0;3;5;11;v1emR
31;École doctorale Pratiques et théories du sens;;7;Sciences de la société;2023;2022-23;2022;2022;9;6;3;81;53;28;9;6;3;0;1;4;4;1S466
47;École doctorale Physique;;3;Sciences de la terre et de l'univers, espace;2023;2022-23;2022;2022;11;3;8;53;12;41;8;4;4;5;3;0;0;8kNpd
52;École doctorale Physique et astrophysique de Lyon;PHAST;3;Sciences de la terre et de l'univers, espace;2023;2022-23;2022;2022;3;3;0;20;11;9;5;2;3;0;4;1;0;61XPb
60;École doctorale Territoires, temps, sociétés et développement;TTSD;7;Sciences de la société;2023;2022-23;2022;2022;17;12;5;97;59;38;9;4;5;1;2;1;5;fkIh6
62;École doctorale Sciences de la vie et de la santé;;4;Chimie;2023;2022-23;2022;2022;1;0;1;2;1;1;0;0;0;0;0;0;0;vZzE7
62;École doctorale Sciences de la vie et de la santé;;10;Sciences agronomiques et écologiques;2023;2022-23;2022;2022;0;0;0;5;2;3;0;0;0;0;0;0;0;vZzE7
77;École doctorale Informatique, automatique, électronique, électrotechnique, mathématiques;IAEM;9;Sciences et technologies de l'information et de la communication;2023;2022-23;2022;2022;62;25;37;259;78;181;69;15;54;29;32;7;1;TCHTA
88;École doctorale Droit et science politique;DSP;7;Sciences de la société;2023;2022-23;2022;2022;13;8;5;125;65;60;20;9;11;0;2;8;10;elnAJ
112;École doctorale Archéologie;;6;Sciences humaines et humanités;2023;2022-23;2022;2022;27;19;8;171;106;65;30;18;12;1;3;4;22;EvU7R
129;École doctorale Sciences de l'environnement d'Ile de France;SEIF;2;Physique;2023;2022-23;2022;2022;0;0;0;3;2;1;2;1;1;1;1;0;0;TnAPh
129;École doctorale Sciences de l'environnement d'Ile de France;SEIF;7;Sciences de la société;2023;2022-23;2022;2022;0;0;0;1;0;1;0;0;0;0;0;0;0;TnAPh
139;École doctorale Connaissance, langage, modélisation;CLM;2;Physique;2023;2022-23;2022;2022;0;0;0;0;0;0;1;0;1;1;0;0;0;1lxGH
139;École doctorale Connaissance, langage, modélisation;CLM;6;Sciences humaines et humanités;2023;2022-23;2022;2022;53;29;24;257;147;110;33;24;9;5;5;15;8;1lxGH
141;École doctorale Droit et science politique;DSP;7;Sciences de la société;2023;2022-23;2022;2022;45;24;21;300;148;152;24;11;13;3;1;9;11;CyNBf
146;École doctorale Galilée;GALILEE;1;Mathématiques et leurs interactions;2023;2022-23;2022;2022;9;3;6;34;9;25;14;0;14;6;7;1;0;71hqm
146;École doctorale Galilée;GALILEE;9;Sciences et technologies de l'information et de la communication;2023;2022-23;2022;2022;14;3;11;51;15;36;12;2;10;4;6;2;0;71hqm
151;École doctorale Biologie, santé, biotechnologies;;5;Biologie, médecine et santé;2023;2022-23;2022;2022;114;79;35;423;287;136;82;44;38;17;58;6;1;yP8w4
162;École doctorale Mécanique, énergétique, génie civil, acoustique;MEGA;8;Sciences pour l'ingénieur;2023;2022-23;2022;2022;61;14;47;352;90;262;99;34;65;38;57;4;0;7wCke
168;École doctorale Sciences chimiques et biologiques pour la santé;SCBS;5;Biologie, médecine et santé;2023;2022-23;2022;2022;135;85;50;470;266;204;99;58;41;34;55;9;1;8cEME
171;École doctorale Toulouse sciences économiques;TSE;7;Sciences de la société;2023;2022-23;2022;2022;18;3;15;90;23;67;16;4;12;0;1;12;3;Q5nNQ
173;École doctorale Sciences de l'univers, de l'environnement et de l'espace;SDU2E;3;Sciences de la terre et de l'univers, espace;2023;2022-23;2022;2022;67;28;39;251;101;150;60;20;40;32;26;2;0;R0Z9c
178;École doctorale Sciences fondamentales;;3;Sciences de la terre et de l'univers, espace;2023;2022-23;2022;2022;12;5;7;44;16;28;5;0;5;0;5;0;0;1AiR7
182;École doctorale Physique et chimie-physique;;3;Sciences de la terre et de l'univers, espace;2023;2022-23;2022;2022;7;1;6;12;3;9;3;0;3;3;0;0;0;3My6I
188;École doctorale Histoire moderne et contemporaine;;6;Sciences humaines et humanités;2023;2022-23;2022;2022;25;10;15;148;66;82;26;16;10;4;6;5;11;RSZ7F
206;École doctorale Chimie : chimie, procédés, environnement;;4;Chimie;2023;2022-23;2022;2022;79;39;40;323;150;173;93;43;50;57;33;2;1;m0UhD
209;École doctorale Sciences physiques et de L'ingénieur;SPI;2;Physique;2023;2022-23;2022;2022;29;8;21;101;24;77;31;6;25;14;14;3;0;tZcIZ
211;École doctorale Sciences exactes et leurs applications;ED SEA;8;Sciences pour l'ingénieur;2023;2022-23;2022;2022;17;2;15;71;20;51;14;5;9;8;6;0;0;1G1iC
216;École doctorale Ingénierie pour la santé, la cognition, l'environnement;EDISCE;2;Physique;2023;2022-23;2022;2022;1;1;0;1;1;0;0;0;0;0;0;0;0;fPs1t
224;École doctorale Cognition, langage, interaction;;9;Sciences et technologies de l'information et de la communication;2023;2022-23;2022;2022;14;4;10;50;18;32;4;1;3;0;2;0;2;7v43e
227;École doctorale Sciences de la nature et de l'homme;;5;Biologie, médecine et santé;2023;2022-23;2022;2022;35;15;20;109;59;50;15;7;8;3;8;4;0;xiDA5
242;École doctorale Économie - Gestion - Normandie;;7;Sciences de la société;2023;2022-23;2022;2022;14;8;6;67;27;40;6;2;4;1;2;3;0;z35ku
251;École doctorale Sciences de l'environnement;;3;Sciences de la terre et de l'univers, espace;2023;2022-23;2022;2022;23;16;7;92;52;40;23;9;14;3;17;3;0;VR28y
275;École doctorale Sciences de gestion;EDSG;6;Sciences humaines et humanités;2023;2022-23;2022;2022;0;0;0;9;5;4;0;0;0;0;0;0;0;6QC4I
286;École doctorale de l'Ehess;;6;Sciences humaines et humanités;2023;2022-23;2022;2022;70;30;40;418;218;200;57;26;31;4;7;13;33;2S146
304;École doctorale Sciences et environnements;;6;Sciences humaines et humanités;2023;2022-23;2022;2022;9;6;3;26;18;8;3;2;1;1;0;1;1;2ywZn
323;École doctorale Génie électrique, électronique et télécommunications;GEET;2;Physique;2023;2022-23;2022;2022;10;3;7;25;6;19;1;1;0;0;0;1;0;arcz6
326;École doctorale Comportement, langage, éducation, socialisation, cognition;CLESCO;8;Sciences pour l'ingénieur;2023;2022-23;2022;2022;1;0;1;1;0;1;1;0;1;1;0;0;0;nWIlG
327;École doctorale Temps, espaces, sociétés, cultures;TESC;3;Sciences de la terre et de l'univers, espace;2023;2022-23;2022;2022;1;0;1;4;2;2;2;1;1;1;0;1;0;IjgiJ
328;École doctorale Arts, lettres, langues, philosophie et communication;ALLPH@;9;Sciences et technologies de l'information et de la communication;2023;2022-23;2022;2022;6;3;3;31;18;13;4;2;2;1;2;0;1;xLxMh
341;École doctorale Évolution, écosystèmes, microbiologie, modélisation;E2M2;10;Sciences agronomiques et écologiques;2023;2022-23;2022;2022;16;7;9;74;45;29;18;11;7;7;8;3;0;J83I0
352;École doctorale Physique et sciences de la matière;;2;Physique;2023;2022-23;2022;2022;85;23;62;261;77;184;66;24;42;35;30;1;0;fb5YC
355;École doctorale Espaces, cultures, sociétés;;7;Sciences de la société;2023;2022-23;2022;2022;6;2;4;70;37;33;6;4;2;0;1;1;4;2kMf5
356;École doctorale Cognition, langage, éducation;;6;Sciences humaines et humanités;2023;2022-23;2022;2022;51;39;12;245;158;87;35;26;9;4;15;12;4;55Cpz
361;École doctorale Sciences et Technologies;ED ST;9;Sciences et technologies de l'information et de la communication;2023;2022-23;2022;2022;13;5;8;72;27;45;16;7;9;10;6;0;0;cOUmL
364;École doctorale Sciences fondamentales et appliquées;EDSFA;4;Chimie;2023;2022-23;2022;2022;9;5;4;64;29;35;13;5;8;3;10;0;0;E483q
377;École doctorale Environnement et société;;4;Chimie;2023;2022-23;2022;2022;0;0;0;6;1;5;3;1;2;0;2;1;0;ZMG5u
377;École doctorale Environnement et société;;5;Biologie, médecine et santé;2023;2022-23;2022;2022;1;1;0;7;7;0;2;0;2;1;1;0;0;ZMG5u
377;École doctorale Environnement et société;;7;Sciences de la société;2023;2022-23;2022;2022;9;7;2;34;24;10;5;3;2;1;0;2;2;ZMG5u
377;École doctorale Environnement et société;;8;Sciences pour l'ingénieur;2023;2022-23;2022;2022;5;1;4;13;4;9;0;0;0;0;0;0;0;ZMG5u
377;École doctorale Environnement et société;;10;Sciences agronomiques et écologiques;2023;2022-23;2022;2022;0;0;0;7;5;2;2;1;1;0;2;0;0;ZMG5u
395;École doctorale Milieux, cultures et sociétés du passé et du présent;MCSPP;6;Sciences humaines et humanités;2023;2022-23;2022;2022;34;21;13;198;133;65;24;12;12;2;4;12;6;2quEb
401;École doctorale Sciences sociales;;6;Sciences humaines et humanités;2023;2022-23;2022;2022;24;16;8;139;76;63;18;7;11;1;1;5;11;raQ7K
417;École doctorale Sciences et Ingénierie;S&I;5;Biologie, médecine et santé;2023;2022-23;2022;2022;1;1;0;9;5;4;2;2;0;0;2;0;0;SSBvE
432;École doctorale Sciences des métiers de l'ingénieur;SMI;5;Biologie, médecine et santé;2023;2022-23;2022;2022;0;0;0;0;0;0;1;0;1;0;1;0;0;nSsHB
433;École doctorale Concepts et langages;;6;Sciences humaines et humanités;2023;2022-23;2022;2022;61;38;23;191;113;78;46;26;20;7;9;19;11;v8q34
446;École doctorale Biologie - Santé;EDBSL;6;Sciences humaines et humanités;2023;2022-23;2022;2022;0;0;0;5;1;4;1;0;1;0;1;0;0;4iEUF
459;École doctorale Sciences chimiques Balard;;5;Biologie, médecine et santé;2023;2022-23;2022;2022;0;0;0;2;1;1;4;2;2;3;1;0;0;YFs2W
468;École doctorale Mécanique, énergétique, génie civil, procédés;MEGEP;8;Sciences pour l'ingénieur;2023;2022-23;2022;2022;136;44;92;481;133;348;120;38;82;36;73;11;0;4XUTB
469;École doctorale du Pacifique;EDP;3;Sciences de la terre et de l'univers, espace;2023;2022-23;2022;2022;2;1;1;4;3;1;0;0;0;0;0;0;0;t9Z2n
469;École doctorale du Pacifique;EDP;8;Sciences pour l'ingénieur;2023;2022-23;2022;2022;1;0;1;5;1;4;0;0;0;0;0;0;0;t9Z2n
469;École doctorale du Pacifique;EDP;9;Sciences et technologies de l'information et de la communication;2023;2022-23;2022;2022;1;0;1;4;1;3;1;0;1;0;0;1;0;t9Z2n
472;École doctorale de l'EPHE;;4;Chimie;2023;2022-23;2022;2022;0;0;0;0;0;0;1;1;0;0;0;1;0;27zK4
472;École doctorale de l'EPHE;;10;Sciences agronomiques et écologiques;2023;2022-23;2022;2022;9;4;5;20;12;8;1;1;0;0;1;0;0;27zK4
474;École doctorale Interdisciplinaire européenne frontières du vivant;FDV;4;Chimie;2023;2022-23;2022;2022;0;0;0;0;0;0;1;1;0;1;0;0;0;E727j
481;École doctorale Sciences sociales et humanités;SSH;7;Sciences de la société;2023;2022-23;2022;2022;26;14;12;149;65;84;18;9;9;3;7;4;4;E3z5j
482;École doctorale Sciences de la matière;SDM;2;Physique;2023;2022-23;2022;2022;30;9;21;88;24;64;16;7;9;6;10;0;0;kmeZ4
484;École doctorale Lettres, langues, linguistique, arts;3LA;6;Sciences humaines et humanités;2023;2022-23;2022;2022;69;41;28;427;267;160;48;31;17;6;4;14;24;BlCQD
488;École doctorale Sciences, ingénierie, santé;SIS;1;Mathématiques et leurs interactions;2023;2022-23;2022;2022;2;0;2;16;2;14;2;1;1;0;1;1;0;Fy2lK
493;École doctorale Erasme;;7;Sciences de la société;2023;2022-23;2022;2022;32;20;12;156;75;81;28;13;15;4;4;9;11;FPW4T
497;École doctorale Normande de Biologie Intégrative, Santé, Environnement;Ed NBISE;4;Chimie;2023;2022-23;2022;2022;0;0;0;2;2;0;0;0;0;0;0;0;0;0D9Je
510;École doctorale Ingénierie - Matériaux, mécanique, environnement, énergétique, procédés, production;IMEP2;8;Sciences pour l'ingénieur;2023;2022-23;2022;2022;118;39;79;434;136;298;109;37;72;50;54;5;0;Ce7NF
512;École doctorale Informatique et mathématiques;InfoMaths;1;Mathématiques et leurs interactions;2023;2022-23;2022;2022;16;5;11;24;10;14;8;0;8;7;1;0;0;t86bi
531;École doctorale Sciences, ingénierie et environnement;SIE;3;Sciences de la terre et de l'univers, espace;2023;2022-23;2022;2022;7;4;3;45;22;23;9;5;4;2;7;0;0;b5BYq
531;École doctorale Sciences, ingénierie et environnement;SIE;10;Sciences agronomiques et écologiques;2023;2022-23;2022;2022;14;7;7;31;17;14;1;0;1;1;0;0;0;b5BYq
536;École doctorale Sciences et agrosciences;;10;Sciences agronomiques et écologiques;2023;2022-23;2022;2022;5;4;1;36;17;19;12;8;4;4;6;2;0;pHfqe
537;École doctorale Culture et patrimoine;C&P;7;Sciences de la société;2023;2022-23;2022;2022;7;4;3;18;11;7;0;0;0;0;0;0;0;GxI4a
540;"École doctorale École transdisciplinaire ""lettres/sciences""";;1;Mathématiques et leurs interactions;2023;2022-23;2022;2022;0;0;0;1;0;1;0;0;0;0;0;0;0;tWWw7
540;"École doctorale École transdisciplinaire ""lettres/sciences""";;4;Chimie;2023;2022-23;2022;2022;0;0;0;1;0;1;0;0;0;0;0;0;0;tWWw7
540;"École doctorale École transdisciplinaire ""lettres/sciences""";;6;Sciences humaines et humanités;2023;2022-23;2022;2022;42;21;21;199;92;107;39;16;23;3;7;15;14;tWWw7
540;"École doctorale École transdisciplinaire ""lettres/sciences""";;7;Sciences de la société;2023;2022-23;2022;2022;1;1;0;15;7;8;3;2;1;0;1;1;1;tWWw7
543;École doctorale de Dauphine;;9;Sciences et technologies de l'information et de la communication;2023;2022-23;2022;2022;18;9;9;48;15;33;14;3;11;3;10;1;0;u8w6A
545;École doctorale Sociétés, politique et santé publique;SP2;5;Biologie, médecine et santé;2023;2022-23;2022;2022;24;12;12;96;61;35;23;12;11;9;13;1;0;IAKR4
548;École doctorale Mer et Sciences;;1;Mathématiques et leurs interactions;2023;2022-23;2022;2022;5;2;3;12;4;8;5;3;2;2;2;0;1;QX0fS
548;École doctorale Mer et Sciences;;2;Physique;2023;2022-23;2022;2022;0;0;0;1;0;1;1;0;1;1;0;0;0;QX0fS
548;École doctorale Mer et Sciences;;8;Sciences pour l'ingénieur;2023;2022-23;2022;2022;4;3;1;8;3;5;0;0;0;0;0;0;0;QX0fS
549;École doctorale Santé, Sciences Biologiques et Chimie du Vivant;SSBCV;5;Biologie, médecine et santé;2023;2022-23;2022;2022;52;27;25;193;109;84;53;31;22;25;25;3;0;B9ggO
549;École doctorale Santé, Sciences Biologiques et Chimie du Vivant;SSBCV;10;Sciences agronomiques et écologiques;2023;2022-23;2022;2022;0;0;0;7;6;1;2;0;2;0;2;0;0;B9ggO
551;École doctorale Mathématiques, Informatique, Physique Théorique et Ingénierie des Systèmes;MIPTIS;9;Sciences et technologies de l'information et de la communication;2023;2022-23;2022;2022;13;2;11;80;18;62;15;3;12;5;7;3;0;Mpudz
552;École doctorale Énergie - Matériaux - Sciences de la Terre et de l'Univers;EMTSU;9;Sciences et technologies de l'information et de la communication;2023;2022-23;2022;2022;2;1;1;2;1;1;0;0;0;0;0;0;0;NTZhw
562;École doctorale Bio Sorbonne Paris Cité;BioSPC;5;Biologie, médecine et santé;2023;2022-23;2022;2022;171;108;63;487;372;115;139;90;49;41;70;28;0;4Yju6
570;École doctorale Santé Publique;EDSP;1;Mathématiques et leurs interactions;2023;2022-23;2022;2022;0;0;0;4;1;3;1;0;1;1;0;0;0;9lgE4
570;École doctorale Santé Publique;EDSP;7;Sciences de la société;2023;2022-23;2022;2022;0;0;0;2;0;2;0;0;0;0;0;0;0;9lgE4
573;École doctorale Interfaces : Approches Interdisciplinaires, Fondements, Applications et Innovation;ED INTERFACES;1;Mathématiques et leurs interactions;2023;2022-23;2022;2022;4;1;3;24;6;18;2;0;2;1;0;1;0;gG820
573;École doctorale Interfaces : Approches Interdisciplinaires, Fondements, Applications et Innovation;ED INTERFACES;10;Sciences agronomiques et écologiques;2023;2022-23;2022;2022;0;0;0;1;1;0;0;0;0;0;0;0;0;gG820
575;École doctorale Electrical, Optical, Bio : Physics and Engineering;EOBE;2;Physique;2023;2022-23;2022;2022;0;0;0;70;30;40;24;9;15;8;12;3;1;dfhyn
576;École doctorale Particules, Hadrons, Énergie, Noyau, Instrumentation, Imagerie, Cosmos et Simulation;PHENIICS;1;Mathématiques et leurs interactions;2023;2022-23;2022;2022;0;0;0;0;0;0;1;1;0;1;0;0;0;qC4rf
576;École doctorale Particules, Hadrons, Énergie, Noyau, Instrumentation, Imagerie, Cosmos et Simulation;PHENIICS;4;Chimie;2023;2022-23;2022;2022;0;0;0;0;0;0;3;1;2;2;1;0;0;qC4rf
577;École doctorale Structure et dynamique des systèmes vivants;SDSV;2;Physique;2023;2022-23;2022;2022;0;0;0;1;0;1;0;0;0;0;0;0;0;4bsxJ
577;École doctorale Structure et dynamique des systèmes vivants;SDSV;10;Sciences agronomiques et écologiques;2023;2022-23;2022;2022;2;0;2;8;3;5;3;1;2;0;3;0;0;4bsxJ
579;École doctorale Sciences mécaniques et energétiques, matériaux et géosciences;SMEMaG;1;Mathématiques et leurs interactions;2023;2022-23;2022;2022;0;0;0;1;0;1;0;0;0;0;0;0;0;atMj7
581;École doctorale Agriculture, alimentation, biologie, environnement, santé;ABIES;1;Mathématiques et leurs interactions;2023;2022-23;2022;2022;1;0;1;3;1;2;3;2;1;3;0;0;0;c1x56
581;École doctorale Agriculture, alimentation, biologie, environnement, santé;ABIES;6;Sciences humaines et humanités;2023;2022-23;2022;2022;4;1;3;22;11;11;1;1;0;0;1;0;0;c1x56
581;École doctorale Agriculture, alimentation, biologie, environnement, santé;ABIES;7;Sciences de la société;2023;2022-23;2022;2022;16;11;5;41;26;15;7;2;5;3;2;2;0;c1x56
583;École doctorale Risques et Société;;6;Sciences humaines et humanités;2023;2022-23;2022;2022;3;2;1;22;13;9;4;2;2;1;3;0;0;wUBi9
583;École doctorale Risques et Société;;9;Sciences et technologies de l'information et de la communication;2023;2022-23;2022;2022;3;0;3;3;0;3;0;0;0;0;0;0;0;wUBi9
584;École doctorale Biodiversité, Agriculture, Alimentation, Environnement, Terre, Eau;GAIA;5;Biologie, médecine et santé;2023;2022-23;2022;2022;48;33;15;133;90;43;18;10;8;8;9;1;0;F1h5f
585;École doctorale Sciences, Technologie,  Sante;EDSTS;4;Chimie;2023;2022-23;2022;2022;27;11;16;86;39;47;18;8;10;13;3;2;0;NM3Dl
585;École doctorale Sciences, Technologie,  Sante;EDSTS;5;Biologie, médecine et santé;2023;2022-23;2022;2022;38;16;22;101;57;44;24;15;9;10;9;5;0;NM3Dl
585;École doctorale Sciences, Technologie,  Sante;EDSTS;9;Sciences et technologies de l'information et de la communication;2023;2022-23;2022;2022;12;5;7;62;17;45;26;9;17;12;12;2;0;NM3Dl
587;École doctorale Diversites, santé et développement en Amazonie;;4;Chimie;2023;2022-23;2022;2022;2;1;1;4;2;2;0;0;0;0;0;0;0;V14tj
588;École doctorale Milieu insulaire tropical : dynamiques de développement, sociétés, patrimoine et culture dans l'espace Caraïbes-Amériques;;6;Sciences humaines et humanités;2023;2022-23;2022;2022;0;0;0;0;0;0;6;4;2;1;0;1;4;4W5IO
589;École doctorale Milieu insulaire tropical à risques : protection, valorisation , santé et développement;;4;Chimie;2023;2022-23;2022;2022;0;0;0;0;0;0;2;1;1;0;1;1;0;2cqi3
591;École doctorale Physique, Sciences de l'Ingenieur, Materiaux, Énergie;PSIME;8;Sciences pour l'ingénieur;2023;2022-23;2022;2022;48;10;38;194;63;131;40;12;28;15;21;4;0;Hn5Om
596;École doctorale Matière, Molécules et Matériaux;ED 3M;8;Sciences pour l'ingénieur;2023;2022-23;2022;2022;0;0;0;0;0;0;1;0;1;0;1;0;0;77947
598;École doctorale Sciences de La Mer et du Littoral;SML;8;Sciences pour l'ingénieur;2023;2022-23;2022;2022;3;0;3;14;3;11;10;1;9;2;6;2;0;Smen6
599;École doctorale Droit et Science Politique;DSP;7;Sciences de la société;2023;2022-23;2022;2022;18;9;9;157;77;80;16;12;4;0;2;3;11;6rwtT
601;École doctorale Mathématiques et Sciences et Technologies de l'information et de la Communication;MathSTIC;9;Sciences et technologies de l'information et de la communication;2023;2022-23;2022;2022;109;20;89;447;95;352;111;33;78;60;42;9;0;3Ue20
604;École doctorale Sociétés, Temps, Territoires;STT;7;Sciences de la société;2023;2022-23;2022;2022;20;13;7;95;46;49;12;6;6;1;2;5;4;SZI5T
606;École doctorale Chimie - Mécanique - Matériaux - Physique;C2MP;2;Physique;2023;2022-23;2022;2022;15;6;9;72;20;52;17;3;14;5;11;1;0;UkNR2
608;École doctorale Sciences et Ingénierie des Molécules, des Produits, des Procédés et de l'Énergie;SIMPPÉ;10;Sciences agronomiques et écologiques;2023;2022-23;2022;2022;1;0;1;1;0;1;0;0;0;0;0;0;0;TyNjM
609;École doctorale Sciences et Ingénierie des Matériaux, Mécanique, Énergétique -;SIMME;4;Chimie;2023;2022-23;2022;2022;0;0;0;0;0;0;3;2;1;2;1;0;0;N4Rjy
613;École doctorale Sciences de la Société, Territoires, Sciences Economiques et de Gestion;SSTSEG;7;Sciences de la société;2023;2022-23;2022;2022;0;0;0;0;0;0;14;6;8;1;3;5;5;6eLRF
616;École doctorale Humanités et Langues;H&L;5;Biologie, médecine et santé;2023;2022-23;2022;2022;0;0;0;6;2;4;1;1;0;1;0;0;0;FYOlf
617;École doctorale Sciences de la Société : Territoires, Economie et Droit;SSTED;3;Sciences de la terre et de l'univers, espace;2023;2022-23;2022;2022;0;0;0;3;1;2;0;0;0;0;0;0;0;Kl9ZX
617;École doctorale Sciences de la Société : Territoires, Economie et Droit;SSTED;8;Sciences pour l'ingénieur;2023;2022-23;2022;2022;0;0;0;0;0;0;1;0;1;0;1;0;0;Kl9ZX
618;École doctorale EUCLIDE;;8;Sciences pour l'ingénieur;2023;2022-23;2022;2022;10;2;8;36;10;26;7;2;5;4;3;0;0;qveTN
618;École doctorale EUCLIDE;;9;Sciences et technologies de l'information et de la communication;2023;2022-23;2022;2022;5;0;5;36;10;26;16;4;12;7;6;3;0;qveTN
619;École doctorale Sciences Fondamentales et Santé;SFS;6;Sciences humaines et humanités;2023;2022-23;2022;2022;0;0;0;1;0;1;0;0;0;0;0;0;0;JiZVW
623;École doctorale Savoir, Sciences, Éducation;SSE;6;Sciences humaines et humanités;2023;2022-23;2022;2022;18;8;10;66;39;27;9;5;4;2;1;4;2;98lMD
626;École doctorale de l’Institut Polytechnique de Paris;;1;Mathématiques et leurs interactions;2023;2022-23;2022;2022;18;3;15;50;7;43;6;0;6;6;0;0;0;DL5fO
626;École doctorale de l’Institut Polytechnique de Paris;;10;Sciences agronomiques et écologiques;2023;2022-23;2022;2022;0;0;0;1;1;0;0;0;0;0;0;0;0;DL5fO
628;École doctorale Arts Humanités et Sciences sociales;AHSS;6;Sciences humaines et humanités;2023;2022-23;2022;2022;41;24;17;214;118;96;14;8;6;2;5;4;3;vwwRK
633;École doctorale Cultures, Sociétés, Territoires;CST;3;Sciences de la terre et de l'univers, espace;2023;2022-23;2022;2022;4;1;3;7;2;5;0;0;0;0;0;0;0;54818
634;École doctorale Sciences, Ingénierie, Environnement;SIE;10;Sciences agronomiques et écologiques;2023;2022-23;2022;2022;3;3;0;9;5;4;1;1;0;0;1;0;0;TOc8f
635;École doctorale Polytechnique Hauts-de-France;PHF;9;Sciences et technologies de l'information et de la communication;2023;2022-23;2022;2022;22;6;16;77;24;53;15;6;9;3;8;3;1;p2m23
636;;;4;Chimie;2023;2022-23;2022;2022;5;2;3;15;9;6;2;0;2;0;2;0;0;
638;École doctorale Science de la Matière, des Molécules et Matériaux;S3M;9;Sciences et technologies de l'information et de la communication;2023;2022-23;2022;2022;0;0;0;1;1;0;4;1;3;1;3;0;0;7artx
639;École doctorale Droit et Science politique - Pays de la Loire;DSP PDL;7;Sciences de la société;2023;2022-23;2022;2022;21;11;10;184;82;102;17;7;10;0;1;5;11;obljx
642;École doctorale Végétal, Animal, Aliment, Mer, Environnement;VAAME;3;Sciences de la terre et de l'univers, espace;2023;2022-23;2022;2022;1;0;1;11;4;7;3;2;1;0;3;0;0;jcs9y
648;;;4;Chimie;2023;2022-23;2022;2022;0;0;0;2;1;1;0;0;0;0;0;0;0;
649;;;3;Sciences de la terre et de l'univers, espace;2023;2022-23;2022;2022;6;3;3;15;8;7;0;0;0;0;0;0;0;
649;;;5;Biologie, médecine et santé;2023;2022-23;2022;2022;20;12;8;80;38;42;0;0;0;0;0;0;0;
653;École doctorale Sciences et Ingénierie;S&I;2;Physique;2023;2022-23;2022;2022;0;0;0;0;0;0;3;0;3;3;0;0;0;vpw2d
654;École doctorale Littératures, Sciences Humaines et Sociales;SHS;6;Sciences humaines et humanités;2023;2022-23;2022;2022;24;10;14;121;71;50;9;7;2;5;1;3;0;k2ywn
655;École doctorale Gouvernance des Institutions et des Organisations;;6;Sciences humaines et humanités;2023;2022-23;2022;2022;1;0;1;3;0;3;0;0;0;0;0;0;0;izw4r
8;École doctorale Histoire du droit, philosophie du droit et sociologie du droit;;7;Sciences de la société;2020;2019-20;2019;2019;11;5;6;85;34;51;2;0;2;;;;;pGSed
9;École doctorale Droit international, droit européen, relations internationales et droit comparé;;7;Sciences de la société;2020;2019-20;2019;2019;41;20;21;269;162;107;32;19;13;;;;;v1emR
20;École doctorale Civilisations, cultures, littératures et sociétés;;6;Sciences humaines et humanités;2020;2019-20;2019;2019;53;34;19;231;154;77;25;13;12;;;;;agjNi
34;École doctorale Matériaux;;2;Physique;2020;2019-20;2019;2019;12;4;8;69;29;40;12;6;6;;;;;1Iufh
39;École doctorale Mathématiques et Informatique;EDMIB;9;Sciences et technologies de l'information et de la communication;2020;2019-20;2019;2019;35;6;29;111;23;88;27;4;23;;;;;TBj2X
40;École doctorale Sciences chimiques;EDSC;5;Biologie, médecine et santé;2020;2019-20;2019;2019;1;1;0;8;4;4;0;0;0;;;;;wde3D
40;École doctorale Sciences chimiques;EDSC;8;Sciences pour l'ingénieur;2020;2019-20;2019;2019;1;0;1;2;1;1;0;0;0;;;;;wde3D
47;École doctorale Physique;;8;Sciences pour l'ingénieur;2020;2019-20;2019;2019;3;0;3;10;3;7;3;0;3;;;;;8kNpd
50;École doctorale Langues, littératures et sciences humaines;LLSH;9;Sciences et technologies de l'information et de la communication;2020;2019-20;2019;2019;10;4;6;48;23;25;3;1;2;;;;;8THzQ
62;École doctorale Sciences de la vie et de la santé;;2;Physique;2020;2019-20;2019;2019;0;0;0;2;1;1;0;0;0;;;;;vZzE7
62;École doctorale Sciences de la vie et de la santé;;5;Biologie, médecine et santé;2020;2019-20;2019;2019;179;108;71;690;388;302;159;97;62;;;;;vZzE7
62;École doctorale Sciences de la vie et de la santé;;10;Sciences agronomiques et écologiques;2020;2019-20;2019;2019;2;0;2;3;1;2;1;0;1;;;;;vZzE7
72;École doctorale Sciences pour l'ingénieur;SPI;8;Sciences pour l'ingénieur;2020;2019-20;2019;2019;58;20;38;257;78;179;67;21;46;;;;;47QPx
77;École doctorale Informatique, automatique, électronique, électrotechnique, mathématiques;IAEM;1;Mathématiques et leurs interactions;2020;2019-20;2019;2019;16;2;14;54;11;43;8;1;7;;;;;TCHTA
104;École doctorale Sciences de la matière, du rayonnement et de l'environnement;SMRE;6;Sciences humaines et humanités;2020;2019-20;2019;2019;0;0;0;2;1;1;1;0;1;;;;;Q5iFz
104;École doctorale Sciences de la matière, du rayonnement et de l'environnement;SMRE;9;Sciences et technologies de l'information et de la communication;2020;2019-20;2019;2019;0;0;0;1;0;1;0;0;0;;;;;Q5iFz
120;École doctorale Littérature française et comparée;;6;Sciences humaines et humanités;2020;2019-20;2019;2019;42;30;12;236;171;65;23;17;6;;;;;3ULpe
129;École doctorale Sciences de l'environnement d'Ile de France;SEIF;4;Chimie;2020;2019-20;2019;2019;4;2;2;4;2;2;0;0;0;;;;;TnAPh
132;École doctorale Sciences du langage;;6;Sciences humaines et humanités;2020;2019-20;2019;2019;0;0;0;0;0;0;5;4;1;;;;;5AUF1
139;École doctorale Connaissance, langage, modélisation;CLM;7;Sciences de la société;2020;2019-20;2019;2019;4;0;4;21;4;17;5;3;2;;;;;1lxGH
141;École doctorale Droit et science politique;DSP;7;Sciences de la société;2020;2019-20;2019;2019;60;24;36;304;145;159;32;19;13;;;;;CyNBf
146;École doctorale Galilée;GALILEE;4;Chimie;2020;2019-20;2019;2019;5;2;3;13;5;8;2;2;0;;;;;71hqm
146;École doctorale Galilée;GALILEE;8;Sciences pour l'ingénieur;2020;2019-20;2019;2019;11;3;8;38;14;24;8;5;3;;;;;71hqm
158;École doctorale Cerveau, cognition, comportement;3C;6;Sciences humaines et humanités;2020;2019-20;2019;2019;18;6;12;65;28;37;14;10;4;;;;;Il62F
160;École doctorale Électronique, électrotechnique, automatique;EEA;9;Sciences et technologies de l'information et de la communication;2020;2019-20;2019;2019;31;7;24;124;29;95;23;5;18;;;;;EgfMQ
173;École doctorale Sciences de l'univers, de l'environnement et de l'espace;SDU2E;10;Sciences agronomiques et écologiques;2020;2019-20;2019;2019;7;3;4;27;14;13;7;3;4;;;;;R0Z9c
178;École doctorale Sciences fondamentales;;5;Biologie, médecine et santé;2020;2019-20;2019;2019;0;0;0;0;0;0;1;1;0;;;;;1AiR7
184;École doctorale Mathématiques et informatique de Marseille;;1;Mathématiques et leurs interactions;2020;2019-20;2019;2019;30;7;23;87;24;63;28;6;22;;;;;DDObG
205;École doctorale Interdisciplinaire Sciences-Santé;EDISS;7;Sciences de la société;2020;2019-20;2019;2019;0;0;0;1;1;0;0;0;0;;;;;69W38
205;École doctorale Interdisciplinaire Sciences-Santé;EDISS;9;Sciences et technologies de l'information et de la communication;2020;2019-20;2019;2019;3;2;1;10;4;6;0;0;0;;;;;69W38
211;École doctorale Sciences exactes et leurs applications;ED SEA;1;Mathématiques et leurs interactions;2020;2019-20;2019;2019;10;5;5;29;11;18;5;2;3;;;;;1G1iC
211;École doctorale Sciences exactes et leurs applications;ED SEA;3;Sciences de la terre et de l'univers, espace;2020;2019-20;2019;2019;9;2;7;20;4;16;2;0;2;;;;;1G1iC
211;École doctorale Sciences exactes et leurs applications;ED SEA;9;Sciences et technologies de l'information et de la communication;2020;2019-20;2019;2019;4;0;4;24;5;19;6;2;4;;;;;1G1iC
216;École doctorale Ingénierie pour la santé, la cognition, l'environnement;EDISCE;3;Sciences de la terre et de l'univers, espace;2020;2019-20;2019;2019;0;0;0;1;0;1;0;0;0;;;;;fPs1t
218;École doctorale Chimie et sciences du vivant;EDCSV;4;Chimie;2020;2019-20;2019;2019;32;13;19;107;45;62;27;14;13;;;;;8bcJh
220;École doctorale Électronique, électrotechnique, automatique, traitement du signal;EEATS;9;Sciences et technologies de l'information et de la communication;2020;2019-20;2019;2019;49;16;33;156;34;122;41;11;30;;;;;IxEaw
222;École doctorale Sciences chimiques;EDSC;5;Biologie, médecine et santé;2020;2019-20;2019;2019;1;0;1;8;2;6;5;2;3;;;;;AdU8Q
224;École doctorale Cognition, langage, interaction;;9;Sciences et technologies de l'information et de la communication;2020;2019-20;2019;2019;1;1;0;9;3;6;3;2;1;;;;;7v43e
227;École doctorale Sciences de la nature et de l'homme;;6;Sciences humaines et humanités;2020;2019-20;2019;2019;10;5;5;45;23;22;14;8;6;;;;;xiDA5
250;École doctorale Sciences chimiques;;4;Chimie;2020;2019-20;2019;2019;35;16;19;122;53;69;22;10;12;;;;;O0Fav
280;École doctorale Philosophie;;6;Sciences humaines et humanités;2020;2019-20;2019;2019;58;23;35;260;101;159;28;10;18;;;;;kJxnm
305;École doctorale Énergie et environnement;E2;3;Sciences de la terre et de l'univers, espace;2020;2019-20;2019;2019;4;1;3;13;7;6;2;2;0;;;;;Kbt8I
309;École doctorale Systèmes;EDSYS;9;Sciences et technologies de l'information et de la communication;2020;2019-20;2019;2019;27;5;22;99;22;77;21;4;17;;;;;8TT4b
323;École doctorale Génie électrique, électronique et télécommunications;GEET;5;Biologie, médecine et santé;2020;2019-20;2019;2019;3;2;1;5;4;1;4;1;3;;;;;arcz6
326;École doctorale Comportement, langage, éducation, socialisation, cognition;CLESCO;5;Biologie, médecine et santé;2020;2019-20;2019;2019;7;3;4;18;8;10;1;0;1;;;;;nWIlG
326;École doctorale Comportement, langage, éducation, socialisation, cognition;CLESCO;7;Sciences de la société;2020;2019-20;2019;2019;5;4;1;7;6;1;0;0;0;;;;;nWIlG
326;École doctorale Comportement, langage, éducation, socialisation, cognition;CLESCO;9;Sciences et technologies de l'information et de la communication;2020;2019-20;2019;2019;0;0;0;2;1;1;0;0;0;;;;;nWIlG
327;École doctorale Temps, espaces, sociétés, cultures;TESC;5;Biologie, médecine et santé;2020;2019-20;2019;2019;0;0;0;5;3;2;0;0;0;;;;;IjgiJ
327;École doctorale Temps, espaces, sociétés, cultures;TESC;8;Sciences pour l'ingénieur;2020;2019-20;2019;2019;1;1;0;4;2;2;0;0;0;;;;;IjgiJ
340;École doctorale Biologie moléculaire, intégrative et cellulaire;BMIC;5;Biologie, médecine et santé;2020;2019-20;2019;2019;63;36;27;273;159;114;63;42;21;;;;;db7xq
352;École doctorale Physique et sciences de la matière;;2;Physique;2020;2019-20;2019;2019;68;26;42;244;80;164;85;23;62;;;;;fb5YC
364;École doctorale Sciences fondamentales et appliquées;EDSFA;3;Sciences de la terre et de l'univers, espace;2020;2019-20;2019;2019;23;9;14;68;17;51;7;2;5;;;;;E483q
372;École doctorale Sciences économiques et de gestion;;7;Sciences de la société;2020;2019-20;2019;2019;34;13;21;166;91;75;23;6;17;;;;;JK63A
377;École doctorale Environnement et société;;8;Sciences pour l'ingénieur;2020;2019-20;2019;2019;3;2;1;6;4;2;3;0;3;;;;;ZMG5u
377;École doctorale Environnement et société;;10;Sciences agronomiques et écologiques;2020;2019-20;2019;2019;3;3;0;8;4;4;0;0;0;;;;;ZMG5u
382;École doctorale Économie, espaces, sociétés, civilisations : pensée critique, politique et pratique sociale;EESC;6;Sciences humaines et humanités;2020;2019-20;2019;2019;0;0;0;0;0;0;7;6;1;;;;;9NI1W
394;École doctorale Physiologie et physiopathologie;p2t;5;Biologie, médecine et santé;2020;2019-20;2019;2019;42;30;12;207;126;81;57;38;19;;;;;VMYmT
400;École doctorale Savoirs scientifiques : épistémologie, histoire des sciences, didactique des disciplines;;1;Mathématiques et leurs interactions;2020;2019-20;2019;2019;0;0;0;0;0;0;2;1;1;;;;;nRax3
401;École doctorale Sciences sociales;;9;Sciences et technologies de l'information et de la communication;2020;2019-20;2019;2019;3;1;2;31;10;21;3;0;3;;;;;raQ7K
405;École doctorale Économie, management,mathématiques et physique de Cergy;EM2C;1;Mathématiques et leurs interactions;2020;2019-20;2019;2019;4;2;2;15;6;9;2;1;1;;;;;QbwSB
406;École doctorale Chimie moléculaire de Paris centre;;4;Chimie;2020;2019-20;2019;2019;25;11;14;99;43;56;39;19;20;;;;;a5dKy
413;École doctorale Sciences de la terre et de l'environnement;STE;6;Sciences humaines et humanités;2020;2019-20;2019;2019;5;2;3;15;7;8;3;1;2;;;;;u9BA9
414;École doctorale Sciences de la vie et de la santé;;5;Biologie, médecine et santé;2020;2019-20;2019;2019;117;60;57;478;263;215;123;66;57;;;;;YI4xS
414;École doctorale Sciences de la vie et de la santé;;7;Sciences de la société;2020;2019-20;2019;2019;1;1;0;1;1;0;1;0;1;;;;;YI4xS
417;École doctorale Sciences et Ingénierie;S&I;9;Sciences et technologies de l'information et de la communication;2020;2019-20;2019;2019;0;0;0;5;3;2;0;0;0;;;;;SSBvE
433;École doctorale Concepts et langages;;9;Sciences et technologies de l'information et de la communication;2020;2019-20;2019;2019;34;22;12;117;54;63;12;9;3;;;;;v8q34
434;École doctorale Géographie de Paris - Espaces, sociétés, aménagement;EDGP;6;Sciences humaines et humanités;2020;2019-20;2019;2019;46;23;23;285;163;122;31;17;14;;;;;1FmLX
446;École doctorale Biologie - Santé;EDBSL;5;Biologie, médecine et santé;2020;2019-20;2019;2019;97;54;43;326;181;145;85;49;36;;;;;4iEUF
454;École doctorale Sciences de l'homme, du politique et du territoire;SHPT;6;Sciences humaines et humanités;2020;2019-20;2019;2019;24;12;12;179;96;83;30;16;14;;;;;Opv31
455;École doctorale Économie, Gestion, Information et Communication;EGIC;7;Sciences de la société;2020;2019-20;2019;2019;21;8;13;82;36;46;12;7;5;;;;;qCOg3
463;École doctorale Sciences du mouvement humain;SMH;8;Sciences pour l'ingénieur;2020;2019-20;2019;2019;12;6;6;40;19;21;3;1;2;;;;;UbtlY
465;École doctorale Économie Panthéon Sorbonne;EPS;7;Sciences de la société;2020;2019-20;2019;2019;57;22;35;277;120;157;54;20;34;;;;;MV68S
467;École doctorale Aéronautique, astronautique;AA;1;Mathématiques et leurs interactions;2020;2019-20;2019;2019;8;2;6;25;3;22;5;1;4;;;;;U7l45
467;École doctorale Aéronautique, astronautique;AA;4;Chimie;2020;2019-20;2019;2019;1;0;1;4;1;3;1;0;1;;;;;U7l45
467;École doctorale Aéronautique, astronautique;AA;5;Biologie, médecine et santé;2020;2019-20;2019;2019;1;0;1;2;0;2;3;3;0;;;;;U7l45
467;École doctorale Aéronautique, astronautique;AA;6;Sciences humaines et humanités;2020;2019-20;2019;2019;4;3;1;8;5;3;3;0;3;;;;;U7l45
468;École doctorale Mécanique, énergétique, génie civil, procédés;MEGEP;8;Sciences pour l'ingénieur;2020;2019-20;2019;2019;121;41;80;481;139;342;119;53;66;;;;;4XUTB
469;École doctorale du Pacifique;EDP;8;Sciences pour l'ingénieur;2020;2019-20;2019;2019;2;1;1;8;2;6;1;0;1;;;;;t9Z2n
472;École doctorale de l'EPHE;;8;Sciences pour l'ingénieur;2020;2019-20;2019;2019;1;0;1;3;1;2;0;0;0;;;;;27zK4
478;École doctorale Sciences de Gestion;;7;Sciences de la société;2020;2019-20;2019;2019;15;7;8;61;38;23;12;7;5;;;;;q34kB
482;École doctorale Sciences de la matière;SDM;2;Physique;2020;2019-20;2019;2019;18;6;12;77;28;49;19;4;15;;;;;kmeZ4
482;École doctorale Sciences de la matière;SDM;4;Chimie;2020;2019-20;2019;2019;48;23;25;196;94;102;41;17;24;;;;;kmeZ4
483;École doctorale Histoire, géographie, aménagement, urbanisme, archéologie, science politique, sociologie, anthropologie;SCSO;6;Sciences humaines et humanités;2020;2019-20;2019;2019;57;28;29;356;190;166;47;21;26;;;;;hc6u4
486;École doctorale Sciences économiques et de gestion;SEG;7;Sciences de la société;2020;2019-20;2019;2019;27;11;16;152;72;80;39;10;29;;;;;h1GZ3
488;École doctorale Sciences, ingénierie, santé;SIS;4;Chimie;2020;2019-20;2019;2019;2;0;2;17;7;10;5;2;3;;;;;Fy2lK
489;École doctorale Sciences et ingénierie des systèmes, de l'environnement et des organisations;SISEO;6;Sciences humaines et humanités;2020;2019-20;2019;2019;10;2;8;42;22;20;7;6;1;;;;;6pT77
489;École doctorale Sciences et ingénierie des systèmes, de l'environnement et des organisations;SISEO;7;Sciences de la société;2020;2019-20;2019;2019;13;4;9;38;20;18;3;2;1;;;;;6pT77
489;École doctorale Sciences et ingénierie des systèmes, de l'environnement et des organisations;SISEO;9;Sciences et technologies de l'information et de la communication;2020;2019-20;2019;2019;7;1;6;19;6;13;5;2;3;;;;;6pT77
515;École doctorale Complexité du vivant;CdV;5;Biologie, médecine et santé;2020;2019-20;2019;2019;83;56;27;276;175;101;98;54;44;;;;;CbV9s
520;École doctorale Humanités;;6;Sciences humaines et humanités;2020;2019-20;2019;2019;34;23;11;247;152;95;37;21;16;;;;;rI175
528;École doctorale Ville, transports et territoires;VTT;6;Sciences humaines et humanités;2020;2019-20;2019;2019;16;9;7;123;78;45;17;9;8;;;;;68zCc
530;École doctorale Organisations, marchés, institutions;OMI;5;Biologie, médecine et santé;2020;2019-20;2019;2019;0;0;0;2;0;2;1;1;0;;;;;4htv7
530;École doctorale Organisations, marchés, institutions;OMI;6;Sciences humaines et humanités;2020;2019-20;2019;2019;37;12;25;151;63;88;17;11;6;;;;;4htv7
530;École doctorale Organisations, marchés, institutions;OMI;7;Sciences de la société;2020;2019-20;2019;2019;15;5;10;83;42;41;13;9;4;;;;;4htv7
530;École doctorale Organisations, marchés, institutions;OMI;9;Sciences et technologies de l'information et de la communication;2020;2019-20;2019;2019;0;0;0;4;4;0;0;0;0;;;;;4htv7
531;École doctorale Sciences, ingénierie et environnement;SIE;3;Sciences de la terre et de l'univers, espace;2020;2019-20;2019;2019;8;4;4;9;5;4;0;0;0;;;;;b5BYq
532;École doctorale Mathématiques et sciences et technologies de l'information et de la communication;MSTIC;1;Mathématiques et leurs interactions;2020;2019-20;2019;2019;27;4;23;78;13;65;16;4;12;;;;;t43KM
532;École doctorale Mathématiques et sciences et technologies de l'information et de la communication;MSTIC;9;Sciences et technologies de l'information et de la communication;2020;2019-20;2019;2019;41;10;31;142;35;107;32;9;23;;;;;t43KM
536;École doctorale Sciences et agrosciences;;4;Chimie;2020;2019-20;2019;2019;0;0;0;3;2;1;1;1;0;;;;;pHfqe
536;École doctorale Sciences et agrosciences;;10;Sciences agronomiques et écologiques;2020;2019-20;2019;2019;17;8;9;55;29;26;13;8;5;;;;;pHfqe
540;"École doctorale École transdisciplinaire ""lettres/sciences""";;6;Sciences humaines et humanités;2020;2019-20;2019;2019;42;23;19;184;85;99;25;10;15;;;;;tWWw7
540;"École doctorale École transdisciplinaire ""lettres/sciences""";;5;Biologie, médecine et santé;2020;2019-20;2019;2019;0;0;0;0;0;0;1;0;1;;;;;tWWw7
541;École doctorale de sciences humaines et sociales de La Réunion;SHS;6;Sciences humaines et humanités;2020;2019-20;2019;2019;23;17;6;92;60;32;9;6;3;;;;;21SpE
544;École doctorale Inter-Med : Espaces, temps, cultures;INTER-MED;7;Sciences de la société;2020;2019-20;2019;2019;44;19;25;158;73;85;22;12;10;;;;;7VjtD
546;École doctorale Abbé Grégoire;;6;Sciences humaines et humanités;2020;2019-20;2019;2019;57;28;29;173;94;79;23;14;9;;;;;ZSn7q
548;École doctorale Mer et Sciences;;8;Sciences pour l'ingénieur;2020;2019-20;2019;2019;1;0;1;5;1;4;1;1;0;;;;;QX0fS
553;École doctorale Carnot - Pasteur;;1;Mathématiques et leurs interactions;2020;2019-20;2019;2019;19;4;15;47;9;38;5;1;4;;;;;6h4Z7
555;École doctorale Sciences de l'Homme et de la Société;SHS;6;Sciences humaines et humanités;2020;2019-20;2019;2019;17;10;7;93;51;42;11;8;3;;;;;44G6m
556;École doctorale Homme, Sociétés, Risques, Territoire;HSRT;6;Sciences humaines et humanités;2020;2019-20;2019;2019;48;26;22;225;111;114;44;18;26;;;;;5QEaX
560;École doctorale Sciences de la terre et de l'environnement et Physique de l'univers, Paris;STEP'UP;2;Physique;2020;2019-20;2019;2019;6;2;4;18;5;13;8;3;5;;;;;Z2VI9
560;École doctorale Sciences de la terre et de l'environnement et Physique de l'univers, Paris;STEP'UP;3;Sciences de la terre et de l'univers, espace;2020;2019-20;2019;2019;46;16;30;167;64;103;46;17;29;;;;;Z2VI9
563;École doctorale Médicament - Toxicologie - Chimie - Imageries;MTCI;5;Biologie, médecine et santé;2020;2019-20;2019;2019;50;33;17;154;85;69;51;22;29;;;;;j8uk1
566;École doctorale Sciences du Sport, de la Motricité et du Mouvement Humain;SMMH;6;Sciences humaines et humanités;2020;2019-20;2019;2019;13;7;6;45;24;21;8;6;2;;;;;3iv8y
570;École doctorale Santé Publique;EDSP;1;Mathématiques et leurs interactions;2020;2019-20;2019;2019;3;2;1;6;3;3;0;0;0;;;;;9lgE4
570;École doctorale Santé Publique;EDSP;5;Biologie, médecine et santé;2020;2019-20;2019;2019;32;22;10;137;85;52;23;17;6;;;;;9lgE4
573;École doctorale Interfaces : Approches Interdisciplinaires, Fondements, Applications et Innovation;ED INTERFACES;1;Mathématiques et leurs interactions;2020;2019-20;2019;2019;5;0;5;15;2;13;7;1;6;;;;;gG820
573;École doctorale Interfaces : Approches Interdisciplinaires, Fondements, Applications et Innovation;ED INTERFACES;2;Physique;2020;2019-20;2019;2019;7;2;5;29;7;22;18;4;14;;;;;gG820
574;École doctorale de Mathématiques Hadamard;EDMH;1;Mathématiques et leurs interactions;2020;2019-20;2019;2019;97;13;84;316;51;265;69;13;56;;;;;4pqal
575;École doctorale Electrical, Optical, Bio : Physics and Engineering;EOBE;4;Chimie;2020;2019-20;2019;2019;2;1;1;2;1;1;1;0;1;;;;;dfhyn
575;École doctorale Electrical, Optical, Bio : Physics and Engineering;EOBE;5;Biologie, médecine et santé;2020;2019-20;2019;2019;3;3;0;13;8;5;4;0;4;;;;;dfhyn
577;École doctorale Structure et dynamique des systèmes vivants;SDSV;4;Chimie;2020;2019-20;2019;2019;1;1;0;1;1;0;0;0;0;;;;;4bsxJ
578;École doctorale Sciences de l'Homme et de la Société;ED SHS;9;Sciences et technologies de l'information et de la communication;2020;2019-20;2019;2019;1;1;0;1;1;0;0;0;0;;;;;Ud43O
579;École doctorale Sciences mécaniques et energétiques, matériaux et géosciences;SMEMaG;3;Sciences de la terre et de l'univers, espace;2020;2019-20;2019;2019;14;5;9;53;25;28;9;3;6;;;;;atMj7
580;École doctorale Sciences et technologies de l'information et de la communication;STIC;1;Mathématiques et leurs interactions;2020;2019-20;2019;2019;3;0;3;9;3;6;1;0;1;;;;;AzCC0
581;École doctorale Agriculture, alimentation, biologie, environnement, santé;ABIES;5;Biologie, médecine et santé;2020;2019-20;2019;2019;12;8;4;61;45;16;16;10;6;;;;;c1x56
581;École doctorale Agriculture, alimentation, biologie, environnement, santé;ABIES;7;Sciences de la société;2020;2019-20;2019;2019;10;7;3;43;21;22;13;8;5;;;;;c1x56
583;École doctorale Risques et Société;;5;Biologie, médecine et santé;2020;2019-20;2019;2019;1;1;0;2;2;0;1;0;1;;;;;wUBi9
585;École doctorale Sciences, Technologie,  Sante;EDSTS;9;Sciences et technologies de l'information et de la communication;2020;2019-20;2019;2019;4;0;4;14;4;10;5;1;4;;;;;NM3Dl
587;École doctorale Diversites, santé et développement en Amazonie;;7;Sciences de la société;2020;2019-20;2019;2019;3;2;1;11;6;5;1;0;1;;;;;V14tj
588;École doctorale Milieu insulaire tropical : dynamiques de développement, sociétés, patrimoine et culture dans l'espace Caraïbes-Amériques;;7;Sciences de la société;2020;2019-20;2019;2019;15;12;3;68;41;27;4;2;2;;;;;4W5IO
589;École doctorale Milieu insulaire tropical à risques : protection, valorisation , santé et développement;;4;Chimie;2020;2019-20;2019;2019;3;1;2;4;2;2;1;0;1;;;;;2cqi3
591;École doctorale Physique, Sciences de l'Ingenieur, Materiaux, Énergie;PSIME;3;Sciences de la terre et de l'univers, espace;2020;2019-20;2019;2019;3;0;3;6;1;5;2;2;0;;;;;Hn5Om
601;École doctorale Mathématiques et Sciences et Technologies de l'information et de la Communication;MathSTIC;9;Sciences et technologies de l'information et de la communication;2020;2019-20;2019;2019;200;51;149;874;216;658;205;45;160;;;;;3Ue20
602;École doctorale Sciences pour l'Ingénieur;SPI;6;Sciences humaines et humanités;2020;2019-20;2019;2019;0;0;0;12;4;8;2;2;0;;;;;8yWbu
604;École doctorale Sociétés, Temps, Territoires;STT;7;Sciences de la société;2020;2019-20;2019;2019;14;9;5;83;39;44;14;7;7;;;;;SZI5T
606;École doctorale Chimie - Mécanique - Matériaux - Physique;C2MP;2;Physique;2020;2019-20;2019;2019;23;4;19;81;21;60;23;5;18;;;;;UkNR2
606;École doctorale Chimie - Mécanique - Matériaux - Physique;C2MP;5;Biologie, médecine et santé;2020;2019-20;2019;2019;0;0;0;6;2;4;1;0;1;;;;;UkNR2
615;École doctorale Sciences Biologiques et Santé;SBS;5;Biologie, médecine et santé;2020;2019-20;2019;2019;46;26;20;163;92;71;37;25;12;;;;;TNa15
616;École doctorale Humanités et Langues;H&L;9;Sciences et technologies de l'information et de la communication;2020;2019-20;2019;2019;0;0;0;0;0;0;1;1;0;;;;;FYOlf
617;École doctorale Sciences de la Société : Territoires, Economie et Droit;SSTED;3;Sciences de la terre et de l'univers, espace;2020;2019-20;2019;2019;0;0;0;5;1;4;0;0;0;;;;;Kl9ZX
618;École doctorale EUCLIDE;;3;Sciences de la terre et de l'univers, espace;2020;2019-20;2019;2019;1;0;1;11;4;7;3;0;3;;;;;qveTN
618;École doctorale EUCLIDE;;5;Biologie, médecine et santé;2020;2019-20;2019;2019;3;1;2;10;3;7;3;2;1;;;;;qveTN
619;École doctorale Sciences Fondamentales et Santé;SFS;5;Biologie, médecine et santé;2020;2019-20;2019;2019;15;7;8;62;36;26;15;10;5;;;;;JiZVW
620;École doctorale Sciences du Numérique et de l'Ingénieur;SNI;1;Mathématiques et leurs interactions;2020;2019-20;2019;2019;1;0;1;3;2;1;0;0;0;;;;;Dr40w
626;École doctorale de l’Institut Polytechnique de Paris;;8;Sciences pour l'ingénieur;2020;2019-20;2019;2019;24;8;16;75;24;51;7;1;6;;;;;DL5fO
8;École doctorale Histoire du droit, philosophie du droit et sociologie du droit;;7;Sciences de la société;2018;2017-18;2017;2017;11;3;8;90;35;55;8;2;6;;;;;pGSed
31;École doctorale Pratiques et théories du sens;;6;Sciences humaines et humanités;2018;2017-18;2017;2017;76;46;30;438;250;188;41;21;20;;;;;1S466
37;École doctorale Sciences physiques pour l'ingénieur et microtechniques;SPIM;3;Sciences de la terre et de l'univers, espace;2018;2017-18;2017;2017;0;0;0;1;0;1;0;0;0;;;;;F7G1B
39;École doctorale Mathématiques et Informatique;EDMIB;1;Mathématiques et leurs interactions;2018;2017-18;2017;2017;25;6;19;90;21;69;19;5;14;;;;;TBj2X
47;École doctorale Physique;;5;Biologie, médecine et santé;2018;2017-18;2017;2017;2;1;1;6;3;3;1;0;1;;;;;8kNpd
50;École doctorale Langues, littératures et sciences humaines;LLSH;6;Sciences humaines et humanités;2018;2017-18;2017;2017;39;32;7;191;137;54;32;22;10;;;;;8THzQ
52;École doctorale Physique et astrophysique de Lyon;PHAST;3;Sciences de la terre et de l'univers, espace;2018;2017-18;2017;2017;7;4;3;22;10;12;7;4;3;;;;;61XPb
58;École doctorale Langues, littératures, cultures, civilisations;LLCC;6;Sciences humaines et humanités;2018;2017-18;2017;2017;99;60;39;471;289;182;57;33;24;;;;;I9ATR
62;École doctorale Sciences de la vie et de la santé;;5;Biologie, médecine et santé;2018;2017-18;2017;2017;176;99;77;708;400;308;153;95;58;;;;;vZzE7
62;École doctorale Sciences de la vie et de la santé;;7;Sciences de la société;2018;2017-18;2017;2017;1;0;1;1;0;1;0;0;0;;;;;vZzE7
62;École doctorale Sciences de la vie et de la santé;;8;Sciences pour l'ingénieur;2018;2017-18;2017;2017;0;0;0;2;0;2;0;0;0;;;;;vZzE7
62;École doctorale Sciences de la vie et de la santé;;9;Sciences et technologies de l'information et de la communication;2018;2017-18;2017;2017;0;0;0;1;0;1;0;0;0;;;;;vZzE7
65;École doctorale Sciences de la Vie, Santé, Agronomie, Environnement;;6;Sciences humaines et humanités;2018;2017-18;2017;2017;0;0;0;4;1;3;0;0;0;;;;;MAOG4
70;École doctorale Sciences pour l'ingénieur;EDSPI;8;Sciences pour l'ingénieur;2018;2017-18;2017;2017;51;16;35;129;34;95;28;5;23;;;;;G413P
71;École doctorale Sciences pour l'ingénieur;;1;Mathématiques et leurs interactions;2018;2017-18;2017;2017;4;2;2;11;6;5;2;1;1;;;;;H6UYp
72;École doctorale Sciences pour l'ingénieur;SPI;8;Sciences pour l'ingénieur;2018;2017-18;2017;2017;87;21;66;247;64;183;79;21;58;;;;;47QPx
77;École doctorale Informatique, automatique, électronique, électrotechnique, mathématiques;IAEM;1;Mathématiques et leurs interactions;2018;2017-18;2017;2017;15;2;13;44;11;33;3;0;3;;;;;TCHTA
86;École doctorale Sociétés, humanités, arts, lettres;LSHS;7;Sciences de la société;2018;2017-18;2017;2017;8;3;5;28;16;12;8;6;2;;;;;O8E6y
88;École doctorale Droit et science politique;DSP;7;Sciences de la société;2018;2017-18;2017;2017;42;22;20;276;131;145;34;16;18;;;;;elnAJ
104;École doctorale Sciences de la matière, du rayonnement et de l'environnement;SMRE;4;Chimie;2018;2017-18;2017;2017;55;31;24;222;100;122;87;46;41;;;;;Q5iFz
104;École doctorale Sciences de la matière, du rayonnement et de l'environnement;SMRE;9;Sciences et technologies de l'information et de la communication;2018;2017-18;2017;2017;1;0;1;1;0;1;0;0;0;;;;;Q5iFz
104;École doctorale Sciences de la matière, du rayonnement et de l'environnement;SMRE;10;Sciences agronomiques et écologiques;2018;2017-18;2017;2017;21;15;6;80;48;32;21;14;7;;;;;Q5iFz
127;École doctorale Astronomie et astrophysique d'Ile de France;A&A;3;Sciences de la terre et de l'univers, espace;2018;2017-18;2017;2017;49;16;33;174;57;117;44;14;30;;;;;cPXrq
132;École doctorale Sciences du langage;;6;Sciences humaines et humanités;2018;2017-18;2017;2017;9;4;5;71;43;28;15;12;3;;;;;5AUF1
139;École doctorale Connaissance, langage, modélisation;CLM;6;Sciences humaines et humanités;2018;2017-18;2017;2017;52;32;20;253;160;93;45;34;11;;;;;1lxGH
141;École doctorale Droit et science politique;DSP;7;Sciences de la société;2018;2017-18;2017;2017;57;28;29;257;123;134;28;9;19;;;;;CyNBf
146;École doctorale Galilée;GALILEE;1;Mathématiques et leurs interactions;2018;2017-18;2017;2017;8;3;5;36;7;29;6;1;5;;;;;71hqm
156;École doctorale Sciences de la mer;;8;Sciences pour l'ingénieur;2018;2017-18;2017;2017;0;0;0;0;0;0;8;1;7;;;;;EGY9P
160;École doctorale Électronique, électrotechnique, automatique;EEA;5;Biologie, médecine et santé;2018;2017-18;2017;2017;5;4;1;13;7;6;4;2;2;;;;;EgfMQ
162;École doctorale Mécanique, énergétique, génie civil, acoustique;MEGA;2;Physique;2018;2017-18;2017;2017;1;1;0;6;2;4;1;0;1;;;;;7wCke
162;École doctorale Mécanique, énergétique, génie civil, acoustique;MEGA;5;Biologie, médecine et santé;2018;2017-18;2017;2017;7;5;2;13;8;5;0;0;0;;;;;7wCke
166;École doctorale Information, structures et systèmes;I2S;5;Biologie, médecine et santé;2018;2017-18;2017;2017;4;0;4;14;6;8;1;1;0;;;;;2uO68
166;École doctorale Information, structures et systèmes;I2S;8;Sciences pour l'ingénieur;2018;2017-18;2017;2017;42;9;33;118;26;92;21;5;16;;;;;2uO68
180;École doctorale Sciences humaines et sociales : cultures, individus, sociétés;SHS;7;Sciences de la société;2018;2017-18;2017;2017;28;17;11;103;61;42;19;13;6;;;;;D2BT3
182;École doctorale Physique et chimie-physique;;2;Physique;2018;2017-18;2017;2017;34;12;22;122;37;85;38;10;28;;;;;3My6I
182;École doctorale Physique et chimie-physique;;5;Biologie, médecine et santé;2018;2017-18;2017;2017;1;1;0;2;2;0;1;1;0;;;;;3My6I
205;École doctorale Interdisciplinaire Sciences-Santé;EDISS;4;Chimie;2018;2017-18;2017;2017;0;0;0;1;1;0;0;0;0;;;;;69W38
205;École doctorale Interdisciplinaire Sciences-Santé;EDISS;8;Sciences pour l'ingénieur;2018;2017-18;2017;2017;0;0;0;4;0;4;1;0;1;;;;;69W38
211;École doctorale Sciences exactes et leurs applications;ED SEA;1;Mathématiques et leurs interactions;2018;2017-18;2017;2017;9;2;7;30;11;19;6;0;6;;;;;1G1iC
211;École doctorale Sciences exactes et leurs applications;ED SEA;2;Physique;2018;2017-18;2017;2017;1;1;0;11;6;5;2;1;1;;;;;1G1iC
211;École doctorale Sciences exactes et leurs applications;ED SEA;3;Sciences de la terre et de l'univers, espace;2018;2017-18;2017;2017;2;1;1;8;1;7;2;0;2;;;;;1G1iC
216;École doctorale Ingénierie pour la santé, la cognition, l'environnement;EDISCE;1;Mathématiques et leurs interactions;2018;2017-18;2017;2017;3;1;2;9;4;5;2;0;2;;;;;fPs1t
216;École doctorale Ingénierie pour la santé, la cognition, l'environnement;EDISCE;9;Sciences et technologies de l'information et de la communication;2018;2017-18;2017;2017;1;0;1;16;7;9;7;5;2;;;;;fPs1t
218;École doctorale Chimie et sciences du vivant;EDCSV;4;Chimie;2018;2017-18;2017;2017;26;9;17;109;47;62;31;13;18;;;;;8bcJh
221;École doctorale Augustin Cournot - Sciences économiques et de gestion - Sciences, technologies et sociétés;EDAC;6;Sciences humaines et humanités;2018;2017-18;2017;2017;0;0;0;11;6;5;0;0;0;;;;;5z9rW
221;École doctorale Augustin Cournot - Sciences économiques et de gestion - Sciences, technologies et sociétés;EDAC;7;Sciences de la société;2018;2017-18;2017;2017;17;7;10;84;42;42;15;6;9;;;;;5z9rW
221;École doctorale Augustin Cournot - Sciences économiques et de gestion - Sciences, technologies et sociétés;EDAC;10;Sciences agronomiques et écologiques;2018;2017-18;2017;2017;0;0;0;2;1;1;0;0;0;;;;;5z9rW
222;École doctorale Sciences chimiques;EDSC;4;Chimie;2018;2017-18;2017;2017;77;26;51;286;108;178;86;38;48;;;;;AdU8Q
224;École doctorale Cognition, langage, interaction;;1;Mathématiques et leurs interactions;2018;2017-18;2017;2017;1;0;1;3;1;2;1;1;0;;;;;7v43e
224;École doctorale Cognition, langage, interaction;;9;Sciences et technologies de l'information et de la communication;2018;2017-18;2017;2017;4;1;3;11;2;9;2;1;1;;;;;7v43e
227;École doctorale Sciences de la nature et de l'homme;;4;Chimie;2018;2017-18;2017;2017;0;0;0;3;0;3;2;2;0;;;;;xiDA5
240;École doctorale Sciences de l'homme et de la société;SHS;5;Biologie, médecine et santé;2018;2017-18;2017;2017;0;0;0;6;2;4;1;0;1;;;;;j345k
254;École doctorale Sciences de la matière;;4;Chimie;2018;2017-18;2017;2017;0;0;0;0;0;0;17;4;13;;;;;365F2
261;École doctorale Cognition, comportements, conduites humaines;3CH;6;Sciences humaines et humanités;2018;2017-18;2017;2017;42;33;9;147;111;36;34;26;8;;;;;KOLCy
268;École doctorale Langage et langues : description, théorisation, transmission;;6;Sciences humaines et humanités;2018;2017-18;2017;2017;48;34;14;236;165;71;48;35;13;;;;;wAIDE
268;École doctorale Langage et langues : description, théorisation, transmission;;7;Sciences de la société;2018;2017-18;2017;2017;1;0;1;4;2;2;1;1;0;;;;;wAIDE
269;École doctorale Mathématiques, sciences de l'information et de l'ingénieur;MSII;1;Mathématiques et leurs interactions;2018;2017-18;2017;2017;14;4;10;45;14;31;13;3;10;;;;;5E625
269;École doctorale Mathématiques, sciences de l'information et de l'ingénieur;MSII;2;Physique;2018;2017-18;2017;2017;1;0;1;4;0;4;2;1;1;;;;;5E625
269;École doctorale Mathématiques, sciences de l'information et de l'ingénieur;MSII;7;Sciences de la société;2018;2017-18;2017;2017;0;0;0;19;0;19;0;0;0;;;;;5E625
270;École doctorale Théologie et sciences religieuses;;6;Sciences humaines et humanités;2018;2017-18;2017;2017;28;7;21;124;31;93;15;5;10;;;;;BRKC1
304;École doctorale Sciences et environnements;;10;Sciences agronomiques et écologiques;2018;2017-18;2017;2017;10;2;8;55;24;31;16;10;6;;;;;2ywZn
326;École doctorale Comportement, langage, éducation, socialisation, cognition;CLESCO;6;Sciences humaines et humanités;2018;2017-18;2017;2017;73;48;25;298;192;106;49;38;11;;;;;nWIlG
327;École doctorale Temps, espaces, sociétés, cultures;TESC;10;Sciences agronomiques et écologiques;2018;2017-18;2017;2017;0;0;0;3;1;2;1;0;1;;;;;IjgiJ
328;École doctorale Arts, lettres, langues, philosophie et communication;ALLPH@;7;Sciences de la société;2018;2017-18;2017;2017;1;1;0;11;8;3;0;0;0;;;;;xLxMh
361;École doctorale Sciences et Technologies;ED ST;6;Sciences humaines et humanités;2018;2017-18;2017;2017;3;1;2;16;6;10;3;2;1;;;;;cOUmL
361;École doctorale Sciences et Technologies;ED ST;8;Sciences pour l'ingénieur;2018;2017-18;2017;2017;8;1;7;46;13;33;10;1;9;;;;;cOUmL
388;École doctorale Chimie physique et chimie analytique de Paris centre;CPCA;4;Chimie;2018;2017-18;2017;2017;87;40;47;295;126;169;65;32;33;;;;;M0Hnd
398;École doctorale Géosciences, ressources naturelles et environnement;GRNE;8;Sciences pour l'ingénieur;2018;2017-18;2017;2017;3;2;1;6;2;4;1;0;1;;;;;Zi4Zf
400;École doctorale Savoirs scientifiques : épistémologie, histoire des sciences, didactique des disciplines;;4;Chimie;2018;2017-18;2017;2017;2;0;2;2;0;2;1;1;0;;;;;nRax3
400;École doctorale Savoirs scientifiques : épistémologie, histoire des sciences, didactique des disciplines;;7;Sciences de la société;2018;2017-18;2017;2017;0;0;0;0;0;0;2;0;2;;;;;nRax3
401;École doctorale Sciences sociales;;6;Sciences humaines et humanités;2018;2017-18;2017;2017;21;9;12;159;77;82;23;10;13;;;;;raQ7K
401;École doctorale Sciences sociales;;7;Sciences de la société;2018;2017-18;2017;2017;44;25;19;181;104;77;25;16;9;;;;;raQ7K
405;École doctorale Économie, management,mathématiques et physique de Cergy;EM2C;2;Physique;2018;2017-18;2017;2017;2;0;2;9;2;7;2;0;2;;;;;QbwSB
411;École doctorale Humanités nouvelles : Fernand Braudel;;6;Sciences humaines et humanités;2018;2017-18;2017;2017;51;22;29;216;112;104;28;15;13;;;;;l2rFh
411;École doctorale Humanités nouvelles : Fernand Braudel;;7;Sciences de la société;2018;2017-18;2017;2017;11;7;4;64;43;21;7;6;1;;;;;l2rFh
412;École doctorale Lorraine de chimie et physique moléculaires : synthèses, expériences, simulations, applications : de la molécule aux édifices supramoléculaires;SESAMES;4;Chimie;2018;2017-18;2017;2017;17;7;10;70;35;35;16;10;6;;;;;mvHX2
417;École doctorale Sciences et Ingénierie;S&I;3;Sciences de la terre et de l'univers, espace;2018;2017-18;2017;2017;0;0;0;4;1;3;1;0;1;;;;;SSBvE
432;École doctorale Sciences des métiers de l'ingénieur;SMI;8;Sciences pour l'ingénieur;2018;2017-18;2017;2017;148;30;118;512;112;400;141;35;106;;;;;nSsHB
433;École doctorale Concepts et langages;;9;Sciences et technologies de l'information et de la communication;2018;2017-18;2017;2017;2;0;2;4;0;4;6;3;3;;;;;v8q34
446;École doctorale Biologie - Santé;EDBSL;4;Chimie;2018;2017-18;2017;2017;4;1;3;9;6;3;8;3;5;;;;;4iEUF
454;École doctorale Sciences de l'homme, du politique et du territoire;SHPT;6;Sciences humaines et humanités;2018;2017-18;2017;2017;33;19;14;199;95;104;31;18;13;;;;;Opv31
454;École doctorale Sciences de l'homme, du politique et du territoire;SHPT;7;Sciences de la société;2018;2017-18;2017;2017;22;11;11;121;70;51;17;7;10;;;;;Opv31
458;École doctorale Sciences écologiques, vétérinaires, agronomiques et bioingénieries;SEVAB;10;Sciences agronomiques et écologiques;2018;2017-18;2017;2017;61;36;25;244;126;118;62;26;36;;;;;Yf3TI
463;École doctorale Sciences du mouvement humain;SMH;7;Sciences de la société;2018;2017-18;2017;2017;0;0;0;3;0;3;0;0;0;;;;;UbtlY
463;École doctorale Sciences du mouvement humain;SMH;8;Sciences pour l'ingénieur;2018;2017-18;2017;2017;6;3;3;31;12;19;4;1;3;;;;;UbtlY
465;École doctorale Économie Panthéon Sorbonne;EPS;1;Mathématiques et leurs interactions;2018;2017-18;2017;2017;5;3;2;19;7;12;5;0;5;;;;;MV68S
467;École doctorale Aéronautique, astronautique;AA;7;Sciences de la société;2018;2017-18;2017;2017;1;0;1;4;1;3;0;0;0;;;;;U7l45
469;École doctorale du Pacifique;EDP;7;Sciences de la société;2018;2017-18;2017;2017;4;4;0;23;16;7;0;0;0;;;;;t9Z2n
472;École doctorale de l'EPHE;;1;Mathématiques et leurs interactions;2018;2017-18;2017;2017;1;1;0;3;2;1;0;0;0;;;;;27zK4
472;École doctorale de l'EPHE;;3;Sciences de la terre et de l'univers, espace;2018;2017-18;2017;2017;2;1;1;8;5;3;3;2;1;;;;;27zK4
472;École doctorale de l'EPHE;;5;Biologie, médecine et santé;2018;2017-18;2017;2017;9;6;3;38;23;15;9;4;5;;;;;27zK4
472;École doctorale de l'EPHE;;8;Sciences pour l'ingénieur;2018;2017-18;2017;2017;1;0;1;2;0;2;0;0;0;;;;;27zK4
472;École doctorale de l'EPHE;;9;Sciences et technologies de l'information et de la communication;2018;2017-18;2017;2017;2;1;1;5;2;3;1;0;1;;;;;27zK4
472;École doctorale de l'EPHE;;10;Sciences agronomiques et écologiques;2018;2017-18;2017;2017;2;0;2;12;4;8;3;3;0;;;;;27zK4
480;École doctorale Montaigne-humanités;;3;Sciences de la terre et de l'univers, espace;2018;2017-18;2017;2017;5;3;2;22;8;14;7;1;6;;;;;f3SeZ
481;École doctorale Sciences sociales et humanités;SSH;7;Sciences de la société;2018;2017-18;2017;2017;35;17;18;198;92;106;20;10;10;;;;;E3z5j
482;École doctorale Sciences de la matière;SDM;5;Biologie, médecine et santé;2018;2017-18;2017;2017;2;1;1;2;1;1;0;0;0;;;;;kmeZ4
488;École doctorale Sciences, ingénierie, santé;SIS;4;Chimie;2018;2017-18;2017;2017;4;1;3;15;6;9;1;0;1;;;;;Fy2lK
488;École doctorale Sciences, ingénierie, santé;SIS;9;Sciences et technologies de l'information et de la communication;2018;2017-18;2017;2017;33;10;23;136;40;96;34;4;30;;;;;Fy2lK
489;École doctorale Sciences et ingénierie des systèmes, de l'environnement et des organisations;SISEO;9;Sciences et technologies de l'information et de la communication;2018;2017-18;2017;2017;4;0;4;21;10;11;2;0;2;;;;;6pT77
496;École doctorale Sociétés, cultures, échanges;SCE;6;Sciences humaines et humanités;2018;2017-18;2017;2017;0;0;0;0;0;0;11;7;4;;;;;633tC
498;École doctorale Sciences pour l'ingénieur, géosciences, architecture;SPIGA;3;Sciences de la terre et de l'univers, espace;2018;2017-18;2017;2017;0;0;0;0;0;0;2;0;2;;;;;0vlKH
504;École doctorale Cognition, éducation, interactions;CEI;6;Sciences humaines et humanités;2018;2017-18;2017;2017;0;0;0;0;0;0;7;3;4;;;;;39naT
504;École doctorale Cognition, éducation, interactions;CEI;9;Sciences et technologies de l'information et de la communication;2018;2017-18;2017;2017;0;0;0;0;0;0;1;1;0;;;;;39naT
506;École doctorale arts, lettres et langues;;6;Sciences humaines et humanités;2018;2017-18;2017;2017;0;0;0;0;0;0;11;8;3;;;;;m9yqI
509;École doctorale Civilisations et sociétés euro-méditerranéennes et comparées;;6;Sciences humaines et humanités;2018;2017-18;2017;2017;5;4;1;23;10;13;4;3;1;;;;;9tbyG
510;École doctorale Ingénierie - Matériaux, mécanique, environnement, énergétique, procédés, production;IMEP2;9;Sciences et technologies de l'information et de la communication;2018;2017-18;2017;2017;0;0;0;3;0;3;2;0;2;;;;;Ce7NF
512;École doctorale Informatique et mathématiques;InfoMaths;8;Sciences pour l'ingénieur;2018;2017-18;2017;2017;0;0;0;6;0;6;0;0;0;;;;;t86bi
522;École doctorale Sciences et ingénierie en matériaux, mécanique, énergétique et aéronautique;SI-MMEA;8;Sciences pour l'ingénieur;2018;2017-18;2017;2017;69;21;48;232;57;175;61;15;46;;;;;82F19
523;École doctorale Sciences pour l'environnement - Gay Lussac;;3;Sciences de la terre et de l'univers, espace;2018;2017-18;2017;2017;11;6;5;29;12;17;7;4;3;;;;;6xD69
526;École doctorale Sociétés et organisations;SORG;7;Sciences de la société;2018;2017-18;2017;2017;30;16;14;117;61;56;12;7;5;;;;;5F3Fd
528;École doctorale Ville, transports et territoires;VTT;7;Sciences de la société;2018;2017-18;2017;2017;3;0;3;16;4;12;5;3;2;;;;;68zCc
530;École doctorale Organisations, marchés, institutions;OMI;9;Sciences et technologies de l'information et de la communication;2018;2017-18;2017;2017;1;1;0;2;2;0;0;0;0;;;;;4htv7
531;École doctorale Sciences, ingénierie et environnement;SIE;2;Physique;2018;2017-18;2017;2017;6;2;4;21;4;17;10;3;7;;;;;b5BYq
537;École doctorale Culture et patrimoine;C&P;6;Sciences humaines et humanités;2018;2017-18;2017;2017;24;11;13;91;49;42;15;8;7;;;;;GxI4a
543;École doctorale de Dauphine;;1;Mathématiques et leurs interactions;2018;2017-18;2017;2017;9;0;9;47;3;44;13;5;8;;;;;u8w6A
546;École doctorale Abbé Grégoire;;9;Sciences et technologies de l'information et de la communication;2018;2017-18;2017;2017;3;2;1;3;2;1;0;0;0;;;;;ZSn7q
548;École doctorale Mer et Sciences;;8;Sciences pour l'ingénieur;2018;2017-18;2017;2017;3;0;3;7;2;5;3;0;3;;;;;QX0fS
549;École doctorale Santé, Sciences Biologiques et Chimie du Vivant;SSBCV;3;Sciences de la terre et de l'univers, espace;2018;2017-18;2017;2017;0;0;0;1;0;1;1;1;0;;;;;B9ggO
549;École doctorale Santé, Sciences Biologiques et Chimie du Vivant;SSBCV;4;Chimie;2018;2017-18;2017;2017;13;6;7;49;18;31;14;5;9;;;;;B9ggO
549;École doctorale Santé, Sciences Biologiques et Chimie du Vivant;SSBCV;9;Sciences et technologies de l'information et de la communication;2018;2017-18;2017;2017;2;1;1;5;3;2;1;0;1;;;;;B9ggO
549;École doctorale Santé, Sciences Biologiques et Chimie du Vivant;SSBCV;10;Sciences agronomiques et écologiques;2018;2017-18;2017;2017;0;0;0;6;5;1;13;10;3;;;;;B9ggO
551;École doctorale Mathématiques, Informatique, Physique Théorique et Ingénierie des Systèmes;MIPTIS;2;Physique;2018;2017-18;2017;2017;1;0;1;5;0;5;2;0;2;;;;;Mpudz
552;École doctorale Énergie - Matériaux - Sciences de la Terre et de l'Univers;EMTSU;5;Biologie, médecine et santé;2018;2017-18;2017;2017;2;0;2;3;0;3;3;2;1;;;;;NTZhw
552;École doctorale Énergie - Matériaux - Sciences de la Terre et de l'Univers;EMTSU;9;Sciences et technologies de l'information et de la communication;2018;2017-18;2017;2017;1;0;1;3;0;3;2;2;0;;;;;NTZhw
553;École doctorale Carnot - Pasteur;;1;Mathématiques et leurs interactions;2018;2017-18;2017;2017;11;2;9;43;12;31;15;5;10;;;;;6h4Z7
553;École doctorale Carnot - Pasteur;;4;Chimie;2018;2017-18;2017;2017;19;10;9;81;29;52;30;9;21;;;;;6h4Z7
554;École doctorale Environnements - Santé;E-S;4;Chimie;2018;2017-18;2017;2017;0;0;0;3;2;1;1;0;1;;;;;ElyFU
554;École doctorale Environnements - Santé;E-S;6;Sciences humaines et humanités;2018;2017-18;2017;2017;1;1;0;12;6;6;3;2;1;;;;;ElyFU
555;École doctorale Sciences de l'Homme et de la Société;SHS;7;Sciences de la société;2018;2017-18;2017;2017;27;11;16;114;43;71;17;5;12;;;;;44G6m
556;École doctorale Homme, Sociétés, Risques, Territoire;HSRT;6;Sciences humaines et humanités;2018;2017-18;2017;2017;50;28;22;247;117;130;41;18;23;;;;;5QEaX
560;École doctorale Sciences de la terre et de l'environnement et Physique de l'univers, Paris;STEP'UP;2;Physique;2018;2017-18;2017;2017;9;2;7;29;7;22;6;1;5;;;;;Z2VI9
565;École doctorale Droit de la Sorbonne;DS;7;Sciences de la société;2018;2017-18;2017;2017;124;67;57;736;371;365;88;36;52;;;;;aXJ7L
567;École doctorale Sciences du Végétal : du gène à l'écosystème;;5;Biologie, médecine et santé;2018;2017-18;2017;2017;25;10;15;116;58;58;21;13;8;;;;;tuDkA
567;École doctorale Sciences du Végétal : du gène à l'écosystème;;10;Sciences agronomiques et écologiques;2018;2017-18;2017;2017;3;2;1;10;5;5;11;6;5;;;;;tuDkA
570;École doctorale Santé Publique;EDSP;6;Sciences humaines et humanités;2018;2017-18;2017;2017;1;1;0;7;6;1;3;3;0;;;;;9lgE4
570;École doctorale Santé Publique;EDSP;7;Sciences de la société;2018;2017-18;2017;2017;0;0;0;5;3;2;0;0;0;;;;;9lgE4
571;École doctorale Sciences Chimiques : Molécules, Matériaux, Instrumentation et Biosystemes;2MIB;4;Chimie;2018;2017-18;2017;2017;73;36;37;290;131;159;70;31;39;;;;;zbi37
572;École doctorale Ondes et matière;EDOM;2;Physique;2018;2017-18;2017;2017;70;23;47;262;71;191;55;13;42;;;;;etSIi
574;École doctorale de Mathématiques Hadamard;EDMH;1;Mathématiques et leurs interactions;2018;2017-18;2017;2017;94;18;76;312;55;257;67;19;48;;;;;4pqal
575;École doctorale Electrical, Optical, Bio : Physics and Engineering;EOBE;5;Biologie, médecine et santé;2018;2017-18;2017;2017;2;2;0;5;3;2;1;1;0;;;;;dfhyn
575;École doctorale Electrical, Optical, Bio : Physics and Engineering;EOBE;8;Sciences pour l'ingénieur;2018;2017-18;2017;2017;43;12;31;149;41;108;32;10;22;;;;;dfhyn
578;École doctorale Sciences de l'Homme et de la Société;ED SHS;6;Sciences humaines et humanités;2018;2017-18;2017;2017;23;10;13;168;95;73;20;12;8;;;;;Ud43O
579;École doctorale Sciences mécaniques et energétiques, matériaux et géosciences;SMEMaG;3;Sciences de la terre et de l'univers, espace;2018;2017-18;2017;2017;14;6;8;56;24;32;9;4;5;;;;;atMj7
579;École doctorale Sciences mécaniques et energétiques, matériaux et géosciences;SMEMaG;8;Sciences pour l'ingénieur;2018;2017-18;2017;2017;54;13;41;293;70;223;65;16;49;;;;;atMj7
580;École doctorale Sciences et technologies de l'information et de la communication;STIC;1;Mathématiques et leurs interactions;2018;2017-18;2017;2017;3;1;2;11;2;9;6;0;6;;;;;AzCC0
581;École doctorale Agriculture, alimentation, biologie, environnement, santé;ABIES;6;Sciences humaines et humanités;2018;2017-18;2017;2017;12;5;7;59;33;26;12;8;4;;;;;c1x56
581;École doctorale Agriculture, alimentation, biologie, environnement, santé;ABIES;7;Sciences de la société;2018;2017-18;2017;2017;5;0;5;29;11;18;4;3;1;;;;;c1x56
582;École doctorale Cancérologie, Biologie, Médecine, Santé;CBMS;5;Biologie, médecine et santé;2018;2017-18;2017;2017;55;32;23;241;149;92;49;32;17;;;;;75bj4
583;École doctorale Risques et Société;;3;Sciences de la terre et de l'univers, espace;2018;2017-18;2017;2017;1;0;1;1;0;1;0;0;0;;;;;wUBi9
584;École doctorale Biodiversité, Agriculture, Alimentation, Environnement, Terre, Eau;GAIA;3;Sciences de la terre et de l'univers, espace;2018;2017-18;2017;2017;25;7;18;78;27;51;19;9;10;;;;;F1h5f
585;École doctorale Sciences, Technologie,  Sante;EDSTS;1;Mathématiques et leurs interactions;2018;2017-18;2017;2017;10;4;6;22;8;14;4;2;2;;;;;NM3Dl
587;École doctorale Diversites, santé et développement en Amazonie;;1;Mathématiques et leurs interactions;2018;2017-18;2017;2017;0;0;0;1;1;0;0;0;0;;;;;V14tj
587;École doctorale Diversites, santé et développement en Amazonie;;3;Sciences de la terre et de l'univers, espace;2018;2017-18;2017;2017;0;0;0;3;2;1;1;1;0;;;;;V14tj
587;École doctorale Diversites, santé et développement en Amazonie;;8;Sciences pour l'ingénieur;2018;2017-18;2017;2017;0;0;0;2;1;1;3;2;1;;;;;V14tj
589;École doctorale Milieu insulaire tropical à risques : protection, valorisation , santé et développement;;9;Sciences et technologies de l'information et de la communication;2018;2017-18;2017;2017;1;0;1;3;0;3;0;0;0;;;;;2cqi3
599;École doctorale Droit et Science Politique;DSP;7;Sciences de la société;2018;2017-18;2017;2017;69;25;44;398;166;232;29;18;11;;;;;6rwtT
602;École doctorale Sciences pour l'Ingénieur;SPI;8;Sciences pour l'ingénieur;2018;2017-18;2017;2017;149;44;105;536;155;381;105;25;80;;;;;8yWbu
604;École doctorale Sociétés, Temps, Territoires;STT;10;Sciences agronomiques et écologiques;2018;2017-18;2017;2017;1;0;1;7;3;4;1;0;1;;;;;SZI5T
605;École doctorale Biologie Santé;ED BS;10;Sciences agronomiques et écologiques;2018;2017-18;2017;2017;0;0;0;0;0;0;4;1;3;;;;;w8CxU
7;École doctorale Georges Vedel - Droit public interne, science administrative et science politique;;7;Sciences de la société;2011;2010-11;2010;2010;27;10;17;186;70;116;25;8;17;;;;;Dw881
9;École doctorale Droit international, droit européen, relations internationales et droit comparé;;7;Sciences de la société;2011;2010-11;2010;2010;35;23;12;230;128;102;21;9;12;;;;;v1emR
42;École doctorale Entreprise, économie, société;EES;7;Sciences de la société;2011;2010-11;2010;2010;33;12;21;180;65;115;48;14;34;;;;;uO01d
47;École doctorale Physique;;2;Physique;2011;2010-11;2010;2010;93;21;72;356;87;269;77;17;60;;;;;8kNpd
72;École doctorale Sciences pour l'ingénieur;SPI;8;Sciences pour l'ingénieur;2011;2010-11;2010;2010;70;13;57;227;49;178;68;15;53;;;;;47QPx
73;École doctorale Sciences économiques, sociales, de l'aménagement et du management;SESAM;6;Sciences humaines et humanités;2011;2010-11;2010;2010;2;0;2;6;1;5;0;0;0;;;;;IQ0Hk
73;École doctorale Sciences économiques, sociales, de l'aménagement et du management;SESAM;7;Sciences de la société;2011;2010-11;2010;2010;65;35;30;278;127;151;38;12;26;;;;;IQ0Hk
79;École doctorale Sciences juridiques, politiques, économiques et de gestion;SJPEG;7;Sciences de la société;2011;2010-11;2010;2010;49;24;25;196;102;94;28;7;21;;;;;ea4x6
85;École doctorale Sciences de la vie et de la santé;SVS;5;Biologie, médecine et santé;2011;2010-11;2010;2010;43;21;22;130;72;58;28;17;11;;;;;YdiMF
86;École doctorale Sociétés, humanités, arts, lettres;LSHS;7;Sciences de la société;2011;2010-11;2010;2010;16;8;8;61;34;27;5;4;1;;;;;O8E6y
92;École doctorale Vie -  Agro - Santé;;3;Sciences de la terre et de l'univers, espace;2011;2010-11;2010;2010;0;0;0;2;0;2;3;1;2;;;;;RjvXY
92;École doctorale Vie -  Agro - Santé;;5;Biologie, médecine et santé;2011;2010-11;2010;2010;47;20;27;188;90;98;34;15;19;;;;;RjvXY
98;École doctorale Droit-Normandie;EDDN;7;Sciences de la société;2011;2010-11;2010;2010;33;12;21;151;66;85;9;4;5;;;;;9fYyW
101;École doctorale de Sciences juridiques;;9;Sciences et technologies de l'information et de la communication;2011;2010-11;2010;2010;1;0;1;7;3;4;0;0;0;;;;;569G2
102;École doctorale Santé, sciences, technologies;;1;Mathématiques et leurs interactions;2011;2010-11;2010;2010;7;2;5;20;6;14;3;1;2;;;;;4h65n
102;École doctorale Santé, sciences, technologies;;4;Chimie;2011;2010-11;2010;2010;7;0;7;21;6;15;7;3;4;;;;;4h65n
102;École doctorale Santé, sciences, technologies;;6;Sciences humaines et humanités;2011;2010-11;2010;2010;0;0;0;2;1;1;2;1;1;;;;;4h65n
104;École doctorale Sciences de la matière, du rayonnement et de l'environnement;SMRE;4;Chimie;2011;2010-11;2010;2010;64;23;41;218;86;132;52;23;29;;;;;Q5iFz
104;École doctorale Sciences de la matière, du rayonnement et de l'environnement;SMRE;10;Sciences agronomiques et écologiques;2011;2010-11;2010;2010;12;3;9;46;21;25;16;8;8;;;;;Q5iFz
112;École doctorale Archéologie;;6;Sciences humaines et humanités;2011;2010-11;2010;2010;44;28;16;301;180;121;42;22;20;;;;;EvU7R
120;École doctorale Littérature française et comparée;;6;Sciences humaines et humanités;2011;2010-11;2010;2010;54;37;17;346;257;89;37;29;8;;;;;3ULpe
122;École doctorale Europe latine - Amérique latine;;6;Sciences humaines et humanités;2011;2010-11;2010;2010;42;29;13;204;134;70;22;15;7;;;;;z9lZY
138;École doctorale Lettres, langues, spectacles;LLS;6;Sciences humaines et humanités;2011;2010-11;2010;2010;69;45;24;302;194;108;34;29;5;;;;;y9O3k
146;École doctorale Galilée;GALILEE;1;Mathématiques et leurs interactions;2011;2010-11;2010;2010;16;5;11;55;11;44;10;3;7;;;;;71hqm
146;École doctorale Galilée;GALILEE;2;Physique;2011;2010-11;2010;2010;11;3;8;34;8;26;3;1;2;;;;;71hqm
156;École doctorale Sciences de la mer;;3;Sciences de la terre et de l'univers, espace;2011;2010-11;2010;2010;17;8;9;65;26;39;14;6;8;;;;;EGY9P
156;École doctorale Sciences de la mer;;7;Sciences de la société;2011;2010-11;2010;2010;5;3;2;23;8;15;1;0;1;;;;;EGY9P
159;École doctorale Esthétique, sciences et technologies des arts;EDESTA;6;Sciences humaines et humanités;2011;2010-11;2010;2010;67;38;29;284;171;113;24;15;9;;;;;zj1Vj
166;École doctorale Information, structures et systèmes;I2S;5;Biologie, médecine et santé;2011;2010-11;2010;2010;2;1;1;2;1;1;0;0;0;;;;;2uO68
168;École doctorale Sciences chimiques et biologiques pour la santé;SCBS;5;Biologie, médecine et santé;2011;2010-11;2010;2010;93;56;37;370;207;163;99;58;41;;;;;8cEME
177;École doctorale Sciences et technologies de l'université d'Orléans;;8;Sciences pour l'ingénieur;2011;2010-11;2010;2010;15;3;12;49;10;39;14;4;10;;;;;JI65m
180;École doctorale Sciences humaines et sociales : cultures, individus, sociétés;SHS;7;Sciences de la société;2011;2010-11;2010;2010;61;38;23;185;109;76;29;20;9;;;;;D2BT3
181;École doctorale Structure, informations, matière et matériaux;Simem;2;Physique;2011;2010-11;2010;2010;18;5;13;59;15;44;10;2;8;;;;;c1D6f
181;École doctorale Structure, informations, matière et matériaux;Simem;9;Sciences et technologies de l'information et de la communication;2011;2010-11;2010;2010;17;5;12;69;19;50;14;0;14;;;;;c1D6f
182;École doctorale Physique et chimie-physique;;4;Chimie;2011;2010-11;2010;2010;2;1;1;10;3;7;0;0;0;;;;;3My6I
217;École doctorale Mathématiques, sciences et technologies de l'information, informatique;MSTII;1;Mathématiques et leurs interactions;2011;2010-11;2010;2010;27;6;21;93;20;73;21;2;19;;;;;Ehx7v
224;École doctorale Cognition, langage, interaction;;8;Sciences pour l'ingénieur;2011;2010-11;2010;2010;3;2;1;10;4;6;1;0;1;;;;;7v43e
238;École doctorale Sciences humaines et sociales;;6;Sciences humaines et humanités;2011;2010-11;2010;2010;59;28;31;223;118;105;32;15;17;;;;;lr2wn
249;École doctorale Droit comparé;;7;Sciences de la société;2011;2010-11;2010;2010;15;9;6;220;124;96;20;8;12;;;;;yu36C
251;École doctorale Sciences de l'environnement;;6;Sciences humaines et humanités;2011;2010-11;2010;2010;2;1;1;19;9;10;10;7;3;;;;;VR28y
251;École doctorale Sciences de l'environnement;;8;Sciences pour l'ingénieur;2011;2010-11;2010;2010;5;3;2;18;11;7;3;1;2;;;;;VR28y
254;École doctorale Sciences de la matière;;4;Chimie;2011;2010-11;2010;2010;51;20;31;174;60;114;57;21;36;;;;;365F2
260;École doctorale pluridisciplinaire;;6;Sciences humaines et humanités;2011;2010-11;2010;2010;24;17;7;104;67;37;9;3;6;;;;;sCk1f
260;École doctorale pluridisciplinaire;;7;Sciences de la société;2011;2010-11;2010;2010;35;16;19;103;57;46;3;1;2;;;;;sCk1f
284;École doctorale Droit et Science Politique;DSP;6;Sciences humaines et humanités;2011;2010-11;2010;2010;28;14;14;107;67;40;6;5;1;;;;;ahH92
285;École doctorale Sciences pratiques;;1;Mathématiques et leurs interactions;2011;2010-11;2010;2010;6;1;5;35;6;29;5;2;3;;;;;Jd3t2
285;École doctorale Sciences pratiques;;3;Sciences de la terre et de l'univers, espace;2011;2010-11;2010;2010;0;0;0;1;1;0;0;0;0;;;;;Jd3t2
285;École doctorale Sciences pratiques;;4;Chimie;2011;2010-11;2010;2010;5;4;1;19;8;11;0;0;0;;;;;Jd3t2
286;École doctorale de l'Ehess;;6;Sciences humaines et humanités;2011;2010-11;2010;2010;259;144;115;1161;651;510;139;70;69;;;;;2S146
287;École doctorale Sciences pour l'ingénieur;;2;Physique;2011;2010-11;2010;2010;5;4;1;15;7;8;2;0;2;;;;;48Q1j
300;École doctorale Sciences Économiques;ED SE;7;Sciences de la société;2011;2010-11;2010;2010;9;4;5;100;39;61;14;9;5;;;;;5x3fM
305;École doctorale Énergie et environnement;E2;1;Mathématiques et leurs interactions;2011;2010-11;2010;2010;2;0;2;9;0;9;3;1;2;;;;;Kbt8I
306;École doctorale Sciences des procédés, sciences des aliments;;9;Sciences et technologies de l'information et de la communication;2011;2010-11;2010;2010;0;0;0;0;0;0;1;1;0;;;;;adF7W
323;École doctorale Génie électrique, électronique et télécommunications;GEET;5;Biologie, médecine et santé;2011;2010-11;2010;2010;3;2;1;22;10;12;5;2;3;;;;;arcz6
323;École doctorale Génie électrique, électronique et télécommunications;GEET;8;Sciences pour l'ingénieur;2011;2010-11;2010;2010;22;6;16;106;21;85;21;6;15;;;;;arcz6
340;École doctorale Biologie moléculaire, intégrative et cellulaire;BMIC;5;Biologie, médecine et santé;2011;2010-11;2010;2010;74;46;28;322;190;132;69;42;27;;;;;db7xq
341;École doctorale Évolution, écosystèmes, microbiologie, modélisation;E2M2;5;Biologie, médecine et santé;2011;2010-11;2010;2010;15;8;7;69;40;29;5;4;1;;;;;J83I0
351;École doctorale Sciences physiques, mathématiques et de l'information pour l'ingénieur;SPMII;2;Physique;2011;2010-11;2010;2010;9;5;4;42;21;21;7;3;4;;;;;rY4EP
351;École doctorale Sciences physiques, mathématiques et de l'information pour l'ingénieur;SPMII;3;Sciences de la terre et de l'univers, espace;2011;2010-11;2010;2010;0;0;0;0;0;0;1;0;1;;;;;rY4EP
352;École doctorale Physique et sciences de la matière;;3;Sciences de la terre et de l'univers, espace;2011;2010-11;2010;2010;5;1;4;21;9;12;4;0;4;;;;;fb5YC
355;École doctorale Espaces, cultures, sociétés;;6;Sciences humaines et humanités;2011;2010-11;2010;2010;93;60;33;476;287;189;43;22;21;;;;;2kMf5
358;École doctorale Sciences, technologies, santé;;2;Physique;2011;2010-11;2010;2010;8;3;5;24;10;14;4;1;3;;;;;OZA3U
364;École doctorale Sciences fondamentales et appliquées;EDSFA;2;Physique;2011;2010-11;2010;2010;18;4;14;54;13;41;6;3;3;;;;;E483q
364;École doctorale Sciences fondamentales et appliquées;EDSFA;3;Sciences de la terre et de l'univers, espace;2011;2010-11;2010;2010;18;5;13;68;24;44;15;5;10;;;;;E483q
364;École doctorale Sciences fondamentales et appliquées;EDSFA;4;Chimie;2011;2010-11;2010;2010;11;8;3;45;23;22;6;2;4;;;;;E483q
364;École doctorale Sciences fondamentales et appliquées;EDSFA;8;Sciences pour l'ingénieur;2011;2010-11;2010;2010;22;5;17;78;21;57;18;4;14;;;;;E483q
368;École doctorale Sciences et santé;;1;Mathématiques et leurs interactions;2011;2010-11;2010;2010;5;1;4;19;7;12;3;2;1;;;;;4L0a1
368;École doctorale Sciences et santé;;2;Physique;2011;2010-11;2010;2010;2;0;2;10;1;9;5;2;3;;;;;4L0a1
370;École doctorale Lettres, sciences humaines et sociales;LSHS;6;Sciences humaines et humanités;2011;2010-11;2010;2010;41;18;23;266;150;116;30;17;13;;;;;xAXXx
371;École doctorale Louis Pasteur;;4;Chimie;2011;2010-11;2010;2010;12;5;7;29;13;16;2;1;1;;;;;2tr4F
371;École doctorale Louis Pasteur;;7;Sciences de la société;2011;2010-11;2010;2010;1;0;1;7;2;5;1;0;1;;;;;2tr4F
373;École doctorale Santé, information/communications et mathématiques, matière;SICMA;4;Chimie;2011;2010-11;2010;2010;4;1;3;12;8;4;6;4;2;;;;;hTJF5
382;École doctorale Économie, espaces, sociétés, civilisations : pensée critique, politique et pratique sociale;EESC;7;Sciences de la société;2011;2010-11;2010;2010;36;20;16;192;104;88;23;13;10;;;;;9NI1W
390;École doctorale Génie des procédés et technologies avancées;;8;Sciences pour l'ingénieur;2011;2010-11;2010;2010;14;7;7;63;22;41;10;5;5;;;;;sK3wm
391;École doctorale Sciences mécaniques, acoustique et électronique et robotique de Paris;SMAER;8;Sciences pour l'ingénieur;2011;2010-11;2010;2010;54;17;37;231;55;176;45;5;40;;;;;k0eue
392;École doctorale Diversité du vivant;;10;Sciences agronomiques et écologiques;2011;2010-11;2010;2010;28;12;16;84;44;40;29;17;12;;;;;537J0
402;École doctorale Sciences de la vie et de la santé;SVS;5;Biologie, médecine et santé;2011;2010-11;2010;2010;26;16;10;92;51;41;32;9;23;;;;;YKgsU
405;École doctorale Économie, management,mathématiques et physique de Cergy;EM2C;7;Sciences de la société;2011;2010-11;2010;2010;11;3;8;52;27;25;8;4;4;;;;;QbwSB
406;École doctorale Chimie moléculaire de Paris centre;;4;Chimie;2011;2010-11;2010;2010;27;12;15;111;51;60;23;11;12;;;;;a5dKy
409;École doctorale Énergie, mécanique, matériaux;EMMA;4;Chimie;2011;2010-11;2010;2010;30;13;17;121;37;84;27;11;16;;;;;KXlbK
410;École doctorale Sciences et ingénierie des ressources, procédés, produits, environnement;RP2E;4;Chimie;2011;2010-11;2010;2010;3;2;1;16;6;10;3;1;2;;;;;Q5fxV
412;École doctorale Lorraine de chimie et physique moléculaires : synthèses, expériences, simulations, applications : de la molécule aux édifices supramoléculaires;SESAMES;4;Chimie;2011;2010-11;2010;2010;16;5;11;59;22;37;20;5;15;;;;;mvHX2
414;École doctorale Sciences de la vie et de la santé;;4;Chimie;2011;2010-11;2010;2010;1;1;0;4;3;1;0;0;0;;;;;YI4xS
415;"École doctorale Interdisciplinaire ""Arts et métiers""";;5;Biologie, médecine et santé;2011;2010-11;2010;2010;5;1;4;5;1;4;4;3;1;;;;;B3z99
415;"École doctorale Interdisciplinaire ""Arts et métiers""";;7;Sciences de la société;2011;2010-11;2010;2010;29;12;17;29;12;17;24;12;12;;;;;B3z99
417;École doctorale Sciences et Ingénierie;S&I;8;Sciences pour l'ingénieur;2011;2010-11;2010;2010;12;1;11;35;8;27;6;0;6;;;;;SSBvE
417;École doctorale Sciences et Ingénierie;S&I;9;Sciences et technologies de l'information et de la communication;2011;2010-11;2010;2010;18;6;12;52;13;39;9;1;8;;;;;SSBvE
417;École doctorale Sciences et Ingénierie;S&I;10;Sciences agronomiques et écologiques;2011;2010-11;2010;2010;0;0;0;1;0;1;0;0;0;;;;;SSBvE
422;École doctorale Sciences et technologies de l'information, des télécommunications et des systèmes;;5;Biologie, médecine et santé;2011;2010-11;2010;2010;16;9;7;69;31;38;10;5;5;;;;;998UM
435;École doctorale Agriculture, alimentation, biologie, environnement et santé;;2;Physique;2011;2010-11;2010;2010;0;0;0;1;0;1;0;0;0;;;;;mC35U
447;École doctorale de l'école polytechnique;;3;Sciences de la terre et de l'univers, espace;2011;2010-11;2010;2010;0;0;0;16;6;10;4;1;3;;;;;zgCCh
447;École doctorale de l'école polytechnique;;7;Sciences de la société;2011;2010-11;2010;2010;7;3;4;12;4;8;2;2;0;;;;;zgCCh
447;École doctorale de l'école polytechnique;;10;Sciences agronomiques et écologiques;2011;2010-11;2010;2010;0;0;0;1;0;1;1;0;1;;;;;zgCCh
456;École doctorale Sciences du sport, de la motricité et du mouvement humain;;5;Biologie, médecine et santé;2011;2010-11;2010;2010;9;3;6;44;19;25;4;2;2;;;;;GqvEI
458;École doctorale Sciences écologiques, vétérinaires, agronomiques et bioingénieries;SEVAB;10;Sciences agronomiques et écologiques;2011;2010-11;2010;2010;54;35;19;232;124;108;47;28;19;;;;;Yf3TI
462;École doctorale Sciences de l'homme et de la société;;6;Sciences humaines et humanités;2011;2010-11;2010;2010;26;13;13;121;55;66;9;3;6;;;;;KsM6i
463;École doctorale Sciences du mouvement humain;SMH;8;Sciences pour l'ingénieur;2011;2010-11;2010;2010;2;1;1;5;2;3;3;1;2;;;;;UbtlY
465;École doctorale Économie Panthéon Sorbonne;EPS;1;Mathématiques et leurs interactions;2011;2010-11;2010;2010;10;3;7;30;10;20;4;1;3;;;;;MV68S
465;École doctorale Économie Panthéon Sorbonne;EPS;7;Sciences de la société;2011;2010-11;2010;2010;79;37;42;388;155;233;61;33;28;;;;;MV68S
469;École doctorale du Pacifique;EDP;3;Sciences de la terre et de l'univers, espace;2011;2010-11;2010;2010;3;0;3;10;4;6;2;0;2;;;;;t9Z2n
469;École doctorale du Pacifique;EDP;4;Chimie;2011;2010-11;2010;2010;2;1;1;5;2;3;2;2;0;;;;;t9Z2n
470;École doctorale Chimie de Paris-Sud;;4;Chimie;2011;2010-11;2010;2010;65;25;40;247;112;135;61;33;28;;;;;aExpW
477;École doctorale Systèmes intégrés en biologie, agronomie, géosciences, hydrosciences, environnement;SIBAGHE;1;Mathématiques et leurs interactions;2011;2010-11;2010;2010;1;0;1;1;0;1;0;0;0;;;;;zfN3N
477;École doctorale Systèmes intégrés en biologie, agronomie, géosciences, hydrosciences, environnement;SIBAGHE;8;Sciences pour l'ingénieur;2011;2010-11;2010;2010;3;1;2;3;1;2;0;0;0;;;;;zfN3N
480;École doctorale Montaigne-humanités;;3;Sciences de la terre et de l'univers, espace;2011;2010-11;2010;2010;4;1;3;16;5;11;0;0;0;;;;;f3SeZ
481;École doctorale Sciences sociales et humanités;SSH;6;Sciences humaines et humanités;2011;2010-11;2010;2010;38;19;19;111;68;43;6;4;2;;;;;E3z5j
484;École doctorale Lettres, langues, linguistique, arts;3LA;6;Sciences humaines et humanités;2011;2010-11;2010;2010;123;83;40;586;365;221;53;32;21;;;;;BlCQD
486;École doctorale Sciences économiques et de gestion;SEG;6;Sciences humaines et humanités;2011;2010-11;2010;2010;0;0;0;1;1;0;1;0;1;;;;;h1GZ3
488;École doctorale Sciences, ingénierie, santé;SIS;10;Sciences agronomiques et écologiques;2011;2010-11;2010;2010;1;1;0;8;3;5;5;2;3;;;;;Fy2lK
489;École doctorale Sciences et ingénierie des systèmes, de l'environnement et des organisations;SISEO;3;Sciences de la terre et de l'univers, espace;2011;2010-11;2010;2010;5;2;3;27;11;16;8;4;4;;;;;6pT77
489;École doctorale Sciences et ingénierie des systèmes, de l'environnement et des organisations;SISEO;4;Chimie;2011;2010-11;2010;2010;2;2;0;13;8;5;2;0;2;;;;;6pT77
489;École doctorale Sciences et ingénierie des systèmes, de l'environnement et des organisations;SISEO;7;Sciences de la société;2011;2010-11;2010;2010;11;5;6;40;21;19;13;6;7;;;;;6pT77
489;École doctorale Sciences et ingénierie des systèmes, de l'environnement et des organisations;SISEO;8;Sciences pour l'ingénieur;2011;2010-11;2010;2010;13;1;12;59;15;44;15;3;12;;;;;6pT77
489;École doctorale Sciences et ingénierie des systèmes, de l'environnement et des organisations;SISEO;10;Sciences agronomiques et écologiques;2011;2010-11;2010;2010;2;1;1;17;4;13;3;2;1;;;;;6pT77
490;École doctorale Environnement - Santé/STIC;E2S;3;Sciences de la terre et de l'univers, espace;2011;2010-11;2010;2010;12;3;9;42;14;28;6;1;5;;;;;sYTua
490;École doctorale Environnement - Santé/STIC;E2S;4;Chimie;2011;2010-11;2010;2010;2;1;1;8;3;5;2;0;2;;;;;sYTua
490;École doctorale Environnement - Santé/STIC;E2S;8;Sciences pour l'ingénieur;2011;2010-11;2010;2010;1;1;0;10;5;5;2;1;1;;;;;sYTua
492;École doctorale Droit;;7;Sciences de la société;2011;2010-11;2010;2010;94;47;47;484;209;275;31;11;20;;;;;kOQsX
493;École doctorale Erasme;;6;Sciences humaines et humanités;2011;2010-11;2010;2010;52;17;35;190;84;106;13;5;8;;;;;FPW4T
494;École doctorale Jean-Henri Lambert;;1;Mathématiques et leurs interactions;2011;2010-11;2010;2010;1;0;1;5;0;5;1;1;0;;;;;A3m51
494;École doctorale Jean-Henri Lambert;;5;Biologie, médecine et santé;2011;2010-11;2010;2010;2;1;1;11;7;4;4;0;4;;;;;A3m51
495;École doctorale Végétal, environnement, nutrition, agroalimentaire, mer;VENAM;9;Sciences et technologies de l'information et de la communication;2011;2010-11;2010;2010;0;0;0;1;1;0;0;0;0;;;;;HL495
503;École doctorale Sciences et technologies de l'information et de mathématiques;STIM;9;Sciences et technologies de l'information et de la communication;2011;2010-11;2010;2010;52;16;36;245;57;188;52;12;40;;;;;JQevP
504;École doctorale Cognition, éducation, interactions;CEI;6;Sciences humaines et humanités;2011;2010-11;2010;2010;43;24;19;182;107;75;23;11;12;;;;;39naT
505;École doctorale Sciences de l'homme, des organisations et de la société;SHOS;7;Sciences de la société;2011;2010-11;2010;2010;99;43;56;374;165;209;38;11;27;;;;;qts78
510;École doctorale Ingénierie - Matériaux, mécanique, environnement, énergétique, procédés, production;IMEP2;4;Chimie;2011;2010-11;2010;2010;20;8;12;91;32;59;14;5;9;;;;;Ce7NF
510;École doctorale Ingénierie - Matériaux, mécanique, environnement, énergétique, procédés, production;IMEP2;8;Sciences pour l'ingénieur;2011;2010-11;2010;2010;110;28;82;365;107;258;63;16;47;;;;;Ce7NF
510;École doctorale Ingénierie - Matériaux, mécanique, environnement, énergétique, procédés, production;IMEP2;9;Sciences et technologies de l'information et de la communication;2011;2010-11;2010;2010;1;0;1;2;0;2;0;0;0;;;;;Ce7NF
514;École doctorale Études anglophones, germanophones et européennes;EDEAGE;6;Sciences humaines et humanités;2011;2010-11;2010;2010;47;36;11;220;157;63;33;24;9;;;;;fuIQs
515;École doctorale Complexité du vivant;CdV;5;Biologie, médecine et santé;2011;2010-11;2010;2010;70;40;30;267;155;112;73;47;26;;;;;CbV9s
517;École doctorale Particules, noyaux, cosmologie;;2;Physique;2011;2010-11;2010;2010;47;13;34;141;41;100;42;9;33;;;;;9kK48
520;École doctorale Humanités;;6;Sciences humaines et humanités;2011;2010-11;2010;2010;105;59;46;443;271;172;31;16;15;;;;;rI175
521;École doctorale Sciences et ingénierie pour l'information, mathématiques;S2I;1;Mathématiques et leurs interactions;2011;2010-11;2010;2010;21;6;15;70;22;48;11;4;7;;;;;V6i83
521;École doctorale Sciences et ingénierie pour l'information, mathématiques;S2I;9;Sciences et technologies de l'information et de la communication;2011;2010-11;2010;2010;56;12;44;215;42;173;65;14;51;;;;;V6i83
522;École doctorale Sciences et ingénierie en matériaux, mécanique, énergétique et aéronautique;SI-MMEA;2;Physique;2011;2010-11;2010;2010;6;0;6;22;4;18;4;1;3;;;;;82F19
523;École doctorale Sciences pour l'environnement - Gay Lussac;;6;Sciences humaines et humanités;2011;2010-11;2010;2010;1;1;0;6;4;2;3;2;1;;;;;6xD69
523;École doctorale Sciences pour l'environnement - Gay Lussac;;10;Sciences agronomiques et écologiques;2011;2010-11;2010;2010;25;17;8;82;41;41;31;15;16;;;;;6xD69
530;École doctorale Organisations, marchés, institutions;OMI;0;;2011;2010-11;2010;2010;43;43;0;156;156;0;19;19;0;;;;;4htv7
531;École doctorale Sciences, ingénierie et environnement;SIE;9;Sciences et technologies de l'information et de la communication;2011;2010-11;2010;2010;0;0;0;0;0;0;1;1;0;;;;;b5BYq
532;École doctorale Mathématiques et sciences et technologies de l'information et de la communication;MSTIC;9;Sciences et technologies de l'information et de la communication;2011;2010-11;2010;2010;42;11;31;172;45;127;29;7;22;;;;;t43KM
534;École doctorale Modélisation et instrumentation en physique, énergie, géosciences et environnement;MIPEGE;3;Sciences de la terre et de l'univers, espace;2011;2010-11;2010;2010;14;5;9;61;19;42;16;5;11;;;;;K93eR
536;École doctorale Sciences et agrosciences;;10;Sciences agronomiques et écologiques;2011;2010-11;2010;2010;14;10;4;30;16;14;1;1;0;;;;;pHfqe
538;École doctorale Culture, régulation, institutions et territoire;CRIT;7;Sciences de la société;2011;2010-11;2010;2010;39;24;15;222;104;118;19;8;11;;;;;8T505
539;École doctorale Sciences et technologies de Versailles;;4;Chimie;2011;2010-11;2010;2010;9;4;5;33;15;18;6;1;5;;;;;nv3h8
539;École doctorale Sciences et technologies de Versailles;;8;Sciences pour l'ingénieur;2011;2010-11;2010;2010;7;3;4;41;12;29;6;0;6;;;;;nv3h8
540;"École doctorale École transdisciplinaire ""lettres/sciences""";;6;Sciences humaines et humanités;2011;2010-11;2010;2010;6;2;4;7;3;4;0;0;0;;;;;tWWw7
543;École doctorale de Dauphine;;1;Mathématiques et leurs interactions;2011;2010-11;2010;2010;18;0;18;48;8;40;5;2;3;;;;;u8w6A
529;École doctorale Cultures et sociétés;CS;0;;2011;2010-11;2010;2010;25;0;0;134;0;0;11;0;0;;;;;XU9tb
37;École doctorale Sciences physiques pour l'ingénieur et microtechniques;SPIM;9;Sciences et technologies de l'information et de la communication;2014;2013-14;2013;2013;38;11;27;162;32;130;42;8;34;;;;;F7G1B
38;École doctorale Langages, espaces, temps, sociétés;;9;Sciences et technologies de l'information et de la communication;2014;2013-14;2013;2013;1;0;1;5;2;3;0;0;0;;;;;pGgDX
52;École doctorale Physique et astrophysique de Lyon;PHAST;2;Physique;2014;2013-14;2013;2013;45;9;36;159;35;124;36;7;29;;;;;61XPb
60;École doctorale Territoires, temps, sociétés et développement;TTSD;6;Sciences humaines et humanités;2014;2013-14;2013;2013;46;25;21;193;116;77;45;29;16;;;;;fkIh6
60;École doctorale Territoires, temps, sociétés et développement;TTSD;7;Sciences de la société;2014;2013-14;2013;2013;13;3;10;62;32;30;8;1;7;;;;;fkIh6
60;École doctorale Territoires, temps, sociétés et développement;TTSD;10;Sciences agronomiques et écologiques;2014;2013-14;2013;2013;1;1;0;3;2;1;2;1;1;;;;;fkIh6
71;École doctorale Sciences pour l'ingénieur;;8;Sciences pour l'ingénieur;2014;2013-14;2013;2013;43;15;28;200;70;130;44;18;26;;;;;H6UYp
77;École doctorale Informatique, automatique, électronique, électrotechnique, mathématiques;IAEM;1;Mathématiques et leurs interactions;2014;2013-14;2013;2013;10;1;9;40;7;33;9;3;6;;;;;TCHTA
79;École doctorale Sciences juridiques, politiques, économiques et de gestion;SJPEG;7;Sciences de la société;2014;2013-14;2013;2013;42;17;25;191;101;90;27;12;15;;;;;ea4x6
92;École doctorale Vie -  Agro - Santé;;5;Biologie, médecine et santé;2014;2013-14;2013;2013;59;31;28;203;93;110;55;29;26;;;;;RjvXY
98;École doctorale Droit-Normandie;EDDN;7;Sciences de la société;2014;2013-14;2013;2013;26;12;14;149;68;81;17;7;10;;;;;9fYyW
104;École doctorale Sciences de la matière, du rayonnement et de l'environnement;SMRE;3;Sciences de la terre et de l'univers, espace;2014;2013-14;2013;2013;12;2;10;37;9;28;17;7;10;;;;;Q5iFz
104;École doctorale Sciences de la matière, du rayonnement et de l'environnement;SMRE;6;Sciences humaines et humanités;2014;2013-14;2013;2013;0;0;0;7;1;6;0;0;0;;;;;Q5iFz
107;École doctorale Physique de la région parisienne;;2;Physique;2014;2013-14;2013;2013;91;22;69;300;68;232;73;12;61;;;;;O3g7O
109;École doctorale Sciences de la terre;;2;Physique;2014;2013-14;2013;2013;16;4;12;16;4;12;0;0;0;;;;;BQNt6
129;École doctorale Sciences de l'environnement d'Ile de France;SEIF;3;Sciences de la terre et de l'univers, espace;2014;2013-14;2013;2013;47;19;28;203;100;103;63;27;36;;;;;TnAPh
141;École doctorale Droit et science politique;DSP;7;Sciences de la société;2014;2013-14;2013;2013;58;34;24;240;107;133;34;13;21;;;;;CyNBf
145;École doctorale Sciences du végétal : du gène à l'écosystème;;10;Sciences agronomiques et écologiques;2014;2013-14;2013;2013;2;1;1;24;17;7;3;2;1;;;;;ubDmM
146;École doctorale Galilée;GALILEE;8;Sciences pour l'ingénieur;2014;2013-14;2013;2013;7;5;2;28;8;20;14;2;12;;;;;71hqm
154;École doctorale Sciences de la vie et de la santé;SVS;5;Biologie, médecine et santé;2014;2013-14;2013;2013;84;41;43;284;145;139;82;43;39;;;;;hLn36
157;École doctorale Génétique, cellulaire, immunologie, infectiologie et développement;GC2ID;5;Biologie, médecine et santé;2014;2013-14;2013;2013;68;42;26;252;167;85;74;52;22;;;;;Sl3l2
158;École doctorale Cerveau, cognition, comportement;3C;5;Biologie, médecine et santé;2014;2013-14;2013;2013;80;47;33;376;221;155;77;43;34;;;;;Il62F
158;École doctorale Cerveau, cognition, comportement;3C;6;Sciences humaines et humanités;2014;2013-14;2013;2013;3;1;2;9;3;6;3;1;2;;;;;Il62F
166;École doctorale Information, structures et systèmes;I2S;1;Mathématiques et leurs interactions;2014;2013-14;2013;2013;15;4;11;51;16;35;13;4;9;;;;;2uO68
166;École doctorale Information, structures et systèmes;I2S;10;Sciences agronomiques et écologiques;2014;2013-14;2013;2013;0;0;0;3;0;3;0;0;0;;;;;2uO68
178;École doctorale Sciences fondamentales;;4;Chimie;2014;2013-14;2013;2013;22;11;11;61;29;32;17;9;8;;;;;1AiR7
184;École doctorale Mathématiques et informatique de Marseille;;1;Mathématiques et leurs interactions;2014;2013-14;2013;2013;19;6;13;79;26;53;16;4;12;;;;;DDObG
188;École doctorale Histoire moderne et contemporaine;;6;Sciences humaines et humanités;2014;2013-14;2013;2013;33;14;19;196;82;114;31;12;19;;;;;RSZ7F
205;École doctorale Interdisciplinaire Sciences-Santé;EDISS;7;Sciences de la société;2014;2013-14;2013;2013;6;3;3;38;15;23;11;6;5;;;;;69W38
205;École doctorale Interdisciplinaire Sciences-Santé;EDISS;9;Sciences et technologies de l'information et de la communication;2014;2013-14;2013;2013;3;0;3;17;6;11;6;2;4;;;;;69W38
205;École doctorale Interdisciplinaire Sciences-Santé;EDISS;10;Sciences agronomiques et écologiques;2014;2013-14;2013;2013;2;1;1;7;4;3;2;1;1;;;;;69W38
209;École doctorale Sciences physiques et de L'ingénieur;SPI;2;Physique;2014;2013-14;2013;2013;28;8;20;82;16;66;19;4;15;;;;;tZcIZ
211;École doctorale Sciences exactes et leurs applications;ED SEA;6;Sciences humaines et humanités;2014;2013-14;2013;2013;0;0;0;2;1;1;0;0;0;;;;;1G1iC
218;École doctorale Chimie et sciences du vivant;EDCSV;4;Chimie;2014;2013-14;2013;2013;25;14;11;80;44;36;26;13;13;;;;;8bcJh
221;École doctorale Augustin Cournot - Sciences économiques et de gestion - Sciences, technologies et sociétés;EDAC;6;Sciences humaines et humanités;2014;2013-14;2013;2013;2;1;1;10;5;5;1;0;1;;;;;5z9rW
222;École doctorale Sciences chimiques;EDSC;2;Physique;2014;2013-14;2013;2013;2;0;2;2;0;2;0;0;0;;;;;AdU8Q
224;École doctorale Cognition, langage, interaction;;1;Mathématiques et leurs interactions;2014;2013-14;2013;2013;1;0;1;2;0;2;1;0;1;;;;;7v43e
227;École doctorale Sciences de la nature et de l'homme;;9;Sciences et technologies de l'information et de la communication;2014;2013-14;2013;2013;0;0;0;1;1;0;1;1;0;;;;;xiDA5
231;École doctorale Économie et gestion;EDEG;7;Sciences de la société;2014;2013-14;2013;2013;47;22;25;183;92;91;25;17;8;;;;;KT720
240;École doctorale Sciences de l'homme et de la société;SHS;5;Biologie, médecine et santé;2014;2013-14;2013;2013;2;0;2;2;0;2;0;0;0;;;;;j345k
240;École doctorale Sciences de l'homme et de la société;SHS;6;Sciences humaines et humanités;2014;2013-14;2013;2013;68;39;29;287;164;123;39;22;17;;;;;j345k
251;École doctorale Sciences de l'environnement;;4;Chimie;2014;2013-14;2013;2013;3;2;1;16;8;8;5;3;2;;;;;VR28y
251;École doctorale Sciences de l'environnement;;10;Sciences agronomiques et écologiques;2014;2013-14;2013;2013;7;4;3;48;33;15;9;7;2;;;;;VR28y
254;École doctorale Sciences de la matière;;3;Sciences de la terre et de l'univers, espace;2014;2013-14;2013;2013;16;4;12;58;23;35;9;4;5;;;;;365F2
260;École doctorale pluridisciplinaire;;7;Sciences de la société;2014;2013-14;2013;2013;30;12;18;136;73;63;4;2;2;;;;;sCk1f
265;École doctorale Langues, littératures et sociétés du monde;;6;Sciences humaines et humanités;2014;2013-14;2013;2013;47;24;23;247;151;96;33;16;17;;;;;4YWGW
267;École doctorale Arts et médias;;6;Sciences humaines et humanités;2014;2013-14;2013;2013;89;54;35;367;248;119;40;31;9;;;;;eCF5C
269;École doctorale Mathématiques, sciences de l'information et de l'ingénieur;MSII;7;Sciences de la société;2014;2013-14;2013;2013;0;0;0;2;2;0;0;0;0;;;;;5E625
273;École doctorale Biologie et biotechnologie;B2T;5;Biologie, médecine et santé;2014;2013-14;2013;2013;34;20;14;192;119;73;59;40;19;;;;;Wtta6
280;École doctorale Philosophie;;6;Sciences humaines et humanités;2014;2013-14;2013;2013;45;16;29;248;104;144;55;14;41;;;;;kJxnm
285;École doctorale Sciences pratiques;;1;Mathématiques et leurs interactions;2014;2013-14;2013;2013;10;2;8;31;8;23;3;0;3;;;;;Jd3t2
285;École doctorale Sciences pratiques;;4;Chimie;2014;2013-14;2013;2013;4;3;1;14;10;4;5;4;1;;;;;Jd3t2
285;École doctorale Sciences pratiques;;7;Sciences de la société;2014;2013-14;2013;2013;7;2;5;38;20;18;2;1;1;;;;;Jd3t2
287;École doctorale Sciences pour l'ingénieur;;8;Sciences pour l'ingénieur;2014;2013-14;2013;2013;43;13;30;147;52;95;46;13;33;;;;;48Q1j
304;École doctorale Sciences et environnements;;4;Chimie;2014;2013-14;2013;2013;0;0;0;2;1;1;2;2;0;;;;;2ywZn
304;École doctorale Sciences et environnements;;6;Sciences humaines et humanités;2014;2013-14;2013;2013;4;2;2;14;6;8;3;0;3;;;;;2ywZn
305;École doctorale Énergie et environnement;E2;8;Sciences pour l'ingénieur;2014;2013-14;2013;2013;11;6;5;45;15;30;13;3;10;;;;;Kbt8I
323;École doctorale Génie électrique, électronique et télécommunications;GEET;2;Physique;2014;2013-14;2013;2013;0;0;0;1;0;1;0;0;0;;;;;arcz6
326;École doctorale Comportement, langage, éducation, socialisation, cognition;CLESCO;6;Sciences humaines et humanités;2014;2013-14;2013;2013;73;52;21;287;186;101;61;37;24;;;;;nWIlG
327;École doctorale Temps, espaces, sociétés, cultures;TESC;6;Sciences humaines et humanités;2014;2013-14;2013;2013;55;25;30;259;141;118;34;15;19;;;;;IjgiJ
351;École doctorale Sciences physiques, mathématiques et de l'information pour l'ingénieur;SPMII;1;Mathématiques et leurs interactions;2014;2013-14;2013;2013;9;1;8;30;11;19;13;6;7;;;;;rY4EP
351;École doctorale Sciences physiques, mathématiques et de l'information pour l'ingénieur;SPMII;9;Sciences et technologies de l'information et de la communication;2014;2013-14;2013;2013;21;5;16;115;43;72;27;6;21;;;;;rY4EP
353;École doctorale Sciences pour l'ingénieur : mécanique, physique, micro et nanoélectronique;;4;Chimie;2014;2013-14;2013;2013;1;1;0;3;3;0;0;0;0;;;;;vk5Kp
355;École doctorale Espaces, cultures, sociétés;;6;Sciences humaines et humanités;2014;2013-14;2013;2013;47;30;17;223;134;89;35;20;15;;;;;2kMf5
356;École doctorale Cognition, langage, éducation;;6;Sciences humaines et humanités;2014;2013-14;2013;2013;88;52;36;331;206;125;61;29;32;;;;;55Cpz
361;École doctorale Sciences et Technologies;ED ST;6;Sciences humaines et humanités;2014;2013-14;2013;2013;5;3;2;12;7;5;3;0;3;;;;;cOUmL
361;École doctorale Sciences et Technologies;ED ST;9;Sciences et technologies de l'information et de la communication;2014;2013-14;2013;2013;29;12;17;121;44;77;27;11;16;;;;;cOUmL
370;École doctorale Lettres, sciences humaines et sociales;LSHS;6;Sciences humaines et humanités;2014;2013-14;2013;2013;40;18;22;226;123;103;34;18;16;;;;;xAXXx
377;École doctorale Environnement et société;;2;Physique;2014;2013-14;2013;2013;2;1;1;13;3;10;0;0;0;;;;;ZMG5u
377;École doctorale Environnement et société;;9;Sciences et technologies de l'information et de la communication;2014;2013-14;2013;2013;4;1;3;9;1;8;3;0;3;;;;;ZMG5u
377;École doctorale Environnement et société;;10;Sciences agronomiques et écologiques;2014;2013-14;2013;2013;0;0;0;2;1;1;0;0;0;;;;;ZMG5u
378;École doctorale Sciences de l'homme et de la société;SHS;6;Sciences humaines et humanités;2014;2013-14;2013;2013;13;6;7;79;42;37;7;0;7;;;;;3XKuF
382;École doctorale Économie, espaces, sociétés, civilisations : pensée critique, politique et pratique sociale;EESC;7;Sciences de la société;2014;2013-14;2013;2013;27;17;10;111;60;51;15;8;7;;;;;9NI1W
386;École doctorale Sciences mathématiques de Paris centre;SMPC;1;Mathématiques et leurs interactions;2014;2013-14;2013;2013;126;34;92;497;119;378;114;26;88;;;;;wMj98
387;École doctorale Interdisciplinaire pour le vivant;I-ViV;5;Biologie, médecine et santé;2014;2013-14;2013;2013;0;0;0;0;0;0;31;18;13;;;;;06uKM
391;École doctorale Sciences mécaniques, acoustique et électronique et robotique de Paris;SMAER;8;Sciences pour l'ingénieur;2014;2013-14;2013;2013;45;7;38;223;42;181;67;13;54;;;;;k0eue
392;École doctorale Diversité du vivant;;10;Sciences agronomiques et écologiques;2014;2013-14;2013;2013;12;8;4;48;28;20;14;7;7;;;;;537J0
395;École doctorale Milieux, cultures et sociétés du passé et du présent;MCSPP;6;Sciences humaines et humanités;2014;2013-14;2013;2013;56;37;19;347;234;113;37;26;11;;;;;2quEb
395;École doctorale Milieux, cultures et sociétés du passé et du présent;MCSPP;7;Sciences de la société;2014;2013-14;2013;2013;16;13;3;108;74;34;15;8;7;;;;;2quEb
397;École doctorale Physique et chimie des matériaux;;2;Physique;2014;2013-14;2013;2013;28;12;16;99;31;68;28;12;16;;;;;WxSt9
400;École doctorale Savoirs scientifiques : épistémologie, histoire des sciences, didactique des disciplines;;4;Chimie;2014;2013-14;2013;2013;0;0;0;1;1;0;0;0;0;;;;;nRax3
406;École doctorale Chimie moléculaire de Paris centre;;4;Chimie;2014;2013-14;2013;2013;26;6;20;109;40;69;32;12;20;;;;;a5dKy
410;École doctorale Sciences et ingénierie des ressources, procédés, produits, environnement;RP2E;4;Chimie;2014;2013-14;2013;2013;3;0;3;19;8;11;3;0;3;;;;;Q5fxV
413;École doctorale Sciences de la terre et de l'environnement;STE;8;Sciences pour l'ingénieur;2014;2013-14;2013;2013;0;0;0;2;2;0;0;0;0;;;;;u9BA9
414;École doctorale Sciences de la vie et de la santé;;6;Sciences humaines et humanités;2014;2013-14;2013;2013;1;0;1;3;1;2;0;0;0;;;;;YI4xS
423;École doctorale Des génomes aux organismes;;5;Biologie, médecine et santé;2014;2013-14;2013;2013;21;10;11;124;65;59;29;17;12;;;;;VguHK
425;École doctorale Innovation thérapeutique : du fondamental à l'appliqué;;4;Chimie;2014;2013-14;2013;2013;12;6;6;37;18;19;9;3;6;;;;;DkgNy
433;École doctorale Concepts et langages;;6;Sciences humaines et humanités;2014;2013-14;2013;2013;92;52;40;443;252;191;68;37;31;;;;;v8q34
435;École doctorale Agriculture, alimentation, biologie, environnement et santé;;1;Mathématiques et leurs interactions;2014;2013-14;2013;2013;0;0;0;0;0;0;3;2;1;;;;;mC35U
435;École doctorale Agriculture, alimentation, biologie, environnement et santé;;10;Sciences agronomiques et écologiques;2014;2013-14;2013;2013;47;30;17;115;71;44;20;12;8;;;;;mC35U
441;École doctorale Histoire de l'art;;6;Sciences humaines et humanités;2014;2013-14;2013;2013;37;26;11;258;187;71;35;24;11;;;;;d5W3U
446;École doctorale Biologie - Santé;EDBSL;6;Sciences humaines et humanités;2014;2013-14;2013;2013;0;0;0;0;0;0;2;1;1;;;;;4iEUF
446;École doctorale Biologie - Santé;EDBSL;10;Sciences agronomiques et écologiques;2014;2013-14;2013;2013;0;0;0;0;0;0;2;1;1;;;;;4iEUF
447;École doctorale de l'école polytechnique;;1;Mathématiques et leurs interactions;2014;2013-14;2013;2013;34;4;30;98;16;82;21;3;18;;;;;zgCCh
447;École doctorale de l'école polytechnique;;7;Sciences de la société;2014;2013-14;2013;2013;7;4;3;28;8;20;3;1;2;;;;;zgCCh
447;École doctorale de l'école polytechnique;;9;Sciences et technologies de l'information et de la communication;2014;2013-14;2013;2013;21;5;16;84;16;68;20;6;14;;;;;zgCCh
454;École doctorale Sciences de l'homme, du politique et du territoire;SHPT;7;Sciences de la société;2014;2013-14;2013;2013;21;11;10;127;60;67;16;11;5;;;;;Opv31
455;École doctorale Économie, Gestion, Information et Communication;EGIC;9;Sciences et technologies de l'information et de la communication;2014;2013-14;2013;2013;6;4;2;69;39;30;9;5;4;;;;;qCOg3
463;École doctorale Sciences du mouvement humain;SMH;7;Sciences de la société;2014;2013-14;2013;2013;1;0;1;4;0;4;0;0;0;;;;;UbtlY
469;École doctorale du Pacifique;EDP;6;Sciences humaines et humanités;2014;2013-14;2013;2013;5;2;3;21;14;7;4;2;2;;;;;t9Z2n
473;École doctorale Sciences de l'homme et de la société;SHS;6;Sciences humaines et humanités;2014;2013-14;2013;2013;122;73;49;553;329;224;64;44;20;;;;;8qKD9
474;École doctorale Interdisciplinaire européenne frontières du vivant;FDV;1;Mathématiques et leurs interactions;2014;2013-14;2013;2013;2;1;1;5;2;3;1;0;1;;;;;E727j
474;École doctorale Interdisciplinaire européenne frontières du vivant;FDV;4;Chimie;2014;2013-14;2013;2013;0;0;0;0;0;0;1;1;0;;;;;E727j
474;École doctorale Interdisciplinaire européenne frontières du vivant;FDV;9;Sciences et technologies de l'information et de la communication;2014;2013-14;2013;2013;0;0;0;1;0;1;0;0;0;;;;;E727j
477;École doctorale Systèmes intégrés en biologie, agronomie, géosciences, hydrosciences, environnement;SIBAGHE;5;Biologie, médecine et santé;2014;2013-14;2013;2013;18;12;6;71;37;34;18;13;5;;;;;zfN3N
477;École doctorale Systèmes intégrés en biologie, agronomie, géosciences, hydrosciences, environnement;SIBAGHE;10;Sciences agronomiques et écologiques;2014;2013-14;2013;2013;77;40;37;295;158;137;61;37;24;;;;;zfN3N
483;École doctorale Histoire, géographie, aménagement, urbanisme, archéologie, science politique, sociologie, anthropologie;SCSO;6;Sciences humaines et humanités;2014;2013-14;2013;2013;104;45;59;557;268;289;71;33;38;;;;;hc6u4
485;École doctorale Éducation, Psychologie, Information et Communication;EPIC;7;Sciences de la société;2014;2013-14;2013;2013;0;0;0;6;1;5;2;1;1;;;;;O82eL
485;École doctorale Éducation, Psychologie, Information et Communication;EPIC;9;Sciences et technologies de l'information et de la communication;2014;2013-14;2013;2013;11;6;5;41;22;19;9;4;5;;;;;O82eL
488;École doctorale Sciences, ingénierie, santé;SIS;1;Mathématiques et leurs interactions;2014;2013-14;2013;2013;6;0;6;12;4;8;1;0;1;;;;;Fy2lK
488;École doctorale Sciences, ingénierie, santé;SIS;8;Sciences pour l'ingénieur;2014;2013-14;2013;2013;26;9;17;95;34;61;32;11;21;;;;;Fy2lK
488;École doctorale Sciences, ingénierie, santé;SIS;9;Sciences et technologies de l'information et de la communication;2014;2013-14;2013;2013;54;11;43;156;35;121;37;11;26;;;;;Fy2lK
489;École doctorale Sciences et ingénierie des systèmes, de l'environnement et des organisations;SISEO;9;Sciences et technologies de l'information et de la communication;2014;2013-14;2013;2013;2;1;1;18;5;13;2;1;1;;;;;6pT77
498;École doctorale Sciences pour l'ingénieur, géosciences, architecture;SPIGA;3;Sciences de la terre et de l'univers, espace;2014;2013-14;2013;2013;4;0;4;22;10;12;4;2;2;;;;;0vlKH
500;École doctorale Matière, molécules, matériaux en Pays de Loire;3MPL;2;Physique;2014;2013-14;2013;2013;21;9;12;103;27;76;35;5;30;;;;;822tM
503;École doctorale Sciences et technologies de l'information et de mathématiques;STIM;1;Mathématiques et leurs interactions;2014;2013-14;2013;2013;13;3;10;55;16;39;11;4;7;;;;;JQevP
505;École doctorale Sciences de l'homme, des organisations et de la société;SHOS;7;Sciences de la société;2014;2013-14;2013;2013;99;41;58;391;184;207;44;14;30;;;;;qts78
507;École doctorale Sciences humaines et sociales;;6;Sciences humaines et humanités;2014;2013-14;2013;2013;95;51;44;404;212;192;58;33;25;;;;;3e7VM
510;École doctorale Ingénierie - Matériaux, mécanique, environnement, énergétique, procédés, production;IMEP2;8;Sciences pour l'ingénieur;2014;2013-14;2013;2013;99;18;81;391;109;282;94;34;60;;;;;Ce7NF
511;École doctorale Sciences et ingénierie;S&I;9;Sciences et technologies de l'information et de la communication;2014;2013-14;2013;2013;15;3;12;70;19;51;21;8;13;;;;;7aXuB
512;École doctorale Informatique et mathématiques;InfoMaths;1;Mathématiques et leurs interactions;2014;2013-14;2013;2013;18;5;13;65;13;52;10;3;7;;;;;t86bi
512;École doctorale Informatique et mathématiques;InfoMaths;9;Sciences et technologies de l'information et de la communication;2014;2013-14;2013;2013;54;15;39;248;74;174;45;8;37;;;;;t86bi
513;École doctorale Droit et sciences politiques, économiques et de gestion;DESPEG;7;Sciences de la société;2014;2013-14;2013;2013;71;28;43;389;192;197;58;34;24;;;;;aVHGU
516;École doctorale Biochimie, biothérapies, biologie moléculaire, infectiologie;B3MI;5;Biologie, médecine et santé;2014;2013-14;2013;2013;71;39;32;313;173;140;75;49;26;;;;;aQTO2
517;École doctorale Particules, noyaux, cosmologie;;3;Sciences de la terre et de l'univers, espace;2014;2013-14;2013;2013;2;0;2;2;0;2;1;0;1;;;;;9kK48
524;École doctorale Biologie - santé;;5;Biologie, médecine et santé;2014;2013-14;2013;2013;35;20;15;137;75;62;38;17;21;;;;;S7Kk6
527;École doctorale Cognition, comportement, langage(s);CCL;6;Sciences humaines et humanités;2014;2013-14;2013;2013;24;17;7;93;61;32;12;6;6;;;;;MvpY8
531;École doctorale Sciences, ingénierie et environnement;SIE;2;Physique;2014;2013-14;2013;2013;11;6;5;29;10;19;6;2;4;;;;;b5BYq
531;École doctorale Sciences, ingénierie et environnement;SIE;3;Sciences de la terre et de l'univers, espace;2014;2013-14;2013;2013;7;4;3;41;24;17;13;8;5;;;;;b5BYq
531;École doctorale Sciences, ingénierie et environnement;SIE;10;Sciences agronomiques et écologiques;2014;2013-14;2013;2013;2;1;1;9;4;5;3;3;0;;;;;b5BYq
534;École doctorale Modélisation et instrumentation en physique, énergie, géosciences et environnement;MIPEGE;4;Chimie;2014;2013-14;2013;2013;2;1;1;10;4;6;1;1;0;;;;;K93eR
536;École doctorale Sciences et agrosciences;;1;Mathématiques et leurs interactions;2014;2013-14;2013;2013;11;5;6;26;10;16;6;0;6;;;;;pHfqe
536;École doctorale Sciences et agrosciences;;3;Sciences de la terre et de l'univers, espace;2014;2013-14;2013;2013;5;3;2;19;9;10;2;2;0;;;;;pHfqe
536;École doctorale Sciences et agrosciences;;10;Sciences agronomiques et écologiques;2014;2013-14;2013;2013;19;8;11;64;28;36;17;10;7;;;;;pHfqe
537;École doctorale Culture et patrimoine;C&P;7;Sciences de la société;2014;2013-14;2013;2013;13;7;6;78;50;28;16;7;9;;;;;GxI4a
539;École doctorale Sciences et technologies de Versailles;;1;Mathématiques et leurs interactions;2014;2013-14;2013;2013;4;2;2;13;5;8;4;2;2;;;;;nv3h8
539;École doctorale Sciences et technologies de Versailles;;8;Sciences pour l'ingénieur;2014;2013-14;2013;2013;6;0;6;32;6;26;13;3;10;;;;;nv3h8
544;École doctorale Inter-Med : Espaces, temps, cultures;INTER-MED;6;Sciences humaines et humanités;2014;2013-14;2013;2013;66;31;35;269;126;143;40;13;27;;;;;7VjtD
547;École doctorale Sciences, Technologie, Santé;EDSTS;1;Mathématiques et leurs interactions;2014;2013-14;2013;2013;6;0;6;22;5;17;10;3;7;;;;;wEdn2
547;École doctorale Sciences, Technologie, Santé;EDSTS;2;Physique;2014;2013-14;2013;2013;7;0;7;30;7;23;10;4;6;;;;;wEdn2
547;École doctorale Sciences, Technologie, Santé;EDSTS;3;Sciences de la terre et de l'univers, espace;2014;2013-14;2013;2013;1;0;1;5;1;4;0;0;0;;;;;wEdn2
547;École doctorale Sciences, Technologie, Santé;EDSTS;5;Biologie, médecine et santé;2014;2013-14;2013;2013;40;21;19;148;75;73;35;22;13;;;;;wEdn2
547;École doctorale Sciences, Technologie, Santé;EDSTS;8;Sciences pour l'ingénieur;2014;2013-14;2013;2013;17;8;9;87;23;64;18;7;11;;;;;wEdn2
548;École doctorale Mer et Sciences;;1;Mathématiques et leurs interactions;2014;2013-14;2013;2013;2;0;2;9;2;7;3;2;1;;;;;QX0fS
548;École doctorale Mer et Sciences;;10;Sciences agronomiques et écologiques;2014;2013-14;2013;2013;0;0;0;1;0;1;0;0;0;;;;;QX0fS
549;École doctorale Santé, Sciences Biologiques et Chimie du Vivant;SSBCV;10;Sciences agronomiques et écologiques;2014;2013-14;2013;2013;7;3;4;15;4;11;3;3;0;;;;;B9ggO
551;École doctorale Mathématiques, Informatique, Physique Théorique et Ingénierie des Systèmes;MIPTIS;1;Mathématiques et leurs interactions;2014;2013-14;2013;2013;7;2;5;25;9;16;6;0;6;;;;;Mpudz
552;École doctorale Énergie - Matériaux - Sciences de la Terre et de l'Univers;EMTSU;4;Chimie;2014;2013-14;2013;2013;16;6;10;51;18;33;15;5;10;;;;;NTZhw
553;École doctorale Carnot - Pasteur;;2;Physique;2014;2013-14;2013;2013;13;6;7;50;15;35;12;1;11;;;;;6h4Z7
554;École doctorale Environnements - Santé;E-S;9;Sciences et technologies de l'information et de la communication;2014;2013-14;2013;2013;0;0;0;3;1;2;1;0;1;;;;;ElyFU
19;École doctorale Littératures françaises et comparée;;6;Sciences humaines et humanités;2015;2014-15;2014;2014;73;49;24;301;199;102;56;46;10;;;;;13M43
20;École doctorale Civilisations, cultures, littératures et sociétés;;6;Sciences humaines et humanités;2015;2014-15;2014;2014;53;34;19;220;152;68;38;22;16;;;;;agjNi
34;École doctorale Matériaux;;8;Sciences pour l'ingénieur;2015;2014-15;2014;2014;15;7;8;77;24;53;23;7;16;;;;;1Iufh
52;École doctorale Physique et astrophysique de Lyon;PHAST;2;Physique;2015;2014-15;2014;2014;45;8;37;162;38;124;35;9;26;;;;;61XPb
60;École doctorale Territoires, temps, sociétés et développement;TTSD;6;Sciences humaines et humanités;2015;2014-15;2014;2014;44;26;18;184;111;73;34;15;19;;;;;fkIh6
60;École doctorale Territoires, temps, sociétés et développement;TTSD;7;Sciences de la société;2015;2014-15;2014;2014;14;9;5;62;36;26;8;5;3;;;;;fkIh6
71;École doctorale Sciences pour l'ingénieur;;8;Sciences pour l'ingénieur;2015;2014-15;2014;2014;46;24;22;209;81;128;37;12;25;;;;;H6UYp
72;École doctorale Sciences pour l'ingénieur;SPI;1;Mathématiques et leurs interactions;2015;2014-15;2014;2014;14;5;9;72;20;52;16;4;12;;;;;47QPx
73;École doctorale Sciences économiques, sociales, de l'aménagement et du management;SESAM;6;Sciences humaines et humanités;2015;2014-15;2014;2014;10;3;7;34;8;26;3;1;2;;;;;IQ0Hk
74;École doctorale Sciences juridiques, politique et de gestion;SJPG;7;Sciences de la société;2015;2014-15;2014;2014;52;27;25;286;133;153;36;19;17;;;;;3A2RY
79;École doctorale Sciences juridiques, politiques, économiques et de gestion;SJPEG;7;Sciences de la société;2015;2014-15;2014;2014;31;14;17;169;82;87;27;18;9;;;;;ea4x6
84;École doctorale Sciences et technologies de l'information et de la communication;STIC;9;Sciences et technologies de l'information et de la communication;2015;2014-15;2014;2014;43;13;30;189;44;145;53;13;40;;;;;9wS2W
92;École doctorale Vie -  Agro - Santé;;6;Sciences humaines et humanités;2015;2014-15;2014;2014;2;0;2;10;1;9;3;1;2;;;;;RjvXY
104;École doctorale Sciences de la matière, du rayonnement et de l'environnement;SMRE;4;Chimie;2015;2014-15;2014;2014;70;38;32;227;100;127;63;20;43;;;;;Q5iFz
104;École doctorale Sciences de la matière, du rayonnement et de l'environnement;SMRE;5;Biologie, médecine et santé;2015;2014-15;2014;2014;1;1;0;2;2;0;2;1;1;;;;;Q5iFz
104;École doctorale Sciences de la matière, du rayonnement et de l'environnement;SMRE;6;Sciences humaines et humanités;2015;2014-15;2014;2014;0;0;0;4;0;4;1;1;0;;;;;Q5iFz
145;École doctorale Sciences du végétal : du gène à l'écosystème;;10;Sciences agronomiques et écologiques;2015;2014-15;2014;2014;3;1;2;21;13;8;3;2;1;;;;;ubDmM
146;École doctorale Galilée;GALILEE;2;Physique;2015;2014-15;2014;2014;9;1;8;31;10;21;13;3;10;;;;;71hqm
146;École doctorale Galilée;GALILEE;6;Sciences humaines et humanités;2015;2014-15;2014;2014;2;2;0;2;2;0;0;0;0;;;;;71hqm
151;École doctorale Biologie, santé, biotechnologies;;5;Biologie, médecine et santé;2015;2014-15;2014;2014;107;57;50;369;214;155;68;41;27;;;;;yP8w4
156;École doctorale Sciences de la mer;;3;Sciences de la terre et de l'univers, espace;2015;2014-15;2014;2014;17;8;9;69;31;38;14;4;10;;;;;EGY9P
158;École doctorale Cerveau, cognition, comportement;3C;5;Biologie, médecine et santé;2015;2014-15;2014;2014;91;57;34;391;226;165;88;56;32;;;;;Il62F
159;École doctorale Esthétique, sciences et technologies des arts;EDESTA;6;Sciences humaines et humanités;2015;2014-15;2014;2014;55;37;18;286;177;109;29;20;9;;;;;zj1Vj
160;École doctorale Électronique, électrotechnique, automatique;EEA;8;Sciences pour l'ingénieur;2015;2014-15;2014;2014;25;7;18;95;23;72;32;6;26;;;;;EgfMQ
162;École doctorale Mécanique, énergétique, génie civil, acoustique;MEGA;5;Biologie, médecine et santé;2015;2014-15;2014;2014;2;1;1;4;2;2;1;1;0;;;;;7wCke
162;École doctorale Mécanique, énergétique, génie civil, acoustique;MEGA;8;Sciences pour l'ingénieur;2015;2014-15;2014;2014;82;20;62;385;101;284;104;19;85;;;;;7wCke
166;École doctorale Information, structures et systèmes;I2S;4;Chimie;2015;2014-15;2014;2014;3;2;1;3;2;1;0;0;0;;;;;2uO68
181;École doctorale Structure, informations, matière et matériaux;Simem;2;Physique;2015;2014-15;2014;2014;16;2;14;49;9;40;13;2;11;;;;;c1D6f
182;École doctorale Physique et chimie-physique;;8;Sciences pour l'ingénieur;2015;2014-15;2014;2014;0;0;0;4;0;4;0;0;0;;;;;3My6I
184;École doctorale Mathématiques et informatique de Marseille;;2;Physique;2015;2014-15;2014;2014;0;0;0;1;1;0;0;0;0;;;;;DDObG
205;École doctorale Interdisciplinaire Sciences-Santé;EDISS;6;Sciences humaines et humanités;2015;2014-15;2014;2014;9;5;4;16;7;9;6;1;5;;;;;69W38
206;École doctorale Chimie : chimie, procédés, environnement;;2;Physique;2015;2014-15;2014;2014;3;1;2;13;2;11;5;0;5;;;;;m0UhD
206;École doctorale Chimie : chimie, procédés, environnement;;4;Chimie;2015;2014-15;2014;2014;84;29;55;320;143;177;74;38;36;;;;;m0UhD
211;École doctorale Sciences exactes et leurs applications;ED SEA;3;Sciences de la terre et de l'univers, espace;2015;2014-15;2014;2014;0;0;0;10;4;6;1;0;1;;;;;1G1iC
211;École doctorale Sciences exactes et leurs applications;ED SEA;10;Sciences agronomiques et écologiques;2015;2014-15;2014;2014;4;1;3;11;7;4;3;3;0;;;;;1G1iC
216;École doctorale Ingénierie pour la santé, la cognition, l'environnement;EDISCE;3;Sciences de la terre et de l'univers, espace;2015;2014-15;2014;2014;0;0;0;1;0;1;0;0;0;;;;;fPs1t
216;École doctorale Ingénierie pour la santé, la cognition, l'environnement;EDISCE;9;Sciences et technologies de l'information et de la communication;2015;2014-15;2014;2014;6;3;3;24;8;16;5;1;4;;;;;fPs1t
218;École doctorale Chimie et sciences du vivant;EDCSV;5;Biologie, médecine et santé;2015;2014-15;2014;2014;45;26;19;223;128;95;53;30;23;;;;;8bcJh
227;École doctorale Sciences de la nature et de l'homme;;5;Biologie, médecine et santé;2015;2014-15;2014;2014;40;24;16;139;86;53;37;18;19;;;;;xiDA5
227;École doctorale Sciences de la nature et de l'homme;;6;Sciences humaines et humanités;2015;2014-15;2014;2014;13;8;5;48;30;18;10;6;4;;;;;xiDA5
227;École doctorale Sciences de la nature et de l'homme;;7;Sciences de la société;2015;2014-15;2014;2014;0;0;0;2;1;1;0;0;0;;;;;xiDA5
227;École doctorale Sciences de la nature et de l'homme;;10;Sciences agronomiques et écologiques;2015;2014-15;2014;2014;18;7;11;32;19;13;6;3;3;;;;;xiDA5
234;École doctorale de Sciences Po;;7;Sciences de la société;2015;2014-15;2014;2014;70;34;36;361;184;177;61;32;29;;;;;ux756
240;École doctorale Sciences de l'homme et de la société;SHS;5;Biologie, médecine et santé;2015;2014-15;2014;2014;3;1;2;5;1;4;0;0;0;;;;;j345k
240;École doctorale Sciences de l'homme et de la société;SHS;6;Sciences humaines et humanités;2015;2014-15;2014;2014;57;32;25;273;154;119;38;28;10;;;;;j345k
245;École doctorale Sciences économiques, juridiques, politiques et de gestion;;7;Sciences de la société;2015;2014-15;2014;2014;46;16;30;281;112;169;33;13;20;;;;;ShLUg
251;École doctorale Sciences de l'environnement;;8;Sciences pour l'ingénieur;2015;2014-15;2014;2014;2;1;1;18;10;8;2;1;1;;;;;VR28y
254;École doctorale Sciences de la matière;;3;Sciences de la terre et de l'univers, espace;2015;2014-15;2014;2014;16;5;11;56;20;36;16;6;10;;;;;365F2
263;École doctorale Sciences juridiques, économiques et de gestion;;7;Sciences de la société;2015;2014-15;2014;2014;23;7;16;157;70;87;18;10;8;;;;;1nUr6
269;École doctorale Mathématiques, sciences de l'information et de l'ingénieur;MSII;4;Chimie;2015;2014-15;2014;2014;0;0;0;1;0;1;0;0;0;;;;;5E625
269;École doctorale Mathématiques, sciences de l'information et de l'ingénieur;MSII;5;Biologie, médecine et santé;2015;2014-15;2014;2014;1;0;1;2;1;1;0;0;0;;;;;5E625
269;École doctorale Mathématiques, sciences de l'information et de l'ingénieur;MSII;9;Sciences et technologies de l'information et de la communication;2015;2014-15;2014;2014;6;1;5;42;10;32;6;0;6;;;;;5E625
275;École doctorale Sciences de gestion;EDSG;7;Sciences de la société;2015;2014-15;2014;2014;14;8;6;14;8;6;18;9;9;;;;;6QC4I
285;École doctorale Sciences pratiques;;1;Mathématiques et leurs interactions;2015;2014-15;2014;2014;9;0;9;34;6;28;4;1;3;;;;;Jd3t2
285;École doctorale Sciences pratiques;;4;Chimie;2015;2014-15;2014;2014;3;2;1;13;10;3;4;2;2;;;;;Jd3t2
286;École doctorale de l'Ehess;;6;Sciences humaines et humanités;2015;2014-15;2014;2014;76;37;39;560;310;250;73;45;28;;;;;2S146
305;École doctorale Énergie et environnement;E2;3;Sciences de la terre et de l'univers, espace;2015;2014-15;2014;2014;2;2;0;13;7;6;5;4;1;;;;;Kbt8I
305;École doctorale Énergie et environnement;E2;9;Sciences et technologies de l'information et de la communication;2015;2014-15;2014;2014;4;1;3;13;4;9;2;0;2;;;;;Kbt8I
306;École doctorale Sciences des procédés, sciences des aliments;;5;Biologie, médecine et santé;2015;2014-15;2014;2014;1;1;0;18;6;12;2;2;0;;;;;adF7W
323;École doctorale Génie électrique, électronique et télécommunications;GEET;1;Mathématiques et leurs interactions;2015;2014-15;2014;2014;0;0;0;1;1;0;1;0;1;;;;;arcz6
323;École doctorale Génie électrique, électronique et télécommunications;GEET;2;Physique;2015;2014-15;2014;2014;18;6;12;65;19;46;10;2;8;;;;;arcz6
351;École doctorale Sciences physiques, mathématiques et de l'information pour l'ingénieur;SPMII;2;Physique;2015;2014-15;2014;2014;13;4;9;49;13;36;10;4;6;;;;;rY4EP
351;École doctorale Sciences physiques, mathématiques et de l'information pour l'ingénieur;SPMII;8;Sciences pour l'ingénieur;2015;2014-15;2014;2014;35;7;28;149;34;115;28;7;21;;;;;rY4EP
353;École doctorale Sciences pour l'ingénieur : mécanique, physique, micro et nanoélectronique;;1;Mathématiques et leurs interactions;2015;2014-15;2014;2014;0;0;0;0;0;0;1;0;1;;;;;vk5Kp
359;École doctorale Mathématiques, télécommunications, informatique, signal, systèmes, électronique;MATISSE;8;Sciences pour l'ingénieur;2015;2014-15;2014;2014;1;0;1;2;1;1;0;0;0;;;;;Y0r76
361;École doctorale Sciences et Technologies;ED ST;6;Sciences humaines et humanités;2015;2014-15;2014;2014;4;3;1;14;9;5;3;2;1;;;;;cOUmL
364;École doctorale Sciences fondamentales et appliquées;EDSFA;8;Sciences pour l'ingénieur;2015;2014-15;2014;2014;9;1;8;65;19;46;14;3;11;;;;;E483q
364;École doctorale Sciences fondamentales et appliquées;EDSFA;10;Sciences agronomiques et écologiques;2015;2014-15;2014;2014;2;1;1;17;11;6;1;0;1;;;;;E483q
370;École doctorale Lettres, sciences humaines et sociales;LSHS;7;Sciences de la société;2015;2014-15;2014;2014;1;1;0;4;3;1;1;1;0;;;;;xAXXx
373;École doctorale Santé, information/communications et mathématiques, matière;SICMA;9;Sciences et technologies de l'information et de la communication;2015;2014-15;2014;2014;68;11;57;252;53;199;52;12;40;;;;;hTJF5
377;École doctorale Environnement et société;;4;Chimie;2015;2014-15;2014;2014;5;3;2;11;5;6;4;3;1;;;;;ZMG5u
377;École doctorale Environnement et société;;8;Sciences pour l'ingénieur;2015;2014-15;2014;2014;2;1;1;9;3;6;4;1;3;;;;;ZMG5u
382;École doctorale Économie, espaces, sociétés, civilisations : pensée critique, politique et pratique sociale;EESC;7;Sciences de la société;2015;2014-15;2014;2014;25;14;11;122;69;53;11;8;3;;;;;9NI1W
388;École doctorale Chimie physique et chimie analytique de Paris centre;CPCA;4;Chimie;2015;2014-15;2014;2014;71;39;32;270;133;137;74;37;37;;;;;M0Hnd
400;École doctorale Savoirs scientifiques : épistémologie, histoire des sciences, didactique des disciplines;;2;Physique;2015;2014-15;2014;2014;3;2;1;17;7;10;3;1;2;;;;;nRax3
405;École doctorale Économie, management,mathématiques et physique de Cergy;EM2C;1;Mathématiques et leurs interactions;2015;2014-15;2014;2014;13;5;8;31;10;21;6;3;3;;;;;QbwSB
406;École doctorale Chimie moléculaire de Paris centre;;4;Chimie;2015;2014-15;2014;2014;32;10;22;114;40;74;28;12;16;;;;;a5dKy
409;École doctorale Énergie, mécanique, matériaux;EMMA;8;Sciences pour l'ingénieur;2015;2014-15;2014;2014;35;10;25;114;18;96;33;7;26;;;;;KXlbK
412;École doctorale Lorraine de chimie et physique moléculaires : synthèses, expériences, simulations, applications : de la molécule aux édifices supramoléculaires;SESAMES;4;Chimie;2015;2014-15;2014;2014;14;7;7;60;27;33;17;10;7;;;;;mvHX2
414;École doctorale Sciences de la vie et de la santé;;2;Physique;2015;2014-15;2014;2014;0;0;0;1;1;0;0;0;0;;;;;YI4xS
414;École doctorale Sciences de la vie et de la santé;;5;Biologie, médecine et santé;2015;2014-15;2014;2014;131;77;54;498;287;211;129;73;56;;;;;YI4xS
414;École doctorale Sciences de la vie et de la santé;;6;Sciences humaines et humanités;2015;2014-15;2014;2014;0;0;0;2;0;2;0;0;0;;;;;YI4xS
414;École doctorale Sciences de la vie et de la santé;;10;Sciences agronomiques et écologiques;2015;2014-15;2014;2014;5;3;2;12;7;5;2;2;0;;;;;YI4xS
419;École doctorale Signalisations et réseaux intégratifs en biologie;BIO-SIGNE;5;Biologie, médecine et santé;2015;2014-15;2014;2014;28;14;14;141;95;46;35;26;9;;;;;rDuFq
425;École doctorale Innovation thérapeutique : du fondamental à l'appliqué;;4;Chimie;2015;2014-15;2014;2014;9;5;4;42;23;19;6;5;1;;;;;DkgNy
433;École doctorale Concepts et langages;;1;Mathématiques et leurs interactions;2015;2014-15;2014;2014;2;0;2;5;3;2;2;1;1;;;;;v8q34
434;École doctorale Géographie de Paris - Espaces, sociétés, aménagement;EDGP;6;Sciences humaines et humanités;2015;2014-15;2014;2014;62;37;25;259;131;128;48;28;20;;;;;1FmLX
454;École doctorale Sciences de l'homme, du politique et du territoire;SHPT;7;Sciences de la société;2015;2014-15;2014;2014;26;19;7;125;66;59;14;5;9;;;;;Opv31
455;École doctorale Économie, Gestion, Information et Communication;EGIC;6;Sciences humaines et humanités;2015;2014-15;2014;2014;10;9;1;55;35;20;9;4;5;;;;;qCOg3
459;École doctorale Sciences chimiques Balard;;4;Chimie;2015;2014-15;2014;2014;66;34;32;251;108;143;85;39;46;;;;;YFs2W
463;École doctorale Sciences du mouvement humain;SMH;6;Sciences humaines et humanités;2015;2014-15;2014;2014;6;3;3;27;12;15;4;3;1;;;;;UbtlY
469;École doctorale du Pacifique;EDP;9;Sciences et technologies de l'information et de la communication;2015;2014-15;2014;2014;1;0;1;4;0;4;1;0;1;;;;;t9Z2n
469;École doctorale du Pacifique;EDP;10;Sciences agronomiques et écologiques;2015;2014-15;2014;2014;5;2;3;22;11;11;8;6;2;;;;;t9Z2n
474;École doctorale Interdisciplinaire européenne frontières du vivant;FDV;2;Physique;2015;2014-15;2014;2014;2;0;2;6;1;5;0;0;0;;;;;E727j
475;École doctorale Mathématiques, informatique, télécommunications de Toulouse;MITT;1;Mathématiques et leurs interactions;2015;2014-15;2014;2014;42;14;28;143;51;92;35;15;20;;;;;xcp2r
475;École doctorale Mathématiques, informatique, télécommunications de Toulouse;MITT;9;Sciences et technologies de l'information et de la communication;2015;2014-15;2014;2014;68;19;49;311;91;220;89;23;66;;;;;xcp2r
478;École doctorale Sciences de Gestion;;7;Sciences de la société;2015;2014-15;2014;2014;18;14;4;60;35;25;14;9;5;;;;;q34kB
480;École doctorale Montaigne-humanités;;2;Physique;2015;2014-15;2014;2014;2;1;1;6;3;3;1;1;0;;;;;f3SeZ
488;École doctorale Sciences, ingénierie, santé;SIS;8;Sciences pour l'ingénieur;2015;2014-15;2014;2014;28;7;21;98;36;62;28;10;18;;;;;Fy2lK
488;École doctorale Sciences, ingénierie, santé;SIS;10;Sciences agronomiques et écologiques;2015;2014-15;2014;2014;2;2;0;8;7;1;1;1;0;;;;;Fy2lK
489;École doctorale Sciences et ingénierie des systèmes, de l'environnement et des organisations;SISEO;10;Sciences agronomiques et écologiques;2015;2014-15;2014;2014;2;1;1;8;3;5;4;0;4;;;;;6pT77
492;École doctorale Droit;;7;Sciences de la société;2015;2014-15;2014;2014;57;27;30;320;156;164;52;21;31;;;;;kOQsX
493;École doctorale Erasme;;7;Sciences de la société;2015;2014-15;2014;2014;42;19;23;253;110;143;31;16;15;;;;;FPW4T
495;École doctorale Végétal, environnement, nutrition, agroalimentaire, mer;VENAM;10;Sciences agronomiques et écologiques;2015;2014-15;2014;2014;27;13;14;130;77;53;41;22;19;;;;;HL495
500;École doctorale Matière, molécules, matériaux en Pays de Loire;3MPL;4;Chimie;2015;2014-15;2014;2014;27;10;17;120;45;75;42;14;28;;;;;822tM
501;École doctorale Droit, économie-gestion, sociétés, territoires;;6;Sciences humaines et humanités;2015;2014-15;2014;2014;22;7;15;96;36;60;11;3;8;;;;;wE7WM
502;École doctorale Biologie - Santé;;2;Physique;2015;2014-15;2014;2014;0;0;0;1;1;0;0;0;0;;;;;JCFV7
502;École doctorale Biologie - Santé;;10;Sciences agronomiques et écologiques;2015;2014-15;2014;2014;1;0;1;1;0;1;0;0;0;;;;;JCFV7
503;École doctorale Sciences et technologies de l'information et de mathématiques;STIM;9;Sciences et technologies de l'information et de la communication;2015;2014-15;2014;2014;58;12;46;236;49;187;51;12;39;;;;;JQevP
506;École doctorale arts, lettres et langues;;6;Sciences humaines et humanités;2015;2014-15;2014;2014;40;25;15;211;141;70;26;18;8;;;;;m9yqI
510;École doctorale Ingénierie - Matériaux, mécanique, environnement, énergétique, procédés, production;IMEP2;8;Sciences pour l'ingénieur;2015;2014-15;2014;2014;93;24;69;404;113;291;87;26;61;;;;;Ce7NF
511;École doctorale Sciences et ingénierie;S&I;9;Sciences et technologies de l'information et de la communication;2015;2014-15;2014;2014;11;4;7;60;20;40;21;3;18;;;;;7aXuB
513;École doctorale Droit et sciences politiques, économiques et de gestion;DESPEG;7;Sciences de la société;2015;2014-15;2014;2014;68;42;26;346;168;178;42;22;20;;;;;aVHGU
521;École doctorale Sciences et ingénierie pour l'information, mathématiques;S2I;1;Mathématiques et leurs interactions;2015;2014-15;2014;2014;13;3;10;46;17;29;20;7;13;;;;;V6i83
523;École doctorale Sciences pour l'environnement - Gay Lussac;;5;Biologie, médecine et santé;2015;2014-15;2014;2014;7;3;4;37;25;12;12;6;6;;;;;6xD69
523;École doctorale Sciences pour l'environnement - Gay Lussac;;10;Sciences agronomiques et écologiques;2015;2014-15;2014;2014;16;9;7;48;27;21;16;12;4;;;;;6xD69
528;École doctorale Ville, transports et territoires;VTT;6;Sciences humaines et humanités;2015;2014-15;2014;2014;17;8;9;131;74;57;27;10;17;;;;;68zCc
528;École doctorale Ville, transports et territoires;VTT;7;Sciences de la société;2015;2014-15;2014;2014;10;6;4;54;28;26;3;2;1;;;;;68zCc
532;École doctorale Mathématiques et sciences et technologies de l'information et de la communication;MSTIC;9;Sciences et technologies de l'information et de la communication;2015;2014-15;2014;2014;41;9;32;162;41;121;47;9;38;;;;;t43KM
534;École doctorale Modélisation et instrumentation en physique, énergie, géosciences et environnement;MIPEGE;3;Sciences de la terre et de l'univers, espace;2015;2014-15;2014;2014;7;4;3;46;24;22;12;9;3;;;;;K93eR
534;École doctorale Modélisation et instrumentation en physique, énergie, géosciences et environnement;MIPEGE;8;Sciences pour l'ingénieur;2015;2014-15;2014;2014;0;0;0;1;0;1;0;0;0;;;;;K93eR
536;École doctorale Sciences et agrosciences;;3;Sciences de la terre et de l'univers, espace;2015;2014-15;2014;2014;4;2;2;13;5;8;3;0;3;;;;;pHfqe
539;École doctorale Sciences et technologies de Versailles;;2;Physique;2015;2014-15;2014;2014;5;1;4;25;6;19;3;1;2;;;;;nv3h8
539;École doctorale Sciences et technologies de Versailles;;9;Sciences et technologies de l'information et de la communication;2015;2014-15;2014;2014;19;5;14;63;23;40;18;7;11;;;;;nv3h8
542;École doctorale de sciences de La Réunion;STS;3;Sciences de la terre et de l'univers, espace;2015;2014-15;2014;2014;11;3;8;13;4;9;5;0;5;;;;;2pAql
542;École doctorale de sciences de La Réunion;STS;10;Sciences agronomiques et écologiques;2015;2014-15;2014;2014;3;2;1;6;4;2;1;0;1;;;;;2pAql
543;École doctorale de Dauphine;;1;Mathématiques et leurs interactions;2015;2014-15;2014;2014;16;1;15;45;14;31;10;0;10;;;;;u8w6A
543;École doctorale de Dauphine;;9;Sciences et technologies de l'information et de la communication;2015;2014-15;2014;2014;11;2;9;34;9;25;9;2;7;;;;;u8w6A
544;École doctorale Inter-Med : Espaces, temps, cultures;INTER-MED;6;Sciences humaines et humanités;2015;2014-15;2014;2014;25;14;11;96;54;42;28;11;17;;;;;7VjtD
544;École doctorale Inter-Med : Espaces, temps, cultures;INTER-MED;7;Sciences de la société;2015;2014-15;2014;2014;36;19;17;138;63;75;36;16;20;;;;;7VjtD
546;École doctorale Abbé Grégoire;;5;Biologie, médecine et santé;2015;2014-15;2014;2014;0;0;0;2;0;2;4;3;1;;;;;ZSn7q
546;École doctorale Abbé Grégoire;;9;Sciences et technologies de l'information et de la communication;2015;2014-15;2014;2014;4;2;2;13;10;3;0;0;0;;;;;ZSn7q
546;École doctorale Abbé Grégoire;;10;Sciences agronomiques et écologiques;2015;2014-15;2014;2014;0;0;0;2;1;1;0;0;0;;;;;ZSn7q
547;École doctorale Sciences, Technologie, Santé;EDSTS;2;Physique;2015;2014-15;2014;2014;10;5;5;35;11;24;5;1;4;;;;;wEdn2
547;École doctorale Sciences, Technologie, Santé;EDSTS;5;Biologie, médecine et santé;2015;2014-15;2014;2014;37;24;13;152;78;74;28;15;13;;;;;wEdn2
547;École doctorale Sciences, Technologie, Santé;EDSTS;10;Sciences agronomiques et écologiques;2015;2014-15;2014;2014;16;4;12;66;30;36;10;7;3;;;;;wEdn2
548;École doctorale Mer et Sciences;;1;Mathématiques et leurs interactions;2015;2014-15;2014;2014;3;0;3;11;2;9;2;0;2;;;;;QX0fS
548;École doctorale Mer et Sciences;;4;Chimie;2015;2014-15;2014;2014;4;2;2;16;6;10;8;5;3;;;;;QX0fS
548;École doctorale Mer et Sciences;;9;Sciences et technologies de l'information et de la communication;2015;2014-15;2014;2014;9;3;6;22;5;17;3;0;3;;;;;QX0fS
549;École doctorale Santé, Sciences Biologiques et Chimie du Vivant;SSBCV;3;Sciences de la terre et de l'univers, espace;2015;2014-15;2014;2014;1;1;0;2;2;0;0;0;0;;;;;B9ggO
549;École doctorale Santé, Sciences Biologiques et Chimie du Vivant;SSBCV;6;Sciences humaines et humanités;2015;2014-15;2014;2014;3;0;3;11;8;3;1;1;0;;;;;B9ggO
549;École doctorale Santé, Sciences Biologiques et Chimie du Vivant;SSBCV;9;Sciences et technologies de l'information et de la communication;2015;2014-15;2014;2014;3;1;2;5;1;4;0;0;0;;;;;B9ggO
551;École doctorale Mathématiques, Informatique, Physique Théorique et Ingénierie des Systèmes;MIPTIS;1;Mathématiques et leurs interactions;2015;2014-15;2014;2014;9;3;6;25;8;17;10;4;6;;;;;Mpudz
552;École doctorale Énergie - Matériaux - Sciences de la Terre et de l'Univers;EMTSU;1;Mathématiques et leurs interactions;2015;2014-15;2014;2014;1;0;1;1;0;1;0;0;0;;;;;NTZhw
553;École doctorale Carnot - Pasteur;;4;Chimie;2015;2014-15;2014;2014;27;6;21;94;24;70;35;9;26;;;;;6h4Z7
554;École doctorale Environnements - Santé;E-S;4;Chimie;2015;2014-15;2014;2014;0;0;0;1;0;1;0;0;0;;;;;ElyFU
555;École doctorale Sciences de l'Homme et de la Société;SHS;7;Sciences de la société;2015;2014-15;2014;2014;46;14;32;225;92;133;20;9;11;;;;;44G6m
556;École doctorale Homme, Sociétés, Risques, Territoire;HSRT;6;Sciences humaines et humanités;2015;2014-15;2014;2014;49;26;23;251;122;129;32;20;12;;;;;5QEaX
558;École doctorale Histoire, Mémoire, Patrimoine, Langage;HMPL;6;Sciences humaines et humanités;2015;2014-15;2014;2014;65;32;33;367;203;164;46;29;17;;;;;uX3jT
562;École doctorale Bio Sorbonne Paris Cité;BioSPC;5;Biologie, médecine et santé;2015;2014-15;2014;2014;146;95;51;495;296;199;0;0;0;;;;;4Yju6
34;École doctorale Matériaux;;4;Chimie;2012;2011-12;2011;2011;7;4;3;28;13;15;13;5;8;;;;;1Iufh
42;École doctorale Entreprise, économie, société;EES;7;Sciences de la société;2012;2011-12;2011;2011;30;14;16;164;66;98;31;9;22;;;;;uO01d
50;École doctorale Langues, littératures et sciences humaines;LLSH;6;Sciences humaines et humanités;2012;2011-12;2011;2011;31;22;9;205;149;56;40;25;15;;;;;8THzQ
50;École doctorale Langues, littératures et sciences humaines;LLSH;9;Sciences et technologies de l'information et de la communication;2012;2011-12;2011;2011;14;8;6;52;29;23;0;0;0;;;;;8THzQ
60;École doctorale Territoires, temps, sociétés et développement;TTSD;6;Sciences humaines et humanités;2012;2011-12;2011;2011;38;25;13;195;117;78;28;16;12;;;;;fkIh6
60;École doctorale Territoires, temps, sociétés et développement;TTSD;10;Sciences agronomiques et écologiques;2012;2011-12;2011;2011;1;1;0;4;2;2;0;0;0;;;;;fkIh6
62;École doctorale Sciences de la vie et de la santé;;5;Biologie, médecine et santé;2012;2011-12;2011;2011;140;79;61;660;348;312;160;91;69;;;;;vZzE7
72;École doctorale Sciences pour l'ingénieur;SPI;1;Mathématiques et leurs interactions;2012;2011-12;2011;2011;15;2;13;58;15;43;15;3;12;;;;;47QPx
77;École doctorale Informatique, automatique, électronique, électrotechnique, mathématiques;IAEM;9;Sciences et technologies de l'information et de la communication;2012;2011-12;2011;2011;61;12;49;234;58;176;79;11;68;;;;;TCHTA
79;École doctorale Sciences juridiques, politiques, économiques et de gestion;SJPEG;7;Sciences de la société;2012;2011-12;2011;2011;54;24;30;208;107;101;31;17;14;;;;;ea4x6
84;École doctorale Sciences et technologies de l'information et de la communication;STIC;9;Sciences et technologies de l'information et de la communication;2012;2011-12;2011;2011;61;13;48;261;49;212;64;9;55;;;;;9wS2W
85;École doctorale Sciences de la vie et de la santé;SVS;5;Biologie, médecine et santé;2012;2011-12;2011;2011;31;20;11;100;50;50;29;20;9;;;;;YdiMF
86;École doctorale Sociétés, humanités, arts, lettres;LSHS;6;Sciences humaines et humanités;2012;2011-12;2011;2011;83;53;30;306;185;121;43;23;20;;;;;O8E6y
102;École doctorale Santé, sciences, technologies;;5;Biologie, médecine et santé;2012;2011-12;2011;2011;49;29;20;182;103;79;42;19;23;;;;;4h65n
102;École doctorale Santé, sciences, technologies;;9;Sciences et technologies de l'information et de la communication;2012;2011-12;2011;2011;9;3;6;37;5;32;5;0;5;;;;;4h65n
104;École doctorale Sciences de la matière, du rayonnement et de l'environnement;SMRE;3;Sciences de la terre et de l'univers, espace;2012;2011-12;2011;2011;20;8;12;57;23;34;22;12;10;;;;;Q5iFz
122;École doctorale Europe latine - Amérique latine;;6;Sciences humaines et humanités;2012;2011-12;2011;2011;41;24;17;234;124;110;27;15;12;;;;;z9lZY
149;École doctorale Carnot;;1;Mathématiques et leurs interactions;2012;2011-12;2011;2011;7;2;5;26;8;18;10;4;6;;;;;zuThw
157;École doctorale Génétique, cellulaire, immunologie, infectiologie et développement;GC2ID;5;Biologie, médecine et santé;2012;2011-12;2011;2011;71;59;12;273;197;76;62;43;19;;;;;Sl3l2
159;École doctorale Esthétique, sciences et technologies des arts;EDESTA;6;Sciences humaines et humanités;2012;2011-12;2011;2011;82;49;33;300;186;114;17;8;9;;;;;zj1Vj
166;École doctorale Information, structures et systèmes;I2S;1;Mathématiques et leurs interactions;2012;2011-12;2011;2011;22;10;12;54;19;35;12;2;10;;;;;2uO68
166;École doctorale Information, structures et systèmes;I2S;2;Physique;2012;2011-12;2011;2011;21;4;17;55;15;40;16;4;12;;;;;2uO68
166;École doctorale Information, structures et systèmes;I2S;8;Sciences pour l'ingénieur;2012;2011-12;2011;2011;23;8;15;69;19;50;18;9;9;;;;;2uO68
177;École doctorale Sciences et technologies de l'université d'Orléans;;2;Physique;2012;2011-12;2011;2011;6;3;3;38;12;26;4;0;4;;;;;JI65m
177;École doctorale Sciences et technologies de l'université d'Orléans;;10;Sciences agronomiques et écologiques;2012;2011-12;2011;2011;0;0;0;2;1;1;0;0;0;;;;;JI65m
178;École doctorale Sciences fondamentales;;1;Mathématiques et leurs interactions;2012;2011-12;2011;2011;6;2;4;18;7;11;4;1;3;;;;;1AiR7
178;École doctorale Sciences fondamentales;;2;Physique;2012;2011-12;2011;2011;10;1;9;33;6;27;10;2;8;;;;;1AiR7
180;École doctorale Sciences humaines et sociales : cultures, individus, sociétés;SHS;7;Sciences de la société;2012;2011-12;2011;2011;50;33;17;194;124;70;38;22;16;;;;;D2BT3
181;École doctorale Structure, informations, matière et matériaux;Simem;8;Sciences pour l'ingénieur;2012;2011-12;2011;2011;2;0;2;12;1;11;5;1;4;;;;;c1D6f
182;École doctorale Physique et chimie-physique;;8;Sciences pour l'ingénieur;2012;2011-12;2011;2011;3;0;3;8;1;7;1;0;1;;;;;3My6I
184;École doctorale Mathématiques et informatique de Marseille;;9;Sciences et technologies de l'information et de la communication;2012;2011-12;2011;2011;24;3;21;102;24;78;14;0;14;;;;;DDObG
188;École doctorale Histoire moderne et contemporaine;;6;Sciences humaines et humanités;2012;2011-12;2011;2011;51;27;24;216;89;127;33;13;20;;;;;RSZ7F
209;École doctorale Sciences physiques et de L'ingénieur;SPI;2;Physique;2012;2011-12;2011;2011;23;5;18;74;18;56;18;6;12;;;;;tZcIZ
211;École doctorale Sciences exactes et leurs applications;ED SEA;5;Biologie, médecine et santé;2012;2011-12;2011;2011;5;4;1;10;7;3;2;2;0;;;;;1G1iC
211;École doctorale Sciences exactes et leurs applications;ED SEA;8;Sciences pour l'ingénieur;2012;2011-12;2011;2011;12;1;11;42;10;32;5;0;5;;;;;1G1iC
216;École doctorale Ingénierie pour la santé, la cognition, l'environnement;EDISCE;5;Biologie, médecine et santé;2012;2011-12;2011;2011;20;10;10;85;37;48;30;9;21;;;;;fPs1t
216;École doctorale Ingénierie pour la santé, la cognition, l'environnement;EDISCE;6;Sciences humaines et humanités;2012;2011-12;2011;2011;14;7;7;49;29;20;6;6;0;;;;;fPs1t
221;École doctorale Augustin Cournot - Sciences économiques et de gestion - Sciences, technologies et sociétés;EDAC;9;Sciences et technologies de l'information et de la communication;2012;2011-12;2011;2011;0;0;0;0;0;0;1;1;0;;;;;5z9rW
222;École doctorale Sciences chimiques;EDSC;2;Physique;2012;2011-12;2011;2011;1;0;1;4;1;3;1;0;1;;;;;AdU8Q
224;École doctorale Cognition, langage, interaction;;9;Sciences et technologies de l'information et de la communication;2012;2011-12;2011;2011;2;0;2;13;1;12;4;0;4;;;;;7v43e
227;École doctorale Sciences de la nature et de l'homme;;3;Sciences de la terre et de l'univers, espace;2012;2011-12;2011;2011;1;1;0;6;3;3;0;0;0;;;;;xiDA5
227;École doctorale Sciences de la nature et de l'homme;;10;Sciences agronomiques et écologiques;2012;2011-12;2011;2011;9;7;2;30;17;13;4;2;2;;;;;xiDA5
231;École doctorale Économie et gestion;EDEG;7;Sciences de la société;2012;2011-12;2011;2011;41;22;19;156;83;73;40;19;21;;;;;KT720
234;École doctorale de Sciences Po;;7;Sciences de la société;2012;2011-12;2011;2011;66;30;36;437;231;206;80;42;38;;;;;ux756
240;École doctorale Sciences de l'homme et de la société;SHS;6;Sciences humaines et humanités;2012;2011-12;2011;2011;62;37;25;274;168;106;40;18;22;;;;;j345k
240;École doctorale Sciences de l'homme et de la société;SHS;7;Sciences de la société;2012;2011-12;2011;2011;21;10;11;80;45;35;5;0;5;;;;;j345k
250;École doctorale Sciences chimiques;;4;Chimie;2012;2011-12;2011;2011;33;15;18;134;65;69;25;17;8;;;;;O0Fav
251;École doctorale Sciences de l'environnement;;3;Sciences de la terre et de l'univers, espace;2012;2011-12;2011;2011;21;10;11;107;50;57;19;5;14;;;;;VR28y
260;École doctorale pluridisciplinaire;;7;Sciences de la société;2012;2011-12;2011;2011;34;21;13;101;55;46;5;3;2;;;;;sCk1f
262;École doctorale Sciences juridiques, politiques, économiques et de gestion;DEG;7;Sciences de la société;2012;2011-12;2011;2011;59;26;33;206;103;103;24;13;11;;;;;H7GyL
265;École doctorale Langues, littératures et sociétés du monde;;6;Sciences humaines et humanités;2012;2011-12;2011;2011;68;45;23;288;177;111;25;15;10;;;;;4YWGW
268;École doctorale Langage et langues : description, théorisation, transmission;;6;Sciences humaines et humanités;2012;2011-12;2011;2011;60;36;24;345;198;147;55;28;27;;;;;wAIDE
269;École doctorale Mathématiques, sciences de l'information et de l'ingénieur;MSII;1;Mathématiques et leurs interactions;2012;2011-12;2011;2011;18;4;14;82;16;66;17;1;16;;;;;5E625
269;École doctorale Mathématiques, sciences de l'information et de l'ingénieur;MSII;5;Biologie, médecine et santé;2012;2011-12;2011;2011;0;0;0;2;1;1;1;0;1;;;;;5E625
270;École doctorale Théologie et sciences religieuses;;6;Sciences humaines et humanités;2012;2011-12;2011;2011;20;5;15;144;35;109;24;6;18;;;;;BRKC1
275;École doctorale Sciences de gestion;EDSG;7;Sciences de la société;2012;2011-12;2011;2011;26;10;16;102;48;54;20;14;6;;;;;6QC4I
284;École doctorale Droit et Science Politique;DSP;6;Sciences humaines et humanités;2012;2011-12;2011;2011;50;33;17;144;91;53;14;9;5;;;;;ahH92
288;École doctorale Ondes et matière;EDOM;2;Physique;2012;2011-12;2011;2011;45;11;34;173;45;128;37;8;29;;;;;kJrcx
305;École doctorale Énergie et environnement;E2;5;Biologie, médecine et santé;2012;2011-12;2011;2011;6;6;0;16;11;5;4;1;3;;;;;Kbt8I
306;École doctorale Sciences des procédés, sciences des aliments;;4;Chimie;2012;2011-12;2011;2011;3;1;2;9;1;8;2;2;0;;;;;adF7W
306;École doctorale Sciences des procédés, sciences des aliments;;5;Biologie, médecine et santé;2012;2011-12;2011;2011;2;1;1;13;10;3;7;3;4;;;;;adF7W
306;École doctorale Sciences des procédés, sciences des aliments;;8;Sciences pour l'ingénieur;2012;2011-12;2011;2011;17;10;7;55;31;24;19;9;10;;;;;adF7W
327;École doctorale Temps, espaces, sociétés, cultures;TESC;6;Sciences humaines et humanités;2012;2011-12;2011;2011;53;33;20;259;140;119;35;15;20;;;;;IjgiJ
328;École doctorale Arts, lettres, langues, philosophie et communication;ALLPH@;9;Sciences et technologies de l'information et de la communication;2012;2011-12;2011;2011;14;7;7;50;26;24;6;3;3;;;;;xLxMh
351;École doctorale Sciences physiques, mathématiques et de l'information pour l'ingénieur;SPMII;2;Physique;2012;2011-12;2011;2011;8;3;5;36;16;20;11;4;7;;;;;rY4EP
359;École doctorale Mathématiques, télécommunications, informatique, signal, systèmes, électronique;MATISSE;1;Mathématiques et leurs interactions;2012;2011-12;2011;2011;20;10;10;76;20;56;20;5;15;;;;;Y0r76
359;École doctorale Mathématiques, télécommunications, informatique, signal, systèmes, électronique;MATISSE;9;Sciences et technologies de l'information et de la communication;2012;2011-12;2011;2011;124;32;92;463;98;365;109;22;87;;;;;Y0r76
361;École doctorale Sciences et Technologies;ED ST;9;Sciences et technologies de l'information et de la communication;2012;2011-12;2011;2011;22;6;16;118;37;81;17;3;14;;;;;cOUmL
364;École doctorale Sciences fondamentales et appliquées;EDSFA;2;Physique;2012;2011-12;2011;2011;12;3;9;57;18;39;14;3;11;;;;;E483q
368;École doctorale Sciences et santé;;5;Biologie, médecine et santé;2012;2011-12;2011;2011;23;8;15;83;33;50;12;4;8;;;;;4L0a1
371;École doctorale Louis Pasteur;;2;Physique;2012;2011-12;2011;2011;2;2;0;7;4;3;2;0;2;;;;;2tr4F
371;École doctorale Louis Pasteur;;3;Sciences de la terre et de l'univers, espace;2012;2011-12;2011;2011;2;1;1;4;1;3;0;0;0;;;;;2tr4F
373;École doctorale Santé, information/communications et mathématiques, matière;SICMA;2;Physique;2012;2011-12;2011;2011;8;1;7;24;5;19;6;3;3;;;;;hTJF5
373;École doctorale Santé, information/communications et mathématiques, matière;SICMA;8;Sciences pour l'ingénieur;2012;2011-12;2011;2011;6;2;4;29;6;23;5;1;4;;;;;hTJF5
377;École doctorale Environnement et société;;1;Mathématiques et leurs interactions;2012;2011-12;2011;2011;0;0;0;6;3;3;2;0;2;;;;;ZMG5u
378;École doctorale Sciences de l'homme et de la société;SHS;6;Sciences humaines et humanités;2012;2011-12;2011;2011;16;9;7;81;43;38;11;9;2;;;;;3XKuF
382;École doctorale Économie, espaces, sociétés, civilisations : pensée critique, politique et pratique sociale;EESC;7;Sciences de la société;2012;2011-12;2011;2011;53;34;19;275;154;121;33;19;14;;;;;9NI1W
387;École doctorale Interdisciplinaire pour le vivant;I-ViV;4;Chimie;2012;2011-12;2011;2011;9;7;2;22;13;9;5;2;3;;;;;06uKM
391;École doctorale Sciences mécaniques, acoustique et électronique et robotique de Paris;SMAER;8;Sciences pour l'ingénieur;2012;2011-12;2011;2011;62;14;48;229;52;177;50;11;39;;;;;k0eue
393;École doctorale Pierre Louis de Santé Publique : Épidémiologie et Sciences de l'information biomédicale;PLSP;5;Biologie, médecine et santé;2012;2011-12;2011;2011;26;15;11;124;71;53;23;14;9;;;;;69445
396;École doctorale Économie, organisations, société;EOS;7;Sciences de la société;2012;2011-12;2011;2011;48;23;25;297;131;166;44;20;24;;;;;Es5e7
401;École doctorale Sciences sociales;;7;Sciences de la société;2012;2011-12;2011;2011;52;35;17;261;136;125;19;7;12;;;;;raQ7K
410;École doctorale Sciences et ingénierie des ressources, procédés, produits, environnement;RP2E;4;Chimie;2012;2011-12;2011;2011;3;0;3;14;4;10;4;2;2;;;;;Q5fxV
410;École doctorale Sciences et ingénierie des ressources, procédés, produits, environnement;RP2E;8;Sciences pour l'ingénieur;2012;2011-12;2011;2011;51;14;37;195;67;128;39;15;24;;;;;Q5fxV
411;École doctorale Humanités nouvelles : Fernand Braudel;;5;Biologie, médecine et santé;2012;2011-12;2011;2011;13;11;2;29;26;3;4;4;0;;;;;l2rFh
412;École doctorale Lorraine de chimie et physique moléculaires : synthèses, expériences, simulations, applications : de la molécule aux édifices supramoléculaires;SESAMES;2;Physique;2012;2011-12;2011;2011;6;1;5;18;7;11;9;6;3;;;;;mvHX2
413;École doctorale Sciences de la terre et de l'environnement;STE;1;Mathématiques et leurs interactions;2012;2011-12;2011;2011;0;0;0;1;0;1;0;0;0;;;;;u9BA9
414;École doctorale Sciences de la vie et de la santé;;5;Biologie, médecine et santé;2012;2011-12;2011;2011;125;64;61;499;260;239;102;48;54;;;;;YI4xS
414;École doctorale Sciences de la vie et de la santé;;10;Sciences agronomiques et écologiques;2012;2011-12;2011;2011;1;1;0;2;2;0;2;0;2;;;;;YI4xS
415;"École doctorale Interdisciplinaire ""Arts et métiers""";;5;Biologie, médecine et santé;2012;2011-12;2011;2011;0;0;0;0;0;0;3;2;1;;;;;B3z99
417;École doctorale Sciences et Ingénierie;S&I;2;Physique;2012;2011-12;2011;2011;2;0;2;7;0;7;6;3;3;;;;;SSBvE
417;École doctorale Sciences et Ingénierie;S&I;8;Sciences pour l'ingénieur;2012;2011-12;2011;2011;11;3;8;38;10;28;7;2;5;;;;;SSBvE
420;École doctorale Santé publique Paris 11 - Paris 5;;7;Sciences de la société;2012;2011-12;2011;2011;3;2;1;15;11;4;1;0;1;;;;;3BNdi
422;École doctorale Sciences et technologies de l'information, des télécommunications et des systèmes;;8;Sciences pour l'ingénieur;2012;2011-12;2011;2011;16;4;12;54;18;36;6;2;4;;;;;998UM
425;École doctorale Innovation thérapeutique : du fondamental à l'appliqué;;5;Biologie, médecine et santé;2012;2011-12;2011;2011;55;34;21;219;137;82;50;33;17;;;;;DkgNy
427;École doctorale Informatique Paris-sud;;9;Sciences et technologies de l'information et de la communication;2012;2011-12;2011;2011;47;15;32;192;54;138;47;10;37;;;;;u0T33
433;École doctorale Concepts et langages;;6;Sciences humaines et humanités;2012;2011-12;2011;2011;105;57;48;478;274;204;69;38;31;;;;;v8q34
447;École doctorale de l'école polytechnique;;2;Physique;2012;2011-12;2011;2011;47;9;38;197;43;154;47;13;34;;;;;zgCCh
447;École doctorale de l'école polytechnique;;5;Biologie, médecine et santé;2012;2011-12;2011;2011;0;0;0;1;1;0;1;1;0;;;;;zgCCh
447;École doctorale de l'école polytechnique;;9;Sciences et technologies de l'information et de la communication;2012;2011-12;2011;2011;27;6;21;80;16;64;16;1;15;;;;;zgCCh
455;École doctorale Économie, Gestion, Information et Communication;EGIC;7;Sciences de la société;2012;2011-12;2011;2011;21;15;6;98;44;54;16;11;5;;;;;qCOg3
456;École doctorale Sciences du sport, de la motricité et du mouvement humain;;6;Sciences humaines et humanités;2012;2011-12;2011;2011;8;7;1;48;28;20;12;6;6;;;;;GqvEI
467;École doctorale Aéronautique, astronautique;AA;1;Mathématiques et leurs interactions;2012;2011-12;2011;2011;3;0;3;6;1;5;1;1;0;;;;;U7l45
467;École doctorale Aéronautique, astronautique;AA;2;Physique;2012;2011-12;2011;2011;0;0;0;2;0;2;0;0;0;;;;;U7l45
468;École doctorale Mécanique, énergétique, génie civil, procédés;MEGEP;8;Sciences pour l'ingénieur;2012;2011-12;2011;2011;115;33;82;393;118;275;97;27;70;;;;;4XUTB
469;École doctorale du Pacifique;EDP;9;Sciences et technologies de l'information et de la communication;2012;2011-12;2011;2011;1;0;1;2;0;2;2;0;2;;;;;t9Z2n
474;École doctorale Interdisciplinaire européenne frontières du vivant;FDV;10;Sciences agronomiques et écologiques;2012;2011-12;2011;2011;0;0;0;2;1;1;4;3;1;;;;;E727j
477;École doctorale Systèmes intégrés en biologie, agronomie, géosciences, hydrosciences, environnement;SIBAGHE;1;Mathématiques et leurs interactions;2012;2011-12;2011;2011;0;0;0;1;0;1;0;0;0;;;;;zfN3N
477;École doctorale Systèmes intégrés en biologie, agronomie, géosciences, hydrosciences, environnement;SIBAGHE;10;Sciences agronomiques et écologiques;2012;2011-12;2011;2011;85;48;37;244;139;105;55;23;32;;;;;zfN3N
482;École doctorale Sciences de la matière;SDM;2;Physique;2012;2011-12;2011;2011;28;7;21;116;29;87;16;2;14;;;;;kmeZ4
482;École doctorale Sciences de la matière;SDM;4;Chimie;2012;2011-12;2011;2011;62;24;38;273;120;153;60;18;42;;;;;kmeZ4
486;École doctorale Sciences économiques et de gestion;SEG;6;Sciences humaines et humanités;2012;2011-12;2011;2011;0;0;0;0;0;0;1;1;0;;;;;h1GZ3
488;École doctorale Sciences, ingénierie, santé;SIS;1;Mathématiques et leurs interactions;2012;2011-12;2011;2011;3;1;2;10;4;6;6;1;5;;;;;Fy2lK
488;École doctorale Sciences, ingénierie, santé;SIS;5;Biologie, médecine et santé;2012;2011-12;2011;2011;12;5;7;57;23;34;11;4;7;;;;;Fy2lK
490;École doctorale Environnement - Santé/STIC;E2S;8;Sciences pour l'ingénieur;2012;2011-12;2011;2011;9;4;5;30;16;14;2;1;1;;;;;sYTua
491;École doctorale Langages, idées, sociétés, institutions, territoires;LISIT;6;Sciences humaines et humanités;2012;2011-12;2011;2011;62;39;23;333;182;151;32;14;18;;;;;iB25j
494;École doctorale Jean-Henri Lambert;;2;Physique;2012;2011-12;2011;2011;2;0;2;11;6;5;0;0;0;;;;;A3m51
494;École doctorale Jean-Henri Lambert;;4;Chimie;2012;2011-12;2011;2011;17;7;10;67;32;35;16;5;11;;;;;A3m51
495;École doctorale Végétal, environnement, nutrition, agroalimentaire, mer;VENAM;10;Sciences agronomiques et écologiques;2012;2011-12;2011;2011;33;19;14;150;84;66;37;24;13;;;;;HL495
496;École doctorale Sociétés, cultures, échanges;SCE;6;Sciences humaines et humanités;2012;2011-12;2011;2011;67;41;26;342;203;139;47;29;18;;;;;633tC
497;École doctorale Normande de Biologie Intégrative, Santé, Environnement;Ed NBISE;6;Sciences humaines et humanités;2012;2011-12;2011;2011;1;0;1;2;1;1;0;0;0;;;;;0D9Je
498;École doctorale Sciences pour l'ingénieur, géosciences, architecture;SPIGA;6;Sciences humaines et humanités;2012;2011-12;2011;2011;5;3;2;11;5;6;2;1;1;;;;;0vlKH
500;École doctorale Matière, molécules, matériaux en Pays de Loire;3MPL;4;Chimie;2012;2011-12;2011;2011;35;10;25;131;48;83;30;11;19;;;;;822tM
502;École doctorale Biologie - Santé;;5;Biologie, médecine et santé;2012;2011-12;2011;2011;88;47;41;305;166;139;71;42;29;;;;;JCFV7
503;École doctorale Sciences et technologies de l'information et de mathématiques;STIM;2;Physique;2012;2011-12;2011;2011;0;0;0;1;0;1;0;0;0;;;;;JQevP
505;École doctorale Sciences de l'homme, des organisations et de la société;SHOS;6;Sciences humaines et humanités;2012;2011-12;2011;2011;5;1;4;16;3;13;3;2;1;;;;;qts78
506;École doctorale arts, lettres et langues;;6;Sciences humaines et humanités;2012;2011-12;2011;2011;57;41;16;253;170;83;26;13;13;;;;;m9yqI
511;École doctorale Sciences et ingénierie;S&I;2;Physique;2012;2011-12;2011;2011;0;0;0;0;0;0;1;0;1;;;;;7aXuB
511;École doctorale Sciences et ingénierie;S&I;4;Chimie;2012;2011-12;2011;2011;2;1;1;20;15;5;2;1;1;;;;;7aXuB
512;École doctorale Informatique et mathématiques;InfoMaths;1;Mathématiques et leurs interactions;2012;2011-12;2011;2011;27;7;20;78;17;61;13;4;9;;;;;t86bi
519;École doctorale Sciences humaines et sociales - Perspectives européennes;SHS-PE;6;Sciences humaines et humanités;2012;2011-12;2011;2011;71;28;43;328;180;148;38;22;16;;;;;2f5qs
521;École doctorale Sciences et ingénierie pour l'information, mathématiques;S2I;1;Mathématiques et leurs interactions;2012;2011-12;2011;2011;15;6;9;66;22;44;15;6;9;;;;;V6i83
522;École doctorale Sciences et ingénierie en matériaux, mécanique, énergétique et aéronautique;SI-MMEA;4;Chimie;2012;2011-12;2011;2011;12;5;7;37;14;23;12;5;7;;;;;82F19
522;École doctorale Sciences et ingénierie en matériaux, mécanique, énergétique et aéronautique;SI-MMEA;8;Sciences pour l'ingénieur;2012;2011-12;2011;2011;49;14;35;190;38;152;41;2;39;;;;;82F19
524;École doctorale Biologie - santé;;5;Biologie, médecine et santé;2012;2011-12;2011;2011;38;20;18;133;63;70;33;16;17;;;;;S7Kk6
529;École doctorale Cultures et sociétés;CS;7;Sciences de la société;2012;2011-12;2011;2011;17;11;6;53;27;26;2;1;1;;;;;XU9tb
530;École doctorale Organisations, marchés, institutions;OMI;6;Sciences humaines et humanités;2012;2011-12;2011;2011;31;16;15;69;44;25;6;2;4;;;;;4htv7
531;École doctorale Sciences, ingénierie et environnement;SIE;6;Sciences humaines et humanités;2012;2011-12;2011;2011;0;0;0;1;1;0;0;0;0;;;;;b5BYq
533;École doctorale Sciences du management : Gestion, organisation, décision, information;GODI;7;Sciences de la société;2012;2011-12;2011;2011;24;13;11;124;58;66;17;9;8;;;;;ld7FG
536;École doctorale Sciences et agrosciences;;1;Mathématiques et leurs interactions;2012;2011-12;2011;2011;1;1;0;4;2;2;1;0;1;;;;;pHfqe
538;École doctorale Culture, régulation, institutions et territoire;CRIT;6;Sciences humaines et humanités;2012;2011-12;2011;2011;42;22;20;140;76;64;8;4;4;;;;;8T505
541;École doctorale de sciences humaines et sociales de La Réunion;SHS;6;Sciences humaines et humanités;2012;2011-12;2011;2011;39;24;15;132;83;49;21;11;10;;;;;21SpE
542;École doctorale de sciences de La Réunion;STS;6;Sciences humaines et humanités;2012;2011-12;2011;2011;0;0;0;2;1;1;2;1;1;;;;;2pAql
543;École doctorale de Dauphine;;1;Mathématiques et leurs interactions;2012;2011-12;2011;2011;10;4;6;48;8;40;9;2;7;;;;;u8w6A
546;École doctorale Abbé Grégoire;;1;Mathématiques et leurs interactions;2012;2011-12;2011;2011;1;1;0;1;1;0;0;0;0;;;;;ZSn7q
8;École doctorale Histoire du droit, philosophie du droit et sociologie du droit;;7;Sciences de la société;2013;2012-13;2012;2012;12;7;5;69;33;36;4;1;3;;;;;pGSed
9;École doctorale Droit international, droit européen, relations internationales et droit comparé;;7;Sciences de la société;2013;2012-13;2012;2012;43;26;17;247;144;103;19;7;12;;;;;v1emR
31;École doctorale Pratiques et théories du sens;;7;Sciences de la société;2013;2012-13;2012;2012;6;4;2;36;15;21;10;3;7;;;;;1S466
39;École doctorale Mathématiques et Informatique;EDMIB;9;Sciences et technologies de l'information et de la communication;2013;2012-13;2012;2012;29;4;25;115;21;94;37;3;34;;;;;TBj2X
52;École doctorale Physique et astrophysique de Lyon;PHAST;2;Physique;2013;2012-13;2012;2012;51;9;42;142;33;109;48;13;35;;;;;61XPb
65;École doctorale Sciences de la Vie, Santé, Agronomie, Environnement;;10;Sciences agronomiques et écologiques;2013;2012-13;2012;2012;25;13;12;90;48;42;31;22;9;;;;;MAOG4
71;École doctorale Sciences pour l'ingénieur;;9;Sciences et technologies de l'information et de la communication;2013;2012-13;2012;2012;24;9;15;88;31;57;16;7;9;;;;;H6UYp
73;École doctorale Sciences économiques, sociales, de l'aménagement et du management;SESAM;6;Sciences humaines et humanités;2013;2012-13;2012;2012;7;3;4;17;3;14;1;0;1;;;;;IQ0Hk
85;École doctorale Sciences de la vie et de la santé;SVS;5;Biologie, médecine et santé;2013;2012-13;2012;2012;41;22;19;115;70;45;33;19;14;;;;;YdiMF
86;École doctorale Sociétés, humanités, arts, lettres;LSHS;7;Sciences de la société;2013;2012-13;2012;2012;14;8;6;37;23;14;4;2;2;;;;;O8E6y
104;École doctorale Sciences de la matière, du rayonnement et de l'environnement;SMRE;9;Sciences et technologies de l'information et de la communication;2013;2012-13;2012;2012;2;0;2;3;0;3;0;0;0;;;;;Q5iFz
104;École doctorale Sciences de la matière, du rayonnement et de l'environnement;SMRE;10;Sciences agronomiques et écologiques;2013;2012-13;2012;2012;17;6;11;50;16;34;6;2;4;;;;;Q5iFz
107;École doctorale Physique de la région parisienne;;2;Physique;2013;2012-13;2012;2012;82;26;56;276;59;217;68;9;59;;;;;O3g7O
129;École doctorale Sciences de l'environnement d'Ile de France;SEIF;3;Sciences de la terre et de l'univers, espace;2013;2012-13;2012;2012;57;29;28;208;98;110;54;24;30;;;;;TnAPh
130;École doctorale Informatique, télécommunications et électronique de Paris;EDITE;9;Sciences et technologies de l'information et de la communication;2013;2012-13;2012;2012;208;59;149;840;243;597;191;48;143;;;;;O5ysj
146;École doctorale Galilée;GALILEE;1;Mathématiques et leurs interactions;2013;2012-13;2012;2012;6;1;5;44;11;33;11;1;10;;;;;71hqm
146;École doctorale Galilée;GALILEE;4;Chimie;2013;2012-13;2012;2012;2;2;0;18;11;7;5;5;0;;;;;71hqm
146;École doctorale Galilée;GALILEE;5;Biologie, médecine et santé;2013;2012-13;2012;2012;12;8;4;55;34;21;13;5;8;;;;;71hqm
156;École doctorale Sciences de la mer;;6;Sciences humaines et humanités;2013;2012-13;2012;2012;3;2;1;14;7;7;3;1;2;;;;;EGY9P
162;École doctorale Mécanique, énergétique, génie civil, acoustique;MEGA;8;Sciences pour l'ingénieur;2013;2012-13;2012;2012;114;31;83;422;101;321;105;15;90;;;;;7wCke
166;École doctorale Information, structures et systèmes;I2S;1;Mathématiques et leurs interactions;2013;2012-13;2012;2012;10;1;9;51;17;34;12;2;10;;;;;2uO68
166;École doctorale Information, structures et systèmes;I2S;8;Sciences pour l'ingénieur;2013;2012-13;2012;2012;28;7;21;82;24;58;15;2;13;;;;;2uO68
178;École doctorale Sciences fondamentales;;3;Sciences de la terre et de l'univers, espace;2013;2012-13;2012;2012;12;4;8;39;17;22;10;5;5;;;;;1AiR7
181;École doctorale Structure, informations, matière et matériaux;Simem;1;Mathématiques et leurs interactions;2013;2012-13;2012;2012;4;1;3;25;6;19;4;1;3;;;;;c1D6f
182;École doctorale Physique et chimie-physique;;2;Physique;2013;2012-13;2012;2012;38;7;31;149;37;112;45;14;31;;;;;3My6I
184;École doctorale Mathématiques et informatique de Marseille;;9;Sciences et technologies de l'information et de la communication;2013;2012-13;2012;2012;20;6;14;97;24;73;20;4;16;;;;;DDObG
205;École doctorale Interdisciplinaire Sciences-Santé;EDISS;5;Biologie, médecine et santé;2013;2012-13;2012;2012;56;21;35;239;126;113;57;34;23;;;;;69W38
205;École doctorale Interdisciplinaire Sciences-Santé;EDISS;7;Sciences de la société;2013;2012-13;2012;2012;10;4;6;45;19;26;8;5;3;;;;;69W38
211;École doctorale Sciences exactes et leurs applications;ED SEA;8;Sciences pour l'ingénieur;2013;2012-13;2012;2012;10;2;8;34;6;28;15;5;10;;;;;1G1iC
216;École doctorale Ingénierie pour la santé, la cognition, l'environnement;EDISCE;2;Physique;2013;2012-13;2012;2012;2;0;2;3;1;2;0;0;0;;;;;fPs1t
216;École doctorale Ingénierie pour la santé, la cognition, l'environnement;EDISCE;7;Sciences de la société;2013;2012-13;2012;2012;3;0;3;3;0;3;0;0;0;;;;;fPs1t
217;École doctorale Mathématiques, sciences et technologies de l'information, informatique;MSTII;9;Sciences et technologies de l'information et de la communication;2013;2012-13;2012;2012;81;19;62;273;57;216;73;14;59;;;;;Ehx7v
227;École doctorale Sciences de la nature et de l'homme;;6;Sciences humaines et humanités;2013;2012-13;2012;2012;7;7;0;36;25;11;7;5;2;;;;;xiDA5
227;École doctorale Sciences de la nature et de l'homme;;10;Sciences agronomiques et écologiques;2013;2012-13;2012;2012;6;4;2;20;10;10;9;5;4;;;;;xiDA5
231;École doctorale Économie et gestion;EDEG;7;Sciences de la société;2013;2012-13;2012;2012;44;20;24;167;88;79;26;13;13;;;;;KT720
240;École doctorale Sciences de l'homme et de la société;SHS;7;Sciences de la société;2013;2012-13;2012;2012;18;9;9;86;37;49;12;5;7;;;;;j345k
242;École doctorale Économie - Gestion - Normandie;;7;Sciences de la société;2013;2012-13;2012;2012;20;12;8;151;67;84;21;11;10;;;;;z35ku
260;École doctorale pluridisciplinaire;;1;Mathématiques et leurs interactions;2013;2012-13;2012;2012;9;3;6;31;12;19;5;2;3;;;;;sCk1f
265;École doctorale Langues, littératures et sociétés du monde;;6;Sciences humaines et humanités;2013;2012-13;2012;2012;75;45;30;298;189;109;28;12;16;;;;;4YWGW
266;École doctorale Biologie, santé, environnement;BIOSE;5;Biologie, médecine et santé;2013;2012-13;2012;2012;42;20;22;164;84;80;59;34;25;;;;;386V9
267;École doctorale Arts et médias;;6;Sciences humaines et humanités;2013;2012-13;2012;2012;78;51;27;341;242;99;31;20;11;;;;;eCF5C
269;École doctorale Mathématiques, sciences de l'information et de l'ingénieur;MSII;2;Physique;2013;2012-13;2012;2012;0;0;0;5;1;4;4;2;2;;;;;5E625
269;École doctorale Mathématiques, sciences de l'information et de l'ingénieur;MSII;6;Sciences humaines et humanités;2013;2012-13;2012;2012;0;0;0;1;1;0;0;0;0;;;;;5E625
279;École doctorale Arts plastiques, esthétique et sciences de l'art;APESA;6;Sciences humaines et humanités;2013;2012-13;2012;2012;40;25;15;295;204;91;44;35;9;;;;;BpW1j
284;École doctorale Droit et Science Politique;DSP;7;Sciences de la société;2013;2012-13;2012;2012;23;14;9;55;31;24;6;2;4;;;;;ahH92
285;École doctorale Sciences pratiques;;7;Sciences de la société;2013;2012-13;2012;2012;7;4;3;37;21;16;2;1;1;;;;;Jd3t2
285;École doctorale Sciences pratiques;;8;Sciences pour l'ingénieur;2013;2012-13;2012;2012;36;9;27;125;27;98;38;7;31;;;;;Jd3t2
285;École doctorale Sciences pratiques;;9;Sciences et technologies de l'information et de la communication;2013;2012-13;2012;2012;11;4;7;35;9;26;6;1;5;;;;;Jd3t2
287;École doctorale Sciences pour l'ingénieur;;1;Mathématiques et leurs interactions;2013;2012-13;2012;2012;13;1;12;46;13;33;11;4;7;;;;;48Q1j
287;École doctorale Sciences pour l'ingénieur;;8;Sciences pour l'ingénieur;2013;2012-13;2012;2012;52;25;27;158;60;98;30;14;16;;;;;48Q1j
300;École doctorale Sciences Économiques;ED SE;7;Sciences de la société;2013;2012-13;2012;2012;6;2;4;72;29;43;19;8;11;;;;;5x3fM
304;École doctorale Sciences et environnements;;10;Sciences agronomiques et écologiques;2013;2012-13;2012;2012;10;4;6;27;12;15;12;3;9;;;;;2ywZn
306;École doctorale Sciences des procédés, sciences des aliments;;4;Chimie;2013;2012-13;2012;2012;3;2;1;12;3;9;0;0;0;;;;;adF7W
306;École doctorale Sciences des procédés, sciences des aliments;;8;Sciences pour l'ingénieur;2013;2012-13;2012;2012;21;8;13;61;31;30;22;11;11;;;;;adF7W
306;École doctorale Sciences des procédés, sciences des aliments;;9;Sciences et technologies de l'information et de la communication;2013;2012-13;2012;2012;1;0;1;2;0;2;1;1;0;;;;;adF7W
351;École doctorale Sciences physiques, mathématiques et de l'information pour l'ingénieur;SPMII;1;Mathématiques et leurs interactions;2013;2012-13;2012;2012;5;2;3;35;18;17;10;4;6;;;;;rY4EP
351;École doctorale Sciences physiques, mathématiques et de l'information pour l'ingénieur;SPMII;2;Physique;2013;2012-13;2012;2012;13;2;11;39;14;25;11;4;7;;;;;rY4EP
351;École doctorale Sciences physiques, mathématiques et de l'information pour l'ingénieur;SPMII;9;Sciences et technologies de l'information et de la communication;2013;2012-13;2012;2012;31;12;19;120;40;80;22;3;19;;;;;rY4EP
353;École doctorale Sciences pour l'ingénieur : mécanique, physique, micro et nanoélectronique;;3;Sciences de la terre et de l'univers, espace;2013;2012-13;2012;2012;0;0;0;8;4;4;0;0;0;;;;;vk5Kp
353;École doctorale Sciences pour l'ingénieur : mécanique, physique, micro et nanoélectronique;;9;Sciences et technologies de l'information et de la communication;2013;2012-13;2012;2012;18;5;13;20;5;15;11;1;10;;;;;vk5Kp
356;École doctorale Cognition, langage, éducation;;9;Sciences et technologies de l'information et de la communication;2013;2012-13;2012;2012;12;5;7;23;12;11;5;2;3;;;;;55Cpz
364;École doctorale Sciences fondamentales et appliquées;EDSFA;4;Chimie;2013;2012-13;2012;2012;11;8;3;30;22;8;10;3;7;;;;;E483q
372;École doctorale Sciences économiques et de gestion;;7;Sciences de la société;2013;2012-13;2012;2012;55;22;33;248;110;138;57;28;29;;;;;JK63A
377;École doctorale Environnement et société;;4;Chimie;2013;2012-13;2012;2012;3;2;1;18;11;7;5;0;5;;;;;ZMG5u
377;École doctorale Environnement et société;;5;Biologie, médecine et santé;2013;2012-13;2012;2012;2;2;0;2;2;0;0;0;0;;;;;ZMG5u
378;École doctorale Sciences de l'homme et de la société;SHS;6;Sciences humaines et humanités;2013;2012-13;2012;2012;13;10;3;76;46;30;9;5;4;;;;;3XKuF
382;École doctorale Économie, espaces, sociétés, civilisations : pensée critique, politique et pratique sociale;EESC;6;Sciences humaines et humanités;2013;2012-13;2012;2012;20;11;9;141;73;68;10;7;3;;;;;9NI1W
387;École doctorale Interdisciplinaire pour le vivant;I-ViV;2;Physique;2013;2012-13;2012;2012;6;3;3;23;12;11;6;4;2;;;;;06uKM
390;École doctorale Génie des procédés et technologies avancées;;4;Chimie;2013;2012-13;2012;2012;5;3;2;20;8;12;6;2;4;;;;;sK3wm
392;École doctorale Diversité du vivant;;5;Biologie, médecine et santé;2013;2012-13;2012;2012;6;4;2;51;23;28;15;6;9;;;;;537J0
393;École doctorale Pierre Louis de Santé Publique : Épidémiologie et Sciences de l'information biomédicale;PLSP;5;Biologie, médecine et santé;2013;2012-13;2012;2012;30;18;12;136;78;58;20;10;10;;;;;69445
397;École doctorale Physique et chimie des matériaux;;2;Physique;2013;2012-13;2012;2012;28;7;21;99;33;66;17;8;9;;;;;WxSt9
400;École doctorale Savoirs scientifiques : épistémologie, histoire des sciences, didactique des disciplines;;3;Sciences de la terre et de l'univers, espace;2013;2012-13;2012;2012;0;0;0;4;1;3;0;0;0;;;;;nRax3
400;École doctorale Savoirs scientifiques : épistémologie, histoire des sciences, didactique des disciplines;;5;Biologie, médecine et santé;2013;2012-13;2012;2012;0;0;0;16;8;8;4;2;2;;;;;nRax3
401;École doctorale Sciences sociales;;6;Sciences humaines et humanités;2013;2012-13;2012;2012;46;21;25;195;85;110;14;5;9;;;;;raQ7K
405;École doctorale Économie, management,mathématiques et physique de Cergy;EM2C;1;Mathématiques et leurs interactions;2013;2012-13;2012;2012;7;1;6;23;10;13;5;3;2;;;;;QbwSB
406;École doctorale Chimie moléculaire de Paris centre;;4;Chimie;2013;2012-13;2012;2012;29;12;17;110;41;69;31;13;18;;;;;a5dKy
409;École doctorale Énergie, mécanique, matériaux;EMMA;4;Chimie;2013;2012-13;2012;2012;24;8;16;93;32;61;31;14;17;;;;;KXlbK
411;École doctorale Humanités nouvelles : Fernand Braudel;;6;Sciences humaines et humanités;2013;2012-13;2012;2012;38;27;11;177;101;76;25;14;11;;;;;l2rFh
412;École doctorale Lorraine de chimie et physique moléculaires : synthèses, expériences, simulations, applications : de la molécule aux édifices supramoléculaires;SESAMES;4;Chimie;2013;2012-13;2012;2012;25;9;16;65;30;35;17;4;13;;;;;mvHX2
413;École doctorale Sciences de la terre et de l'environnement;STE;6;Sciences humaines et humanités;2013;2012-13;2012;2012;3;1;2;15;6;9;1;0;1;;;;;u9BA9
414;École doctorale Sciences de la vie et de la santé;;6;Sciences humaines et humanités;2013;2012-13;2012;2012;0;0;0;0;0;0;1;1;0;;;;;YI4xS
419;École doctorale Signalisations et réseaux intégratifs en biologie;BIO-SIGNE;5;Biologie, médecine et santé;2013;2012-13;2012;2012;33;23;10;137;90;47;24;9;15;;;;;rDuFq
420;École doctorale Santé publique Paris 11 - Paris 5;;5;Biologie, médecine et santé;2013;2012-13;2012;2012;36;21;15;133;83;50;33;25;8;;;;;3BNdi
423;École doctorale Des génomes aux organismes;;1;Mathématiques et leurs interactions;2013;2012-13;2012;2012;2;2;0;5;3;2;3;2;1;;;;;VguHK
435;École doctorale Agriculture, alimentation, biologie, environnement et santé;;3;Sciences de la terre et de l'univers, espace;2013;2012-13;2012;2012;0;0;0;6;2;4;2;0;2;;;;;mC35U
435;École doctorale Agriculture, alimentation, biologie, environnement et santé;;9;Sciences et technologies de l'information et de la communication;2013;2012-13;2012;2012;0;0;0;1;0;1;0;0;0;;;;;mC35U
446;École doctorale Biologie - Santé;EDBSL;4;Chimie;2013;2012-13;2012;2012;0;0;0;0;0;0;2;0;2;;;;;4iEUF
446;École doctorale Biologie - Santé;EDBSL;6;Sciences humaines et humanités;2013;2012-13;2012;2012;0;0;0;0;0;0;2;1;1;;;;;4iEUF
447;École doctorale de l'école polytechnique;;1;Mathématiques et leurs interactions;2013;2012-13;2012;2012;23;6;17;87;15;72;24;5;19;;;;;zgCCh
467;École doctorale Aéronautique, astronautique;AA;2;Physique;2013;2012-13;2012;2012;0;0;0;6;0;6;0;0;0;;;;;U7l45
474;École doctorale Interdisciplinaire européenne frontières du vivant;FDV;2;Physique;2013;2012-13;2012;2012;1;0;1;17;5;12;1;1;0;;;;;E727j
481;École doctorale Sciences sociales et humanités;SSH;6;Sciences humaines et humanités;2013;2012-13;2012;2012;39;26;13;118;78;40;8;6;2;;;;;E3z5j
482;École doctorale Sciences de la matière;SDM;8;Sciences pour l'ingénieur;2013;2012-13;2012;2012;17;8;9;30;12;18;3;2;1;;;;;kmeZ4
483;École doctorale Histoire, géographie, aménagement, urbanisme, archéologie, science politique, sociologie, anthropologie;SCSO;3;Sciences de la terre et de l'univers, espace;2013;2012-13;2012;2012;14;6;8;74;34;40;5;1;4;;;;;hc6u4
485;École doctorale Éducation, Psychologie, Information et Communication;EPIC;9;Sciences et technologies de l'information et de la communication;2013;2012-13;2012;2012;6;3;3;36;19;17;4;3;1;;;;;O82eL
486;École doctorale Sciences économiques et de gestion;SEG;9;Sciences et technologies de l'information et de la communication;2013;2012-13;2012;2012;0;0;0;1;1;0;2;2;0;;;;;h1GZ3
488;École doctorale Sciences, ingénierie, santé;SIS;3;Sciences de la terre et de l'univers, espace;2013;2012-13;2012;2012;9;4;5;31;9;22;10;2;8;;;;;Fy2lK
489;École doctorale Sciences et ingénierie des systèmes, de l'environnement et des organisations;SISEO;9;Sciences et technologies de l'information et de la communication;2013;2012-13;2012;2012;5;3;2;17;5;12;5;0;5;;;;;6pT77
493;École doctorale Erasme;;6;Sciences humaines et humanités;2013;2012-13;2012;2012;37;16;21;195;77;118;19;10;9;;;;;FPW4T
494;École doctorale Jean-Henri Lambert;;8;Sciences pour l'ingénieur;2013;2012-13;2012;2012;4;1;3;26;9;17;12;0;12;;;;;A3m51
495;École doctorale Végétal, environnement, nutrition, agroalimentaire, mer;VENAM;8;Sciences pour l'ingénieur;2013;2012-13;2012;2012;0;0;0;0;0;0;1;0;1;;;;;HL495
501;École doctorale Droit, économie-gestion, sociétés, territoires;;6;Sciences humaines et humanités;2013;2012-13;2012;2012;16;5;11;101;42;59;19;11;8;;;;;wE7WM
502;École doctorale Biologie - Santé;;5;Biologie, médecine et santé;2013;2012-13;2012;2012;108;59;49;330;176;154;71;35;36;;;;;JCFV7
507;École doctorale Sciences humaines et sociales;;6;Sciences humaines et humanités;2013;2012-13;2012;2012;97;46;51;387;198;189;58;25;33;;;;;3e7VM
508;École doctorale Normande de chimie;EDNC;5;Biologie, médecine et santé;2013;2012-13;2012;2012;3;1;2;3;1;2;1;0;1;;;;;E52OO
509;École doctorale Civilisations et sociétés euro-méditerranéennes et comparées;;6;Sciences humaines et humanités;2013;2012-13;2012;2012;16;7;9;59;31;28;8;5;3;;;;;9tbyG
511;École doctorale Sciences et ingénierie;S&I;8;Sciences pour l'ingénieur;2013;2012-13;2012;2012;6;0;6;12;3;9;4;3;1;;;;;7aXuB
514;École doctorale Études anglophones, germanophones et européennes;EDEAGE;6;Sciences humaines et humanités;2013;2012-13;2012;2012;35;27;8;226;167;59;33;22;11;;;;;fuIQs
519;École doctorale Sciences humaines et sociales - Perspectives européennes;SHS-PE;7;Sciences de la société;2013;2012-13;2012;2012;24;14;10;135;76;59;18;14;4;;;;;2f5qs
521;École doctorale Sciences et ingénierie pour l'information, mathématiques;S2I;1;Mathématiques et leurs interactions;2013;2012-13;2012;2012;11;2;9;56;17;39;7;3;4;;;;;V6i83
521;École doctorale Sciences et ingénierie pour l'information, mathématiques;S2I;9;Sciences et technologies de l'information et de la communication;2013;2012-13;2012;2012;61;10;51;218;49;169;56;10;46;;;;;V6i83
521;École doctorale Sciences et ingénierie pour l'information, mathématiques;S2I;10;Sciences agronomiques et écologiques;2013;2012-13;2012;2012;0;0;0;0;0;0;1;0;1;;;;;V6i83
524;École doctorale Biologie - santé;;5;Biologie, médecine et santé;2013;2012-13;2012;2012;39;25;14;150;78;72;23;11;12;;;;;S7Kk6
526;École doctorale Sociétés et organisations;SORG;6;Sciences humaines et humanités;2013;2012-13;2012;2012;29;16;13;110;51;59;23;11;12;;;;;5F3Fd
526;École doctorale Sociétés et organisations;SORG;7;Sciences de la société;2013;2012-13;2012;2012;9;4;5;42;17;25;7;3;4;;;;;5F3Fd
529;École doctorale Cultures et sociétés;CS;7;Sciences de la société;2013;2012-13;2012;2012;13;9;4;59;31;28;4;1;3;;;;;XU9tb
531;École doctorale Sciences, ingénierie et environnement;SIE;1;Mathématiques et leurs interactions;2013;2012-13;2012;2012;0;0;0;1;0;1;0;0;0;;;;;b5BYq
531;École doctorale Sciences, ingénierie et environnement;SIE;6;Sciences humaines et humanités;2013;2012-13;2012;2012;0;0;0;0;0;0;1;1;0;;;;;b5BYq
534;École doctorale Modélisation et instrumentation en physique, énergie, géosciences et environnement;MIPEGE;2;Physique;2013;2012-13;2012;2012;22;4;18;92;28;64;21;4;17;;;;;K93eR
536;École doctorale Sciences et agrosciences;;1;Mathématiques et leurs interactions;2013;2012-13;2012;2012;14;3;11;31;6;25;10;2;8;;;;;pHfqe
539;École doctorale Sciences et technologies de Versailles;;8;Sciences pour l'ingénieur;2013;2012-13;2012;2012;8;1;7;40;7;33;9;2;7;;;;;nv3h8
541;École doctorale de sciences humaines et sociales de La Réunion;SHS;7;Sciences de la société;2013;2012-13;2012;2012;19;9;10;66;32;34;4;1;3;;;;;21SpE
542;École doctorale de sciences de La Réunion;STS;9;Sciences et technologies de l'information et de la communication;2013;2012-13;2012;2012;3;0;3;14;8;6;0;0;0;;;;;2pAql
543;École doctorale de Dauphine;;1;Mathématiques et leurs interactions;2013;2012-13;2012;2012;15;6;9;45;11;34;13;2;11;;;;;u8w6A
543;École doctorale de Dauphine;;9;Sciences et technologies de l'information et de la communication;2013;2012-13;2012;2012;8;0;8;30;7;23;5;2;3;;;;;u8w6A
546;École doctorale Abbé Grégoire;;2;Physique;2013;2012-13;2012;2012;5;1;4;25;7;18;9;1;8;;;;;ZSn7q
546;École doctorale Abbé Grégoire;;4;Chimie;2013;2012-13;2012;2012;0;0;0;2;2;0;1;0;1;;;;;ZSn7q
546;École doctorale Abbé Grégoire;;7;Sciences de la société;2013;2012-13;2012;2012;28;14;14;104;49;55;20;6;14;;;;;ZSn7q
547;École doctorale Sciences, Technologie, Santé;EDSTS;9;Sciences et technologies de l'information et de la communication;2013;2012-13;2012;2012;16;3;13;70;18;52;16;4;12;;;;;wEdn2
548;École doctorale Mer et Sciences;;2;Physique;2013;2012-13;2012;2012;1;0;1;3;1;2;0;0;0;;;;;QX0fS
549;École doctorale Santé, Sciences Biologiques et Chimie du Vivant;SSBCV;3;Sciences de la terre et de l'univers, espace;2013;2012-13;2012;2012;1;1;0;2;2;0;1;0;1;;;;;B9ggO
549;École doctorale Santé, Sciences Biologiques et Chimie du Vivant;SSBCV;6;Sciences humaines et humanités;2013;2012-13;2012;2012;2;2;0;5;5;0;1;1;0;;;;;B9ggO
551;École doctorale Mathématiques, Informatique, Physique Théorique et Ingénierie des Systèmes;MIPTIS;7;Sciences de la société;2013;2012-13;2012;2012;1;1;0;1;1;0;0;0;0;;;;;Mpudz
551;École doctorale Mathématiques, Informatique, Physique Théorique et Ingénierie des Systèmes;MIPTIS;8;Sciences pour l'ingénieur;2013;2012-13;2012;2012;2;1;1;6;1;5;0;0;0;;;;;Mpudz
552;École doctorale Énergie - Matériaux - Sciences de la Terre et de l'Univers;EMTSU;2;Physique;2013;2012-13;2012;2012;18;5;13;39;12;27;23;5;18;;;;;NTZhw
552;École doctorale Énergie - Matériaux - Sciences de la Terre et de l'Univers;EMTSU;3;Sciences de la terre et de l'univers, espace;2013;2012-13;2012;2012;17;5;12;49;18;31;12;6;6;;;;;NTZhw
552;École doctorale Énergie - Matériaux - Sciences de la Terre et de l'Univers;EMTSU;4;Chimie;2013;2012-13;2012;2012;22;10;12;53;17;36;11;6;5;;;;;NTZhw
552;École doctorale Énergie - Matériaux - Sciences de la Terre et de l'Univers;EMTSU;8;Sciences pour l'ingénieur;2013;2012-13;2012;2012;14;5;9;73;18;55;18;3;15;;;;;NTZhw
553;École doctorale Carnot - Pasteur;;2;Physique;2013;2012-13;2012;2012;12;2;10;46;9;37;14;4;10;;;;;6h4Z7
554;École doctorale Environnements - Santé;E-S;9;Sciences et technologies de l'information et de la communication;2013;2012-13;2012;2012;4;3;1;10;6;4;2;0;2;;;;;ElyFU
555;École doctorale Sciences de l'Homme et de la Société;SHS;7;Sciences de la société;2013;2012-13;2012;2012;54;25;29;223;102;121;32;12;20;;;;;44G6m
8;École doctorale Histoire du droit, philosophie du droit et sociologie du droit;;7;Sciences de la société;2023;2022-23;2022;2022;10;5;5;83;43;40;5;2;3;0;0;1;4;pGSed
22;École doctorale Mondes anciens et médiévaux;;6;Sciences humaines et humanités;2023;2022-23;2022;2022;24;19;5;158;92;66;27;13;14;5;5;11;6;fqCbl
37;École doctorale Sciences physiques pour l'ingénieur et microtechniques;SPIM;9;Sciences et technologies de l'information et de la communication;2023;2022-23;2022;2022;47;13;34;211;57;154;43;11;32;22;15;6;0;F7G1B
39;École doctorale Mathématiques et Informatique;EDMIB;9;Sciences et technologies de l'information et de la communication;2023;2022-23;2022;2022;40;14;26;129;37;92;32;7;25;19;11;2;0;TBj2X
41;École doctorale Droit;;7;Sciences de la société;2023;2022-23;2022;2022;34;17;17;287;133;154;38;17;21;1;4;6;27;KnOQK
42;École doctorale Entreprise, économie, société;EES;7;Sciences de la société;2023;2022-23;2022;2022;26;10;16;114;53;61;16;6;10;0;3;10;3;uO01d
50;École doctorale Langues, littératures et sciences humaines;LLSH;6;Sciences humaines et humanités;2023;2022-23;2022;2022;46;35;11;171;127;44;36;31;5;3;8;16;9;8THzQ
50;École doctorale Langues, littératures et sciences humaines;LLSH;9;Sciences et technologies de l'information et de la communication;2023;2022-23;2022;2022;2;2;0;26;14;12;8;5;3;0;3;3;2;8THzQ
62;École doctorale Sciences de la vie et de la santé;;8;Sciences pour l'ingénieur;2023;2022-23;2022;2022;0;0;0;1;0;1;0;0;0;0;0;0;0;vZzE7
71;École doctorale Sciences pour l'ingénieur;;7;Sciences de la société;2023;2022-23;2022;2022;2;2;0;7;6;1;0;0;0;0;0;0;0;H6UYp
73;École doctorale Sciences économiques, sociales, de l'aménagement et du management;SESAM;1;Mathématiques et leurs interactions;2023;2022-23;2022;2022;1;0;1;1;0;1;0;0;0;0;0;0;0;IQ0Hk
78;École doctorale Sociétés, langages, temps, connaissances;STLC;6;Sciences humaines et humanités;2023;2022-23;2022;2022;33;13;20;193;109;84;24;17;7;1;9;8;6;vLU3i
84;École doctorale Sciences et technologies de l'information et de la communication;STIC;9;Sciences et technologies de l'information et de la communication;2023;2022-23;2022;2022;57;13;44;217;55;162;56;16;40;32;19;4;1;9wS2W
86;École doctorale Sociétés, humanités, arts, lettres;LSHS;7;Sciences de la société;2023;2022-23;2022;2022;4;2;2;30;16;14;4;1;3;1;1;1;1;O8E6y
122;École doctorale Europe latine - Amérique latine;;6;Sciences humaines et humanités;2023;2022-23;2022;2022;14;10;4;76;53;23;16;14;2;4;2;2;8;z9lZY
139;École doctorale Connaissance, langage, modélisation;CLM;9;Sciences et technologies de l'information et de la communication;2023;2022-23;2022;2022;3;2;1;7;2;5;0;0;0;0;0;0;0;1lxGH
160;École doctorale Électronique, électrotechnique, automatique;EEA;8;Sciences pour l'ingénieur;2023;2022-23;2022;2022;8;2;6;36;10;26;11;3;8;6;4;1;0;EgfMQ
162;École doctorale Mécanique, énergétique, génie civil, acoustique;MEGA;2;Physique;2023;2022-23;2022;2022;0;0;0;1;0;1;1;1;0;0;1;0;0;7wCke
166;École doctorale Information, structures et systèmes;I2S;4;Chimie;2023;2022-23;2022;2022;0;0;0;3;2;1;2;1;1;1;1;0;0;2uO68
182;École doctorale Physique et chimie-physique;;8;Sciences pour l'ingénieur;2023;2022-23;2022;2022;1;1;0;3;2;1;0;0;0;0;0;0;0;3My6I
184;École doctorale Mathématiques et informatique de Marseille;;6;Sciences humaines et humanités;2023;2022-23;2022;2022;0;0;0;1;1;0;0;0;0;0;0;0;0;DDObG
184;École doctorale Mathématiques et informatique de Marseille;;8;Sciences pour l'ingénieur;2023;2022-23;2022;2022;4;2;2;16;5;11;1;0;1;0;1;0;0;DDObG
184;École doctorale Mathématiques et informatique de Marseille;;9;Sciences et technologies de l'information et de la communication;2023;2022-23;2022;2022;22;8;14;43;14;29;4;1;3;1;2;1;0;DDObG
205;École doctorale Interdisciplinaire Sciences-Santé;EDISS;4;Chimie;2023;2022-23;2022;2022;2;1;1;3;1;2;1;0;1;1;0;0;0;69W38
205;École doctorale Interdisciplinaire Sciences-Santé;EDISS;9;Sciences et technologies de l'information et de la communication;2023;2022-23;2022;2022;1;0;1;13;7;6;4;2;2;2;2;0;0;69W38
209;École doctorale Sciences physiques et de L'ingénieur;SPI;8;Sciences pour l'ingénieur;2023;2022-23;2022;2022;18;8;10;86;26;60;23;8;15;10;10;3;0;tZcIZ
211;École doctorale Sciences exactes et leurs applications;ED SEA;2;Physique;2023;2022-23;2022;2022;5;1;4;21;3;18;1;0;1;0;0;0;1;1G1iC
211;École doctorale Sciences exactes et leurs applications;ED SEA;9;Sciences et technologies de l'information et de la communication;2023;2022-23;2022;2022;5;2;3;13;4;9;10;3;7;4;5;1;0;1G1iC
216;École doctorale Ingénierie pour la santé, la cognition, l'environnement;EDISCE;5;Biologie, médecine et santé;2023;2022-23;2022;2022;62;25;37;225;115;110;45;22;23;12;29;4;0;fPs1t
217;École doctorale Mathématiques, sciences et technologies de l'information, informatique;MSTII;1;Mathématiques et leurs interactions;2023;2022-23;2022;2022;25;3;22;106;26;80;24;5;19;12;11;1;0;Ehx7v
227;École doctorale Sciences de la nature et de l'homme;;2;Physique;2023;2022-23;2022;2022;0;0;0;0;0;0;1;1;0;0;1;0;0;xiDA5
227;École doctorale Sciences de la nature et de l'homme;;7;Sciences de la société;2023;2022-23;2022;2022;2;1;1;9;6;3;4;2;2;0;4;0;0;xiDA5
234;École doctorale de Sciences Po;;6;Sciences humaines et humanités;2023;2022-23;2022;2022;59;20;39;304;135;169;48;29;19;4;8;23;13;ux756
275;École doctorale Sciences de gestion;EDSG;7;Sciences de la société;2023;2022-23;2022;2022;10;5;5;44;19;25;14;7;7;4;5;0;5;6QC4I
305;École doctorale Énergie et environnement;E2;3;Sciences de la terre et de l'univers, espace;2023;2022-23;2022;2022;1;0;1;10;1;9;0;0;0;0;0;0;0;Kbt8I
305;École doctorale Énergie et environnement;E2;4;Chimie;2023;2022-23;2022;2022;2;1;1;12;7;5;2;1;1;0;2;0;0;Kbt8I
309;École doctorale Systèmes;EDSYS;6;Sciences humaines et humanités;2023;2022-23;2022;2022;1;1;0;1;1;0;0;0;0;0;0;0;0;8TT4b
309;École doctorale Systèmes;EDSYS;9;Sciences et technologies de l'information et de la communication;2023;2022-23;2022;2022;12;5;7;73;16;57;24;4;20;11;11;2;0;8TT4b
323;École doctorale Génie électrique, électronique et télécommunications;GEET;4;Chimie;2023;2022-23;2022;2022;0;0;0;1;0;1;0;0;0;0;0;0;0;arcz6
323;École doctorale Génie électrique, électronique et télécommunications;GEET;5;Biologie, médecine et santé;2023;2022-23;2022;2022;2;0;2;6;2;4;1;1;0;0;0;1;0;arcz6
326;École doctorale Comportement, langage, éducation, socialisation, cognition;CLESCO;6;Sciences humaines et humanités;2023;2022-23;2022;2022;50;40;10;234;160;74;37;26;11;4;16;13;4;nWIlG
326;École doctorale Comportement, langage, éducation, socialisation, cognition;CLESCO;7;Sciences de la société;2023;2022-23;2022;2022;0;0;0;9;6;3;1;1;0;0;1;0;0;nWIlG
327;École doctorale Temps, espaces, sociétés, cultures;TESC;9;Sciences et technologies de l'information et de la communication;2023;2022-23;2022;2022;1;1;0;1;1;0;0;0;0;0;0;0;0;IjgiJ
328;École doctorale Arts, lettres, langues, philosophie et communication;ALLPH@;6;Sciences humaines et humanités;2023;2022-23;2022;2022;61;39;22;330;216;114;37;27;10;3;6;15;13;xLxMh
361;École doctorale Sciences et Technologies;ED ST;2;Physique;2023;2022-23;2022;2022;6;2;4;39;16;23;13;7;6;3;7;3;0;cOUmL
364;École doctorale Sciences fondamentales et appliquées;EDSFA;3;Sciences de la terre et de l'univers, espace;2023;2022-23;2022;2022;17;7;10;65;22;43;12;5;7;5;7;0;0;E483q
397;École doctorale Physique et chimie des matériaux;;2;Physique;2023;2022-23;2022;2022;65;29;36;113;47;66;30;10;20;16;14;0;0;WxSt9
397;École doctorale Physique et chimie des matériaux;;4;Chimie;2023;2022-23;2022;2022;9;4;5;149;72;77;48;26;22;32;15;1;0;WxSt9
398;École doctorale Géosciences, ressources naturelles et environnement;GRNE;2;Physique;2023;2022-23;2022;2022;1;0;1;3;0;3;0;0;0;0;0;0;0;Zi4Zf
398;École doctorale Géosciences, ressources naturelles et environnement;GRNE;3;Sciences de la terre et de l'univers, espace;2023;2022-23;2022;2022;27;13;14;95;41;54;25;9;16;8;16;0;1;Zi4Zf
405;École doctorale Économie, management,mathématiques et physique de Cergy;EM2C;9;Sciences et technologies de l'information et de la communication;2023;2022-23;2022;2022;15;3;12;55;15;40;9;1;8;5;3;1;0;QbwSB
413;École doctorale Sciences de la terre et de l'environnement;STE;8;Sciences pour l'ingénieur;2023;2022-23;2022;2022;1;0;1;1;0;1;0;0;0;0;0;0;0;u9BA9
417;École doctorale Sciences et Ingénierie;S&I;3;Sciences de la terre et de l'univers, espace;2023;2022-23;2022;2022;2;0;2;11;4;7;3;1;2;0;3;0;0;SSBvE
417;École doctorale Sciences et Ingénierie;S&I;9;Sciences et technologies de l'information et de la communication;2023;2022-23;2022;2022;3;1;2;7;1;6;3;2;1;0;3;0;0;SSBvE
441;École doctorale Histoire de l'art;;6;Sciences humaines et humanités;2023;2022-23;2022;2022;25;18;7;158;115;43;16;14;2;0;1;3;12;d5W3U
446;École doctorale Biologie - Santé;EDBSL;4;Chimie;2023;2022-23;2022;2022;0;0;0;7;3;4;2;1;1;2;0;0;0;4iEUF
446;École doctorale Biologie - Santé;EDBSL;5;Biologie, médecine et santé;2023;2022-23;2022;2022;94;49;45;361;209;152;69;45;24;25;36;7;1;4iEUF
454;École doctorale Sciences de l'homme, du politique et du territoire;SHPT;6;Sciences humaines et humanités;2023;2022-23;2022;2022;33;18;15;191;102;89;27;15;12;1;5;9;12;Opv31
454;École doctorale Sciences de l'homme, du politique et du territoire;SHPT;7;Sciences de la société;2023;2022-23;2022;2022;10;3;7;84;44;40;7;1;6;0;0;2;5;Opv31
459;École doctorale Sciences chimiques Balard;;2;Physique;2023;2022-23;2022;2022;1;1;0;4;3;1;0;0;0;0;0;0;0;YFs2W
465;École doctorale Économie Panthéon Sorbonne;EPS;1;Mathématiques et leurs interactions;2023;2022-23;2022;2022;1;1;0;16;5;11;4;0;4;1;1;1;1;MV68S
465;École doctorale Économie Panthéon Sorbonne;EPS;7;Sciences de la société;2023;2022-23;2022;2022;57;21;36;282;123;159;47;16;31;4;14;25;4;MV68S
467;École doctorale Aéronautique, astronautique;AA;1;Mathématiques et leurs interactions;2023;2022-23;2022;2022;0;0;0;17;3;14;7;0;7;2;4;0;1;U7l45
467;École doctorale Aéronautique, astronautique;AA;3;Sciences de la terre et de l'univers, espace;2023;2022-23;2022;2022;0;0;0;4;1;3;0;0;0;0;0;0;0;U7l45
467;École doctorale Aéronautique, astronautique;AA;4;Chimie;2023;2022-23;2022;2022;0;0;0;1;0;1;0;0;0;0;0;0;0;U7l45
467;École doctorale Aéronautique, astronautique;AA;7;Sciences de la société;2023;2022-23;2022;2022;0;0;0;2;1;1;2;1;1;1;1;0;0;U7l45
467;École doctorale Aéronautique, astronautique;AA;8;Sciences pour l'ingénieur;2023;2022-23;2022;2022;0;0;0;20;4;16;7;3;4;4;3;0;0;U7l45
469;École doctorale du Pacifique;EDP;2;Physique;2023;2022-23;2022;2022;0;0;0;1;0;1;0;0;0;0;0;0;0;t9Z2n
469;École doctorale du Pacifique;EDP;7;Sciences de la société;2023;2022-23;2022;2022;5;4;1;17;10;7;4;2;2;1;2;0;1;t9Z2n
469;École doctorale du Pacifique;EDP;10;Sciences agronomiques et écologiques;2023;2022-23;2022;2022;3;2;1;15;9;6;2;1;1;1;0;1;0;t9Z2n
472;École doctorale de l'EPHE;;6;Sciences humaines et humanités;2023;2022-23;2022;2022;80;44;36;481;248;233;68;40;28;6;14;17;31;27zK4
472;École doctorale de l'EPHE;;8;Sciences pour l'ingénieur;2023;2022-23;2022;2022;1;1;0;2;1;1;0;0;0;0;0;0;0;27zK4
474;École doctorale Interdisciplinaire européenne frontières du vivant;FDV;1;Mathématiques et leurs interactions;2023;2022-23;2022;2022;0;0;0;5;1;4;1;1;0;1;0;0;0;E727j
474;École doctorale Interdisciplinaire européenne frontières du vivant;FDV;2;Physique;2023;2022-23;2022;2022;1;1;0;1;1;0;1;0;1;1;0;0;0;E727j
474;École doctorale Interdisciplinaire européenne frontières du vivant;FDV;3;Sciences de la terre et de l'univers, espace;2023;2022-23;2022;2022;5;2;3;13;8;5;3;3;0;2;1;0;0;E727j
474;École doctorale Interdisciplinaire européenne frontières du vivant;FDV;5;Biologie, médecine et santé;2023;2022-23;2022;2022;19;7;12;101;50;51;27;12;15;24;3;0;0;E727j
474;École doctorale Interdisciplinaire européenne frontières du vivant;FDV;9;Sciences et technologies de l'information et de la communication;2023;2022-23;2022;2022;0;0;0;2;1;1;1;0;1;1;0;0;0;E727j
481;École doctorale Sciences sociales et humanités;SSH;6;Sciences humaines et humanités;2023;2022-23;2022;2022;16;12;4;113;65;48;18;7;11;3;3;5;7;E3z5j
482;École doctorale Sciences de la matière;SDM;4;Chimie;2023;2022-23;2022;2022;62;27;35;208;92;116;32;18;14;14;15;3;0;kmeZ4
483;École doctorale Histoire, géographie, aménagement, urbanisme, archéologie, science politique, sociologie, anthropologie;SCSO;8;Sciences pour l'ingénieur;2023;2022-23;2022;2022;0;0;0;9;4;5;0;0;0;0;0;0;0;hc6u4
488;École doctorale Sciences, ingénierie, santé;SIS;4;Chimie;2023;2022-23;2022;2022;3;3;0;16;8;8;5;5;0;1;3;1;0;Fy2lK
488;École doctorale Sciences, ingénierie, santé;SIS;9;Sciences et technologies de l'information et de la communication;2023;2022-23;2022;2022;30;4;26;158;38;120;33;8;25;15;15;2;1;Fy2lK
488;École doctorale Sciences, ingénierie, santé;SIS;10;Sciences agronomiques et écologiques;2023;2022-23;2022;2022;0;0;0;4;2;2;1;0;1;0;1;0;0;Fy2lK
493;École doctorale Erasme;;6;Sciences humaines et humanités;2023;2022-23;2022;2022;16;9;7;89;63;26;11;7;4;0;3;6;2;FPW4T
493;École doctorale Erasme;;9;Sciences et technologies de l'information et de la communication;2023;2022-23;2022;2022;7;3;4;27;16;11;3;1;2;0;1;0;2;FPW4T
497;École doctorale Normande de Biologie Intégrative, Santé, Environnement;Ed NBISE;3;Sciences de la terre et de l'univers, espace;2023;2022-23;2022;2022;0;0;0;6;2;4;2;0;2;0;1;1;0;0D9Je
497;École doctorale Normande de Biologie Intégrative, Santé, Environnement;Ed NBISE;9;Sciences et technologies de l'information et de la communication;2023;2022-23;2022;2022;0;0;0;1;0;1;1;0;1;1;0;0;0;0D9Je
497;École doctorale Normande de Biologie Intégrative, Santé, Environnement;Ed NBISE;10;Sciences agronomiques et écologiques;2023;2022-23;2022;2022;8;1;7;34;12;22;11;8;3;3;8;0;0;0D9Je
509;École doctorale Civilisations et sociétés euro-méditerranéennes et comparées;;6;Sciences humaines et humanités;2023;2022-23;2022;2022;10;8;2;45;26;19;4;4;0;1;0;2;1;9tbyG
512;École doctorale Informatique et mathématiques;InfoMaths;8;Sciences pour l'ingénieur;2023;2022-23;2022;2022;0;0;0;6;0;6;0;0;0;0;0;0;0;t86bi
512;École doctorale Informatique et mathématiques;InfoMaths;9;Sciences et technologies de l'information et de la communication;2023;2022-23;2022;2022;55;6;49;216;50;166;47;7;40;36;8;3;0;t86bi
528;École doctorale Ville, transports et territoires;VTT;7;Sciences de la société;2023;2022-23;2022;2022;4;2;2;38;15;23;3;2;1;0;2;0;1;68zCc
531;École doctorale Sciences, ingénierie et environnement;SIE;2;Physique;2023;2022-23;2022;2022;4;2;2;23;8;15;6;1;5;4;2;0;0;b5BYq
537;École doctorale Culture et patrimoine;C&P;6;Sciences humaines et humanités;2023;2022-23;2022;2022;10;6;4;68;28;40;5;3;2;1;0;3;1;GxI4a
540;"École doctorale École transdisciplinaire ""lettres/sciences""";;8;Sciences pour l'ingénieur;2023;2022-23;2022;2022;1;0;1;6;3;3;0;0;0;0;0;0;0;tWWw7
542;École doctorale de sciences de La Réunion;STS;1;Mathématiques et leurs interactions;2023;2022-23;2022;2022;1;1;0;3;2;1;1;0;1;0;0;1;0;2pAql
542;École doctorale de sciences de La Réunion;STS;4;Chimie;2023;2022-23;2022;2022;1;1;0;4;2;2;2;1;1;0;2;0;0;2pAql
544;École doctorale Inter-Med : Espaces, temps, cultures;INTER-MED;6;Sciences humaines et humanités;2023;2022-23;2022;2022;15;8;7;91;51;40;12;8;4;3;2;3;4;7VjtD
548;École doctorale Mer et Sciences;;3;Sciences de la terre et de l'univers, espace;2023;2022-23;2022;2022;3;2;1;8;7;1;4;2;2;2;0;2;0;QX0fS
549;École doctorale Santé, Sciences Biologiques et Chimie du Vivant;SSBCV;4;Chimie;2023;2022-23;2022;2022;11;6;5;43;20;23;14;6;8;7;7;0;0;B9ggO
549;École doctorale Santé, Sciences Biologiques et Chimie du Vivant;SSBCV;6;Sciences humaines et humanités;2023;2022-23;2022;2022;4;3;1;8;7;1;2;2;0;0;2;0;0;B9ggO
551;École doctorale Mathématiques, Informatique, Physique Théorique et Ingénierie des Systèmes;MIPTIS;1;Mathématiques et leurs interactions;2023;2022-23;2022;2022;8;1;7;27;6;21;7;2;5;3;2;2;0;Mpudz
551;École doctorale Mathématiques, Informatique, Physique Théorique et Ingénierie des Systèmes;MIPTIS;2;Physique;2023;2022-23;2022;2022;1;1;0;9;2;7;0;0;0;0;0;0;0;Mpudz
551;École doctorale Mathématiques, Informatique, Physique Théorique et Ingénierie des Systèmes;MIPTIS;5;Biologie, médecine et santé;2023;2022-23;2022;2022;0;0;0;0;0;0;1;0;1;1;0;0;0;Mpudz
551;École doctorale Mathématiques, Informatique, Physique Théorique et Ingénierie des Systèmes;MIPTIS;8;Sciences pour l'ingénieur;2023;2022-23;2022;2022;2;1;1;16;6;10;3;3;0;0;2;1;0;Mpudz
552;École doctorale Énergie - Matériaux - Sciences de la Terre et de l'Univers;EMTSU;8;Sciences pour l'ingénieur;2023;2022-23;2022;2022;25;7;18;115;30;85;16;7;9;9;6;1;0;NTZhw
553;École doctorale Carnot - Pasteur;;3;Sciences de la terre et de l'univers, espace;2023;2022-23;2022;2022;2;1;1;4;2;2;1;1;0;1;0;0;0;6h4Z7
554;École doctorale Environnements - Santé;E-S;3;Sciences de la terre et de l'univers, espace;2023;2022-23;2022;2022;6;2;4;27;9;18;5;2;3;1;3;1;0;ElyFU
555;École doctorale Sciences de l'Homme et de la Société;SHS;7;Sciences de la société;2023;2022-23;2022;2022;14;10;4;122;53;69;11;3;8;2;1;4;4;44G6m
556;École doctorale Homme, Sociétés, Risques, Territoire;HSRT;6;Sciences humaines et humanités;2023;2022-23;2022;2022;6;2;4;30;16;14;4;0;4;0;0;0;4;5QEaX
559;École doctorale Management Panthéon-Sorbonne;;1;Mathématiques et leurs interactions;2023;2022-23;2022;2022;1;1;0;10;5;5;7;5;2;0;0;2;5;4SP7k
559;École doctorale Management Panthéon-Sorbonne;;7;Sciences de la société;2023;2022-23;2022;2022;45;22;23;191;106;85;26;11;15;2;13;9;2;4SP7k
560;École doctorale Sciences de la terre et de l'environnement et Physique de l'univers, Paris;STEP'UP;2;Physique;2023;2022-23;2022;2022;13;6;7;32;10;22;9;2;7;7;2;0;0;Z2VI9
563;École doctorale Médicament - Toxicologie - Chimie - Imageries;MTCI;4;Chimie;2023;2022-23;2022;2022;3;0;3;36;16;20;7;4;3;2;5;0;0;j8uk1
567;École doctorale Sciences du Végétal : du gène à l'écosystème;;10;Sciences agronomiques et écologiques;2023;2022-23;2022;2022;10;7;3;57;34;23;11;3;8;3;6;2;0;tuDkA
570;École doctorale Santé Publique;EDSP;6;Sciences humaines et humanités;2023;2022-23;2022;2022;1;1;0;7;4;3;0;0;0;0;0;0;0;9lgE4
571;École doctorale Sciences Chimiques : Molécules, Matériaux, Instrumentation et Biosystemes;2MIB;2;Physique;2023;2022-23;2022;2022;11;3;8;23;10;13;8;3;5;4;4;0;0;zbi37
575;École doctorale Electrical, Optical, Bio : Physics and Engineering;EOBE;4;Chimie;2023;2022-23;2022;2022;0;0;0;2;1;1;1;0;1;1;0;0;0;dfhyn
579;École doctorale Sciences mécaniques et energétiques, matériaux et géosciences;SMEMaG;2;Physique;2023;2022-23;2022;2022;0;0;0;4;0;4;6;0;6;1;3;2;0;atMj7
579;École doctorale Sciences mécaniques et energétiques, matériaux et géosciences;SMEMaG;4;Chimie;2023;2022-23;2022;2022;0;0;0;2;1;1;0;0;0;0;0;0;0;atMj7
581;École doctorale Agriculture, alimentation, biologie, environnement, santé;ABIES;8;Sciences pour l'ingénieur;2023;2022-23;2022;2022;9;7;2;37;21;16;16;6;10;7;6;3;0;c1x56
583;École doctorale Risques et Société;;4;Chimie;2023;2022-23;2022;2022;0;0;0;3;1;2;2;1;1;0;2;0;0;wUBi9
583;École doctorale Risques et Société;;7;Sciences de la société;2023;2022-23;2022;2022;1;1;0;9;4;5;1;0;1;0;0;0;1;wUBi9
584;École doctorale Biodiversité, Agriculture, Alimentation, Environnement, Terre, Eau;GAIA;3;Sciences de la terre et de l'univers, espace;2023;2022-23;2022;2022;14;9;5;73;37;36;18;5;13;4;10;3;1;F1h5f
584;École doctorale Biodiversité, Agriculture, Alimentation, Environnement, Terre, Eau;GAIA;8;Sciences pour l'ingénieur;2023;2022-23;2022;2022;0;0;0;2;1;1;5;4;1;1;4;0;0;F1h5f
585;École doctorale Sciences, Technologie,  Sante;EDSTS;1;Mathématiques et leurs interactions;2023;2022-23;2022;2022;12;1;11;36;14;22;9;7;2;7;1;1;0;NM3Dl
585;École doctorale Sciences, Technologie,  Sante;EDSTS;3;Sciences de la terre et de l'univers, espace;2023;2022-23;2022;2022;1;1;0;3;3;0;1;0;1;0;1;0;0;NM3Dl
587;École doctorale Diversites, santé et développement en Amazonie;;1;Mathématiques et leurs interactions;2023;2022-23;2022;2022;1;1;0;1;1;0;0;0;0;0;0;0;0;V14tj
589;École doctorale Milieu insulaire tropical à risques : protection, valorisation , santé et développement;;1;Mathématiques et leurs interactions;2023;2022-23;2022;2022;0;0;0;0;0;0;1;0;1;1;0;0;0;2cqi3
590;École doctorale Mathematiques, Information, Ingenierie des Systemes;MIIS;1;Mathématiques et leurs interactions;2023;2022-23;2022;2022;16;4;12;55;11;44;10;3;7;6;3;1;0;L20t5
591;École doctorale Physique, Sciences de l'Ingenieur, Materiaux, Énergie;PSIME;2;Physique;2023;2022-23;2022;2022;28;6;22;114;33;81;31;10;21;13;16;2;0;Hn5Om
596;École doctorale Matière, Molécules et Matériaux;ED 3M;3;Sciences de la terre et de l'univers, espace;2023;2022-23;2022;2022;11;6;5;31;16;15;2;0;2;1;1;0;0;77947
598;École doctorale Sciences de La Mer et du Littoral;SML;7;Sciences de la société;2023;2022-23;2022;2022;6;3;3;19;10;9;2;2;0;1;0;0;1;Smen6
600;École doctorale Écologie, Géosciences, Agronomie et Alimentation;EGAAL;5;Biologie, médecine et santé;2023;2022-23;2022;2022;15;7;8;41;21;20;20;9;11;8;12;0;0;urS33
602;École doctorale Sciences pour l'Ingénieur;SPI;8;Sciences pour l'ingénieur;2023;2022-23;2022;2022;95;26;69;334;94;240;89;33;56;50;32;7;0;8yWbu
603;École doctorale Éducation, Langages, Interactions, Cognition, Clinique, Expertise - ED 603;ELICCE;6;Sciences humaines et humanités;2023;2022-23;2022;2022;28;13;15;147;85;62;34;18;16;2;12;11;9;1Mzw7
603;École doctorale Éducation, Langages, Interactions, Cognition, Clinique, Expertise - ED 603;ELICCE;9;Sciences et technologies de l'information et de la communication;2023;2022-23;2022;2022;0;0;0;0;0;0;1;0;1;1;0;0;0;1Mzw7
605;École doctorale Biologie Santé;ED BS;5;Biologie, médecine et santé;2023;2022-23;2022;2022;73;43;30;270;162;108;83;43;40;36;40;3;4;w8CxU
607;École doctorale Sciences et Ingénierie des Ressources Naturelles;SIReNA;3;Sciences de la terre et de l'univers, espace;2023;2022-23;2022;2022;12;4;8;76;27;49;14;5;9;7;5;2;0;vi9w2
608;École doctorale Sciences et Ingénierie des Molécules, des Produits, des Procédés et de l'Énergie;SIMPPÉ;8;Sciences pour l'ingénieur;2023;2022-23;2022;2022;47;14;33;198;67;131;52;22;30;23;26;3;0;TyNjM
610;École doctorale Sciences et Ingénierie des Systèmes, Mathématiques, Informatique;SISMI;9;Sciences et technologies de l'information et de la communication;2023;2022-23;2022;2022;0;0;0;0;0;0;19;1;18;4;11;3;1;dBCUB
611;École doctorale Sciences du Langage, Psychologie, Cognition, Education;SLPCE;6;Sciences humaines et humanités;2023;2022-23;2022;2022;0;0;0;0;0;0;10;4;6;2;4;3;1;z8agK
615;École doctorale Sciences Biologiques et Santé;SBS;5;Biologie, médecine et santé;2023;2022-23;2022;2022;0;0;0;0;0;0;16;10;6;4;8;4;0;TNa15
617;École doctorale Sciences de la Société : Territoires, Economie et Droit;SSTED;7;Sciences de la société;2023;2022-23;2022;2022;37;15;22;183;84;99;15;8;7;1;1;7;6;Kl9ZX
617;École doctorale Sciences de la Société : Territoires, Economie et Droit;SSTED;10;Sciences agronomiques et écologiques;2023;2022-23;2022;2022;0;0;0;0;0;0;1;0;1;0;1;0;0;Kl9ZX
618;École doctorale EUCLIDE;;6;Sciences humaines et humanités;2023;2022-23;2022;2022;5;4;1;16;11;5;9;3;6;1;3;3;2;qveTN
618;École doctorale EUCLIDE;;10;Sciences agronomiques et écologiques;2023;2022-23;2022;2022;14;10;4;45;32;13;10;4;6;6;4;0;0;qveTN
619;École doctorale Sciences Fondamentales et Santé;SFS;2;Physique;2023;2022-23;2022;2022;2;1;1;5;2;3;2;2;0;1;1;0;0;JiZVW
619;École doctorale Sciences Fondamentales et Santé;SFS;5;Biologie, médecine et santé;2023;2022-23;2022;2022;17;13;4;82;51;31;13;5;8;3;6;2;2;JiZVW
619;École doctorale Sciences Fondamentales et Santé;SFS;7;Sciences de la société;2023;2022-23;2022;2022;0;0;0;1;0;1;0;0;0;0;0;0;0;JiZVW
620;École doctorale Sciences du Numérique et de l'Ingénieur;SNI;2;Physique;2023;2022-23;2022;2022;4;0;4;11;0;11;3;3;0;3;0;0;0;Dr40w
622;École doctorale Sciences du langage;SDL;6;Sciences humaines et humanités;2023;2022-23;2022;2022;37;29;8;244;179;65;43;31;12;2;11;17;13;9DsG2
626;École doctorale de l’Institut Polytechnique de Paris;;3;Sciences de la terre et de l'univers, espace;2023;2022-23;2022;2022;2;1;1;13;7;6;3;0;3;2;0;1;0;DL5fO
626;École doctorale de l’Institut Polytechnique de Paris;;9;Sciences et technologies de l'information et de la communication;2023;2022-23;2022;2022;92;20;72;334;95;239;80;17;63;44;30;5;1;DL5fO
629;École doctorale Sciences sociales et Humanités;SSH;7;Sciences de la société;2023;2022-23;2022;2022;5;2;3;57;26;31;8;6;2;0;1;1;6;nnSns
632;École doctorale Science de l’ingénierie et des systèmes;ENGSYS;8;Sciences pour l'ingénieur;2023;2022-23;2022;2022;50;16;34;171;48;123;38;13;25;19;17;2;0;1jT2e
633;École doctorale Cultures, Sociétés, Territoires;CST;9;Sciences et technologies de l'information et de la communication;2023;2022-23;2022;2022;2;2;0;7;5;2;3;0;3;1;0;2;0;54818
634;École doctorale Sciences, Ingénierie, Environnement;SIE;3;Sciences de la terre et de l'univers, espace;2023;2022-23;2022;2022;5;2;3;17;8;9;3;2;1;1;1;0;1;TOc8f
634;École doctorale Sciences, Ingénierie, Environnement;SIE;4;Chimie;2023;2022-23;2022;2022;2;0;2;9;5;4;2;0;2;0;2;0;0;TOc8f
635;École doctorale Polytechnique Hauts-de-France;PHF;7;Sciences de la société;2023;2022-23;2022;2022;9;6;3;22;12;10;1;1;0;0;0;1;0;p2m23
636;;;7;Sciences de la société;2023;2022-23;2022;2022;9;5;4;52;32;20;1;0;1;0;0;1;0;
636;;;8;Sciences pour l'ingénieur;2023;2022-23;2022;2022;0;0;0;3;1;2;0;0;0;0;0;0;0;
637;École doctorale Sciences de la vie et de la santé;SVS;5;Biologie, médecine et santé;2023;2022-23;2022;2022;67;34;33;262;130;132;86;54;32;29;44;11;2;3byga
638;École doctorale Science de la Matière, des Molécules et Matériaux;S3M;2;Physique;2023;2022-23;2022;2022;25;9;16;78;24;54;23;5;18;17;6;0;0;7artx
642;École doctorale Végétal, Animal, Aliment, Mer, Environnement;VAAME;5;Biologie, médecine et santé;2023;2022-23;2022;2022;18;11;7;50;27;23;6;4;2;4;2;0;0;jcs9y
648;;;7;Sciences de la société;2023;2022-23;2022;2022;1;0;1;6;1;5;2;2;0;1;0;1;0;
650;;;6;Sciences humaines et humanités;2023;2022-23;2022;2022;15;6;9;126;68;58;0;0;0;0;0;0;0;
652;École doctorale Biologie, Chimie, Santé;OMEGA-LIM;5;Biologie, médecine et santé;2023;2022-23;2022;2022;19;8;11;99;57;42;25;19;6;14;8;2;1;wh5hf
654;École doctorale Littératures, Sciences Humaines et Sociales;SHS;7;Sciences de la société;2023;2022-23;2022;2022;3;1;2;9;6;3;0;0;0;0;0;0;0;k2ywn
655;École doctorale Gouvernance des Institutions et des Organisations;;7;Sciences de la société;2023;2022-23;2022;2022;20;6;14;91;40;51;8;3;5;0;0;3;5;izw4r
20;École doctorale Civilisations, cultures, littératures et sociétés;;6;Sciences humaines et humanités;2019;2018-19;2018;2018;53;34;19;231;154;77;25;13;12;;;;;agjNi
22;École doctorale Mondes anciens et médiévaux;;6;Sciences humaines et humanités;2019;2018-19;2018;2018;34;17;17;169;95;74;26;13;13;;;;;fqCbl
39;École doctorale Mathématiques et Informatique;EDMIB;1;Mathématiques et leurs interactions;2019;2018-19;2018;2018;28;6;22;87;20;67;29;7;22;;;;;TBj2X
39;École doctorale Mathématiques et Informatique;EDMIB;9;Sciences et technologies de l'information et de la communication;2019;2018-19;2018;2018;33;8;25;110;21;89;26;3;23;;;;;TBj2X
60;École doctorale Territoires, temps, sociétés et développement;TTSD;10;Sciences agronomiques et écologiques;2019;2018-19;2018;2018;1;1;0;4;2;2;1;1;0;;;;;fkIh6
62;École doctorale Sciences de la vie et de la santé;;3;Sciences de la terre et de l'univers, espace;2019;2018-19;2018;2018;1;1;0;2;2;0;0;0;0;;;;;vZzE7
62;École doctorale Sciences de la vie et de la santé;;7;Sciences de la société;2019;2018-19;2018;2018;0;0;0;1;0;1;0;0;0;;;;;vZzE7
72;École doctorale Sciences pour l'ingénieur;SPI;9;Sciences et technologies de l'information et de la communication;2019;2018-19;2018;2018;106;23;83;393;102;291;110;37;73;;;;;47QPx
73;École doctorale Sciences économiques, sociales, de l'aménagement et du management;SESAM;6;Sciences humaines et humanités;2019;2018-19;2018;2018;18;7;11;27;9;18;4;2;2;;;;;IQ0Hk
78;École doctorale Sociétés, langages, temps, connaissances;STLC;7;Sciences de la société;2019;2018-19;2018;2018;3;2;1;19;13;6;4;3;1;;;;;vLU3i
86;École doctorale Sociétés, humanités, arts, lettres;LSHS;6;Sciences humaines et humanités;2019;2018-19;2018;2018;57;33;24;234;139;95;38;26;12;;;;;O8E6y
98;École doctorale Droit-Normandie;EDDN;7;Sciences de la société;2019;2018-19;2018;2018;17;3;14;133;63;70;16;10;6;;;;;9fYyW
104;École doctorale Sciences de la matière, du rayonnement et de l'environnement;SMRE;10;Sciences agronomiques et écologiques;2019;2018-19;2018;2018;20;13;7;78;51;27;25;12;13;;;;;Q5iFz
105;École doctorale Terre, univers, environnement;;3;Sciences de la terre et de l'univers, espace;2019;2018-19;2018;2018;44;11;33;158;60;98;50;23;27;;;;;lcWAf
120;École doctorale Littérature française et comparée;;6;Sciences humaines et humanités;2019;2018-19;2018;2018;31;22;9;227;164;63;37;22;15;;;;;3ULpe
122;École doctorale Europe latine - Amérique latine;;7;Sciences de la société;2019;2018-19;2018;2018;14;11;3;44;29;15;5;3;2;;;;;z9lZY
129;École doctorale Sciences de l'environnement d'Ile de France;SEIF;1;Mathématiques et leurs interactions;2019;2018-19;2018;2018;0;0;0;0;0;0;1;1;0;;;;;TnAPh
129;École doctorale Sciences de l'environnement d'Ile de France;SEIF;3;Sciences de la terre et de l'univers, espace;2019;2018-19;2018;2018;53;27;26;167;81;86;46;20;26;;;;;TnAPh
139;École doctorale Connaissance, langage, modélisation;CLM;6;Sciences humaines et humanités;2019;2018-19;2018;2018;56;30;26;244;148;96;39;22;17;;;;;1lxGH
146;École doctorale Galilée;GALILEE;5;Biologie, médecine et santé;2019;2018-19;2018;2018;14;10;4;61;36;25;18;11;7;;;;;71hqm
146;École doctorale Galilée;GALILEE;9;Sciences et technologies de l'information et de la communication;2019;2018-19;2018;2018;18;2;16;55;14;41;16;6;10;;;;;71hqm
159;École doctorale Esthétique, sciences et technologies des arts;EDESTA;6;Sciences humaines et humanités;2019;2018-19;2018;2018;37;21;16;234;140;94;33;19;14;;;;;zj1Vj
162;École doctorale Mécanique, énergétique, génie civil, acoustique;MEGA;2;Physique;2019;2018-19;2018;2018;0;0;0;2;1;1;0;0;0;;;;;7wCke
166;École doctorale Information, structures et systèmes;I2S;3;Sciences de la terre et de l'univers, espace;2019;2018-19;2018;2018;1;0;1;4;1;3;1;1;0;;;;;2uO68
166;École doctorale Information, structures et systèmes;I2S;7;Sciences de la société;2019;2018-19;2018;2018;1;1;0;3;1;2;0;0;0;;;;;2uO68
173;École doctorale Sciences de l'univers, de l'environnement et de l'espace;SDU2E;3;Sciences de la terre et de l'univers, espace;2019;2018-19;2018;2018;59;19;40;273;96;177;73;31;42;;;;;R0Z9c
173;École doctorale Sciences de l'univers, de l'environnement et de l'espace;SDU2E;10;Sciences agronomiques et écologiques;2019;2018-19;2018;2018;9;5;4;33;16;17;14;7;7;;;;;R0Z9c
180;École doctorale Sciences humaines et sociales : cultures, individus, sociétés;SHS;6;Sciences humaines et humanités;2019;2018-19;2018;2018;18;12;6;91;67;24;17;13;4;;;;;D2BT3
184;École doctorale Mathématiques et informatique de Marseille;;9;Sciences et technologies de l'information et de la communication;2019;2018-19;2018;2018;5;1;4;34;11;23;3;2;1;;;;;DDObG
211;École doctorale Sciences exactes et leurs applications;ED SEA;1;Mathématiques et leurs interactions;2019;2018-19;2018;2018;8;1;7;26;9;17;5;4;1;;;;;1G1iC
211;École doctorale Sciences exactes et leurs applications;ED SEA;3;Sciences de la terre et de l'univers, espace;2019;2018-19;2018;2018;4;0;4;13;2;11;0;0;0;;;;;1G1iC
211;École doctorale Sciences exactes et leurs applications;ED SEA;8;Sciences pour l'ingénieur;2019;2018-19;2018;2018;18;5;13;63;16;47;8;3;5;;;;;1G1iC
211;École doctorale Sciences exactes et leurs applications;ED SEA;9;Sciences et technologies de l'information et de la communication;2019;2018-19;2018;2018;7;2;5;29;9;20;4;1;3;;;;;1G1iC
216;École doctorale Ingénierie pour la santé, la cognition, l'environnement;EDISCE;1;Mathématiques et leurs interactions;2019;2018-19;2018;2018;0;0;0;4;1;3;2;2;0;;;;;fPs1t
216;École doctorale Ingénierie pour la santé, la cognition, l'environnement;EDISCE;2;Physique;2019;2018-19;2018;2018;1;0;1;6;0;6;1;0;1;;;;;fPs1t
216;École doctorale Ingénierie pour la santé, la cognition, l'environnement;EDISCE;7;Sciences de la société;2019;2018-19;2018;2018;0;0;0;2;2;0;0;0;0;;;;;fPs1t
217;École doctorale Mathématiques, sciences et technologies de l'information, informatique;MSTII;9;Sciences et technologies de l'information et de la communication;2019;2018-19;2018;2018;61;20;41;262;65;197;73;15;58;;;;;Ehx7v
218;École doctorale Chimie et sciences du vivant;EDCSV;4;Chimie;2019;2018-19;2018;2018;39;16;23;114;50;64;30;13;17;;;;;8bcJh
218;École doctorale Chimie et sciences du vivant;EDCSV;5;Biologie, médecine et santé;2019;2018-19;2018;2018;48;31;17;195;115;80;39;28;11;;;;;8bcJh
220;École doctorale Électronique, électrotechnique, automatique, traitement du signal;EEATS;9;Sciences et technologies de l'information et de la communication;2019;2018-19;2018;2018;41;5;36;163;32;131;65;13;52;;;;;IxEaw
221;École doctorale Augustin Cournot - Sciences économiques et de gestion - Sciences, technologies et sociétés;EDAC;7;Sciences de la société;2019;2018-19;2018;2018;14;7;7;88;44;44;14;11;3;;;;;5z9rW
221;École doctorale Augustin Cournot - Sciences économiques et de gestion - Sciences, technologies et sociétés;EDAC;10;Sciences agronomiques et écologiques;2019;2018-19;2018;2018;0;0;0;0;0;0;1;0;1;;;;;5z9rW
222;École doctorale Sciences chimiques;EDSC;5;Biologie, médecine et santé;2019;2018-19;2018;2018;1;0;1;13;4;9;1;0;1;;;;;AdU8Q
222;École doctorale Sciences chimiques;EDSC;8;Sciences pour l'ingénieur;2019;2018-19;2018;2018;2;0;2;7;2;5;3;1;2;;;;;AdU8Q
227;École doctorale Sciences de la nature et de l'homme;;8;Sciences pour l'ingénieur;2019;2018-19;2018;2018;0;0;0;3;3;0;0;0;0;;;;;xiDA5
227;École doctorale Sciences de la nature et de l'homme;;9;Sciences et technologies de l'information et de la communication;2019;2018-19;2018;2018;0;0;0;1;1;0;1;0;1;;;;;xiDA5
227;École doctorale Sciences de la nature et de l'homme;;10;Sciences agronomiques et écologiques;2019;2018-19;2018;2018;22;11;11;141;90;51;37;24;13;;;;;xiDA5
245;École doctorale Sciences économiques, juridiques, politiques et de gestion;;7;Sciences de la société;2019;2018-19;2018;2018;37;16;21;193;79;114;19;6;13;;;;;ShLUg
250;École doctorale Sciences chimiques;;4;Chimie;2019;2018-19;2018;2018;43;19;24;104;42;62;26;10;16;;;;;O0Fav
251;École doctorale Sciences de l'environnement;;4;Chimie;2019;2018-19;2018;2018;4;2;2;20;12;8;5;2;3;;;;;VR28y
251;École doctorale Sciences de l'environnement;;6;Sciences humaines et humanités;2019;2018-19;2018;2018;6;4;2;12;8;4;1;1;0;;;;;VR28y
261;École doctorale Cognition, comportements, conduites humaines;3CH;6;Sciences humaines et humanités;2019;2018-19;2018;2018;41;29;12;139;101;38;34;27;7;;;;;KOLCy
268;École doctorale Langage et langues : description, théorisation, transmission;;7;Sciences de la société;2019;2018-19;2018;2018;0;0;0;3;1;2;1;1;0;;;;;wAIDE
270;École doctorale Théologie et sciences religieuses;;6;Sciences humaines et humanités;2019;2018-19;2018;2018;16;8;8;117;31;86;17;5;12;;;;;BRKC1
304;École doctorale Sciences et environnements;;6;Sciences humaines et humanités;2019;2018-19;2018;2018;3;2;1;11;8;3;0;0;0;;;;;2ywZn
304;École doctorale Sciences et environnements;;7;Sciences de la société;2019;2018-19;2018;2018;1;1;0;8;6;2;2;2;0;;;;;2ywZn
304;École doctorale Sciences et environnements;;10;Sciences agronomiques et écologiques;2019;2018-19;2018;2018;12;8;4;52;26;26;17;6;11;;;;;2ywZn
309;École doctorale Systèmes;EDSYS;8;Sciences pour l'ingénieur;2019;2018-19;2018;2018;20;6;14;84;32;52;17;8;9;;;;;8TT4b
328;École doctorale Arts, lettres, langues, philosophie et communication;ALLPH@;6;Sciences humaines et humanités;2019;2018-19;2018;2018;73;51;22;290;186;104;32;23;9;;;;;xLxMh
341;École doctorale Évolution, écosystèmes, microbiologie, modélisation;E2M2;5;Biologie, médecine et santé;2019;2018-19;2018;2018;22;13;9;100;51;49;25;11;14;;;;;J83I0
353;École doctorale Sciences pour l'ingénieur : mécanique, physique, micro et nanoélectronique;;4;Chimie;2019;2018-19;2018;2018;0;0;0;0;0;0;1;1;0;;;;;vk5Kp
355;École doctorale Espaces, cultures, sociétés;;7;Sciences de la société;2019;2018-19;2018;2018;16;8;8;66;41;25;18;11;7;;;;;2kMf5
364;École doctorale Sciences fondamentales et appliquées;EDSFA;8;Sciences pour l'ingénieur;2019;2018-19;2018;2018;23;5;18;69;17;52;13;6;7;;;;;E483q
364;École doctorale Sciences fondamentales et appliquées;EDSFA;10;Sciences agronomiques et écologiques;2019;2018-19;2018;2018;1;0;1;5;3;2;2;1;1;;;;;E483q
377;École doctorale Environnement et société;;4;Chimie;2019;2018-19;2018;2018;3;1;2;5;2;3;3;2;1;;;;;ZMG5u
377;École doctorale Environnement et société;;8;Sciences pour l'ingénieur;2019;2018-19;2018;2018;1;1;0;6;2;4;5;2;3;;;;;ZMG5u
377;École doctorale Environnement et société;;10;Sciences agronomiques et écologiques;2019;2018-19;2018;2018;2;1;1;11;6;5;5;4;1;;;;;ZMG5u
400;École doctorale Savoirs scientifiques : épistémologie, histoire des sciences, didactique des disciplines;;3;Sciences de la terre et de l'univers, espace;2019;2018-19;2018;2018;1;1;0;1;1;0;0;0;0;;;;;nRax3
402;École doctorale Sciences de la vie et de la santé;SVS;2;Physique;2019;2018-19;2018;2018;0;0;0;0;0;0;1;0;1;;;;;YKgsU
405;École doctorale Économie, management,mathématiques et physique de Cergy;EM2C;9;Sciences et technologies de l'information et de la communication;2019;2018-19;2018;2018;13;1;12;45;15;30;5;2;3;;;;;QbwSB
411;École doctorale Humanités nouvelles : Fernand Braudel;;7;Sciences de la société;2019;2018-19;2018;2018;1;0;1;2;0;2;3;2;1;;;;;l2rFh
412;École doctorale Lorraine de chimie et physique moléculaires : synthèses, expériences, simulations, applications : de la molécule aux édifices supramoléculaires;SESAMES;2;Physique;2019;2018-19;2018;2018;0;0;0;0;0;0;2;1;1;;;;;mvHX2
413;École doctorale Sciences de la terre et de l'environnement;STE;10;Sciences agronomiques et écologiques;2019;2018-19;2018;2018;0;0;0;0;0;0;1;1;0;;;;;u9BA9
414;École doctorale Sciences de la vie et de la santé;;4;Chimie;2019;2018-19;2018;2018;0;0;0;1;1;0;1;1;0;;;;;YI4xS
414;École doctorale Sciences de la vie et de la santé;;10;Sciences agronomiques et écologiques;2019;2018-19;2018;2018;0;0;0;0;0;0;3;1;2;;;;;YI4xS
432;École doctorale Sciences des métiers de l'ingénieur;SMI;5;Biologie, médecine et santé;2019;2018-19;2018;2018;0;0;0;0;0;0;2;2;0;;;;;nSsHB
450;École doctorale Recherches en psychanalyse et psychopathologie;PSY²;6;Sciences humaines et humanités;2019;2018-19;2018;2018;38;30;8;201;139;62;34;21;13;;;;;8jI3f
455;École doctorale Économie, Gestion, Information et Communication;EGIC;7;Sciences de la société;2019;2018-19;2018;2018;20;11;9;85;43;42;12;4;8;;;;;qCOg3
459;École doctorale Sciences chimiques Balard;;5;Biologie, médecine et santé;2019;2018-19;2018;2018;1;1;0;1;1;0;0;0;0;;;;;YFs2W
463;École doctorale Sciences du mouvement humain;SMH;7;Sciences de la société;2019;2018-19;2018;2018;0;0;0;2;0;2;1;0;1;;;;;UbtlY
465;École doctorale Économie Panthéon Sorbonne;EPS;1;Mathématiques et leurs interactions;2019;2018-19;2018;2018;4;0;4;22;6;16;6;3;3;;;;;MV68S
465;École doctorale Économie Panthéon Sorbonne;EPS;7;Sciences de la société;2019;2018-19;2018;2018;63;25;38;286;121;165;65;34;31;;;;;MV68S
467;École doctorale Aéronautique, astronautique;AA;1;Mathématiques et leurs interactions;2019;2018-19;2018;2018;7;0;7;19;3;16;4;0;4;;;;;U7l45
467;École doctorale Aéronautique, astronautique;AA;3;Sciences de la terre et de l'univers, espace;2019;2018-19;2018;2018;0;0;0;4;2;2;1;0;1;;;;;U7l45
467;École doctorale Aéronautique, astronautique;AA;4;Chimie;2019;2018-19;2018;2018;0;0;0;4;1;3;0;0;0;;;;;U7l45
467;École doctorale Aéronautique, astronautique;AA;7;Sciences de la société;2019;2018-19;2018;2018;2;1;1;4;2;2;2;0;2;;;;;U7l45
467;École doctorale Aéronautique, astronautique;AA;9;Sciences et technologies de l'information et de la communication;2019;2018-19;2018;2018;2;0;2;4;2;2;4;2;2;;;;;U7l45
469;École doctorale du Pacifique;EDP;1;Mathématiques et leurs interactions;2019;2018-19;2018;2018;1;0;1;2;0;2;0;0;0;;;;;t9Z2n
469;École doctorale du Pacifique;EDP;3;Sciences de la terre et de l'univers, espace;2019;2018-19;2018;2018;1;0;1;5;4;1;3;1;2;;;;;t9Z2n
469;École doctorale du Pacifique;EDP;5;Biologie, médecine et santé;2019;2018-19;2018;2018;1;0;1;12;6;6;2;1;1;;;;;t9Z2n
469;École doctorale du Pacifique;EDP;7;Sciences de la société;2019;2018-19;2018;2018;4;2;2;30;18;12;1;1;0;;;;;t9Z2n
472;École doctorale de l'EPHE;;8;Sciences pour l'ingénieur;2019;2018-19;2018;2018;1;1;0;2;1;1;0;0;0;;;;;27zK4
472;École doctorale de l'EPHE;;10;Sciences agronomiques et écologiques;2019;2018-19;2018;2018;0;0;0;8;2;6;3;2;1;;;;;27zK4
480;École doctorale Montaigne-humanités;;6;Sciences humaines et humanités;2019;2018-19;2018;2018;114;62;52;582;346;236;69;40;29;;;;;f3SeZ
482;École doctorale Sciences de la matière;SDM;8;Sciences pour l'ingénieur;2019;2018-19;2018;2018;12;5;7;51;15;36;12;4;8;;;;;kmeZ4
483;École doctorale Histoire, géographie, aménagement, urbanisme, archéologie, science politique, sociologie, anthropologie;SCSO;6;Sciences humaines et humanités;2019;2018-19;2018;2018;58;28;30;361;185;176;56;24;32;;;;;hc6u4
485;École doctorale Éducation, Psychologie, Information et Communication;EPIC;9;Sciences et technologies de l'information et de la communication;2019;2018-19;2018;2018;0;0;0;5;1;4;3;1;2;;;;;O82eL
488;École doctorale Sciences, ingénierie, santé;SIS;9;Sciences et technologies de l'information et de la communication;2019;2018-19;2018;2018;35;10;25;142;40;102;29;10;19;;;;;Fy2lK
489;École doctorale Sciences et ingénierie des systèmes, de l'environnement et des organisations;SISEO;6;Sciences humaines et humanités;2019;2018-19;2018;2018;7;1;6;24;15;9;2;1;1;;;;;6pT77
489;École doctorale Sciences et ingénierie des systèmes, de l'environnement et des organisations;SISEO;7;Sciences de la société;2019;2018-19;2018;2018;4;3;1;25;17;8;4;1;3;;;;;6pT77
489;École doctorale Sciences et ingénierie des systèmes, de l'environnement et des organisations;SISEO;10;Sciences agronomiques et écologiques;2019;2018-19;2018;2018;2;2;0;11;6;5;2;1;1;;;;;6pT77
493;École doctorale Erasme;;7;Sciences de la société;2019;2018-19;2018;2018;36;18;18;181;82;99;28;17;11;;;;;FPW4T
509;École doctorale Civilisations et sociétés euro-méditerranéennes et comparées;;7;Sciences de la société;2019;2018-19;2018;2018;18;8;10;124;43;81;13;4;9;;;;;9tbyG
510;École doctorale Ingénierie - Matériaux, mécanique, environnement, énergétique, procédés, production;IMEP2;8;Sciences pour l'ingénieur;2019;2018-19;2018;2018;105;43;62;404;147;257;89;30;59;;;;;Ce7NF
515;École doctorale Complexité du vivant;CdV;5;Biologie, médecine et santé;2019;2018-19;2018;2018;69;36;33;296;173;123;72;43;29;;;;;CbV9s
521;École doctorale Sciences et ingénierie pour l'information, mathématiques;S2I;2;Physique;2019;2018-19;2018;2018;0;0;0;0;0;0;4;0;4;;;;;V6i83
521;École doctorale Sciences et ingénierie pour l'information, mathématiques;S2I;8;Sciences pour l'ingénieur;2019;2018-19;2018;2018;0;0;0;0;0;0;12;7;5;;;;;V6i83
527;École doctorale Cognition, comportement, langage(s);CCL;6;Sciences humaines et humanités;2019;2018-19;2018;2018;0;0;0;0;0;0;14;13;1;;;;;MvpY8
530;École doctorale Organisations, marchés, institutions;OMI;1;Mathématiques et leurs interactions;2019;2018-19;2018;2018;0;0;0;1;1;0;0;0;0;;;;;4htv7
532;École doctorale Mathématiques et sciences et technologies de l'information et de la communication;MSTIC;3;Sciences de la terre et de l'univers, espace;2019;2018-19;2018;2018;2;2;0;8;3;5;3;1;2;;;;;t43KM
536;École doctorale Sciences et agrosciences;;1;Mathématiques et leurs interactions;2019;2018-19;2018;2018;3;2;1;4;3;1;1;0;1;;;;;pHfqe
537;École doctorale Culture et patrimoine;C&P;7;Sciences de la société;2019;2018-19;2018;2018;3;2;1;71;38;33;3;3;0;;;;;GxI4a
540;"École doctorale École transdisciplinaire ""lettres/sciences""";;5;Biologie, médecine et santé;2019;2018-19;2018;2018;0;0;0;3;0;3;0;0;0;;;;;tWWw7
541;École doctorale de sciences humaines et sociales de La Réunion;SHS;6;Sciences humaines et humanités;2019;2018-19;2018;2018;17;15;2;50;30;20;9;5;4;;;;;21SpE
542;École doctorale de sciences de La Réunion;STS;2;Physique;2019;2018-19;2018;2018;6;4;2;36;7;29;10;3;7;;;;;2pAql
543;École doctorale de Dauphine;;1;Mathématiques et leurs interactions;2019;2018-19;2018;2018;12;2;10;39;4;35;20;1;19;;;;;u8w6A
543;École doctorale de Dauphine;;7;Sciences de la société;2019;2018-19;2018;2018;56;20;36;220;101;119;51;24;27;;;;;u8w6A
543;École doctorale de Dauphine;;8;Sciences pour l'ingénieur;2019;2018-19;2018;2018;12;3;9;46;12;34;0;0;0;;;;;u8w6A
543;École doctorale de Dauphine;;9;Sciences et technologies de l'information et de la communication;2019;2018-19;2018;2018;0;0;0;0;0;0;7;2;5;;;;;u8w6A
545;École doctorale Sociétés, politique et santé publique;SP2;6;Sciences humaines et humanités;2019;2018-19;2018;2018;42;20;22;140;73;67;21;13;8;;;;;IAKR4
545;École doctorale Sociétés, politique et santé publique;SP2;7;Sciences de la société;2019;2018-19;2018;2018;20;10;10;92;46;46;12;9;3;;;;;IAKR4
546;École doctorale Abbé Grégoire;;5;Biologie, médecine et santé;2019;2018-19;2018;2018;1;1;0;1;1;0;0;0;0;;;;;ZSn7q
546;École doctorale Abbé Grégoire;;7;Sciences de la société;2019;2018-19;2018;2018;18;13;5;100;58;42;17;7;10;;;;;ZSn7q
548;École doctorale Mer et Sciences;;1;Mathématiques et leurs interactions;2019;2018-19;2018;2018;3;1;2;16;4;12;4;1;3;;;;;QX0fS
548;École doctorale Mer et Sciences;;6;Sciences humaines et humanités;2019;2018-19;2018;2018;2;0;2;5;1;4;0;0;0;;;;;QX0fS
548;École doctorale Mer et Sciences;;9;Sciences et technologies de l'information et de la communication;2019;2018-19;2018;2018;7;3;4;25;12;13;4;2;2;;;;;QX0fS
549;École doctorale Santé, Sciences Biologiques et Chimie du Vivant;SSBCV;5;Biologie, médecine et santé;2019;2018-19;2018;2018;44;30;14;195;128;67;46;27;19;;;;;B9ggO
549;École doctorale Santé, Sciences Biologiques et Chimie du Vivant;SSBCV;8;Sciences pour l'ingénieur;2019;2018-19;2018;2018;0;0;0;2;1;1;0;0;0;;;;;B9ggO
549;École doctorale Santé, Sciences Biologiques et Chimie du Vivant;SSBCV;9;Sciences et technologies de l'information et de la communication;2019;2018-19;2018;2018;0;0;0;0;0;0;1;1;0;;;;;B9ggO
551;École doctorale Mathématiques, Informatique, Physique Théorique et Ingénierie des Systèmes;MIPTIS;9;Sciences et technologies de l'information et de la communication;2019;2018-19;2018;2018;14;6;8;44;12;32;14;2;12;;;;;Mpudz
553;École doctorale Carnot - Pasteur;;2;Physique;2019;2018-19;2018;2018;10;3;7;52;11;41;9;1;8;;;;;6h4Z7
554;École doctorale Environnements - Santé;E-S;2;Physique;2019;2018-19;2018;2018;2;1;1;3;1;2;0;0;0;;;;;ElyFU
554;École doctorale Environnements - Santé;E-S;6;Sciences humaines et humanités;2019;2018-19;2018;2018;6;2;4;16;5;11;5;2;3;;;;;ElyFU
556;École doctorale Homme, Sociétés, Risques, Territoire;HSRT;6;Sciences humaines et humanités;2019;2018-19;2018;2018;39;18;21;233;106;127;38;15;23;;;;;5QEaX
558;École doctorale Histoire, Mémoire, Patrimoine, Langage;HMPL;7;Sciences de la société;2019;2018-19;2018;2018;0;0;0;1;1;0;0;0;0;;;;;uX3jT
561;École doctorale Hématologie, Oncogenèse et Biothérapies;HOB;5;Biologie, médecine et santé;2019;2018-19;2018;2018;48;35;13;192;118;74;45;29;16;;;;;7Klb2
563;École doctorale Médicament - Toxicologie - Chimie - Imageries;MTCI;5;Biologie, médecine et santé;2019;2018-19;2018;2018;53;23;30;162;82;80;43;25;18;;;;;j8uk1
570;École doctorale Santé Publique;EDSP;5;Biologie, médecine et santé;2019;2018-19;2018;2018;48;29;19;148;90;58;34;24;10;;;;;9lgE4
572;École doctorale Ondes et matière;EDOM;2;Physique;2019;2018-19;2018;2018;54;13;41;242;65;177;56;16;40;;;;;etSIi
573;École doctorale Interfaces : Approches Interdisciplinaires, Fondements, Applications et Innovation;ED INTERFACES;5;Biologie, médecine et santé;2019;2018-19;2018;2018;8;5;3;22;12;10;2;1;1;;;;;gG820
575;École doctorale Electrical, Optical, Bio : Physics and Engineering;EOBE;4;Chimie;2019;2018-19;2018;2018;0;0;0;1;0;1;0;0;0;;;;;dfhyn
576;École doctorale Particules, Hadrons, Énergie, Noyau, Instrumentation, Imagerie, Cosmos et Simulation;PHENIICS;2;Physique;2019;2018-19;2018;2018;47;11;36;220;65;155;65;18;47;;;;;qC4rf
576;École doctorale Particules, Hadrons, Énergie, Noyau, Instrumentation, Imagerie, Cosmos et Simulation;PHENIICS;5;Biologie, médecine et santé;2019;2018-19;2018;2018;0;0;0;2;1;1;0;0;0;;;;;qC4rf
577;École doctorale Structure et dynamique des systèmes vivants;SDSV;2;Physique;2019;2018-19;2018;2018;0;0;0;0;0;0;1;0;1;;;;;4bsxJ
577;École doctorale Structure et dynamique des systèmes vivants;SDSV;5;Biologie, médecine et santé;2019;2018-19;2018;2018;57;33;24;219;129;90;51;34;17;;;;;4bsxJ
579;École doctorale Sciences mécaniques et energétiques, matériaux et géosciences;SMEMaG;1;Mathématiques et leurs interactions;2019;2018-19;2018;2018;0;0;0;4;1;3;1;0;1;;;;;atMj7
579;École doctorale Sciences mécaniques et energétiques, matériaux et géosciences;SMEMaG;3;Sciences de la terre et de l'univers, espace;2019;2018-19;2018;2018;19;10;9;66;28;38;16;7;9;;;;;atMj7
580;École doctorale Sciences et technologies de l'information et de la communication;STIC;8;Sciences pour l'ingénieur;2019;2018-19;2018;2018;8;1;7;21;6;15;2;1;1;;;;;AzCC0
581;École doctorale Agriculture, alimentation, biologie, environnement, santé;ABIES;5;Biologie, médecine et santé;2019;2018-19;2018;2018;19;14;5;79;51;28;32;14;18;;;;;c1x56
583;École doctorale Risques et Société;;3;Sciences de la terre et de l'univers, espace;2019;2018-19;2018;2018;0;0;0;2;0;2;0;0;0;;;;;wUBi9
584;École doctorale Biodiversité, Agriculture, Alimentation, Environnement, Terre, Eau;GAIA;10;Sciences agronomiques et écologiques;2019;2018-19;2018;2018;124;60;64;385;187;198;99;47;52;;;;;F1h5f
585;École doctorale Sciences, Technologie,  Sante;EDSTS;1;Mathématiques et leurs interactions;2019;2018-19;2018;2018;2;1;1;20;7;13;3;1;2;;;;;NM3Dl
585;École doctorale Sciences, Technologie,  Sante;EDSTS;2;Physique;2019;2018-19;2018;2018;2;1;1;11;5;6;6;3;3;;;;;NM3Dl
585;École doctorale Sciences, Technologie,  Sante;EDSTS;10;Sciences agronomiques et écologiques;2019;2018-19;2018;2018;8;5;3;28;17;11;5;5;0;;;;;NM3Dl
590;École doctorale Mathematiques, Information, Ingenierie des Systemes;MIIS;8;Sciences pour l'ingénieur;2019;2018-19;2018;2018;6;1;5;30;12;18;6;3;3;;;;;L20t5
590;École doctorale Mathematiques, Information, Ingenierie des Systemes;MIIS;9;Sciences et technologies de l'information et de la communication;2019;2018-19;2018;2018;26;9;17;92;21;71;31;5;26;;;;;L20t5
598;École doctorale Sciences de La Mer et du Littoral;SML;3;Sciences de la terre et de l'univers, espace;2019;2018-19;2018;2018;15;6;9;71;31;40;15;6;9;;;;;Smen6
598;École doctorale Sciences de La Mer et du Littoral;SML;7;Sciences de la société;2019;2018-19;2018;2018;2;1;1;16;9;7;3;0;3;;;;;Smen6
600;École doctorale Écologie, Géosciences, Agronomie et Alimentation;EGAAL;9;Sciences et technologies de l'information et de la communication;2019;2018-19;2018;2018;2;0;2;2;0;2;0;0;0;;;;;urS33
600;École doctorale Écologie, Géosciences, Agronomie et Alimentation;EGAAL;10;Sciences agronomiques et écologiques;2019;2018-19;2018;2018;52;25;27;193;108;85;45;20;25;;;;;urS33
605;École doctorale Biologie Santé;ED BS;6;Sciences humaines et humanités;2019;2018-19;2018;2018;0;0;0;4;1;3;1;1;0;;;;;w8CxU
606;École doctorale Chimie - Mécanique - Matériaux - Physique;C2MP;8;Sciences pour l'ingénieur;2019;2018-19;2018;2018;15;5;10;100;26;74;17;7;10;;;;;UkNR2
608;École doctorale Sciences et Ingénierie des Molécules, des Produits, des Procédés et de l'Énergie;SIMPPÉ;8;Sciences pour l'ingénieur;2019;2018-19;2018;2018;41;10;31;142;41;101;34;16;18;;;;;TyNjM
609;École doctorale Sciences et Ingénierie des Matériaux, Mécanique, Énergétique -;SIMME;2;Physique;2019;2018-19;2018;2018;3;1;2;26;5;21;0;0;0;;;;;N4Rjy
610;École doctorale Sciences et Ingénierie des Systèmes, Mathématiques, Informatique;SISMI;2;Physique;2019;2018-19;2018;2018;2;1;1;14;3;11;0;0;0;;;;;dBCUB
610;École doctorale Sciences et Ingénierie des Systèmes, Mathématiques, Informatique;SISMI;8;Sciences pour l'ingénieur;2019;2018-19;2018;2018;5;0;5;33;6;27;0;0;0;;;;;dBCUB
611;École doctorale Sciences du Langage, Psychologie, Cognition, Education;SLPCE;6;Sciences humaines et humanités;2019;2018-19;2018;2018;19;10;9;80;44;36;0;0;0;;;;;z8agK
613;École doctorale Sciences de la Société, Territoires, Sciences Economiques et de Gestion;SSTSEG;7;Sciences de la société;2019;2018-19;2018;2018;15;6;9;110;51;59;0;0;0;;;;;6eLRF
614;École doctorale Chimie, Écologie, Géosciences, Agrosciences - Théodore Monod;CEGA;3;Sciences de la terre et de l'univers, espace;2019;2018-19;2018;2018;5;1;4;20;9;11;0;0;0;;;;;uc10I
619;École doctorale Sciences Fondamentales et Santé;SFS;4;Chimie;2019;2018-19;2018;2018;6;2;4;16;6;10;2;1;1;;;;;JiZVW
620;École doctorale Sciences du Numérique et de l'Ingénieur;SNI;8;Sciences pour l'ingénieur;2019;2018-19;2018;2018;14;3;11;51;12;39;14;3;11;;;;;Dr40w
620;École doctorale Sciences du Numérique et de l'Ingénieur;SNI;9;Sciences et technologies de l'information et de la communication;2019;2018-19;2018;2018;8;1;7;49;6;43;13;2;11;;;;;Dr40w
621;École doctorale Ingénierie des Systèmes, Matériaux, Mécanique, Énergétique;ISMME;1;Mathématiques et leurs interactions;2019;2018-19;2018;2018;6;1;5;20;5;15;0;0;0;;;;;B2549
621;École doctorale Ingénierie des Systèmes, Matériaux, Mécanique, Énergétique;ISMME;3;Sciences de la terre et de l'univers, espace;2019;2018-19;2018;2018;0;0;0;1;1;0;0;0;0;;;;;B2549
9;École doctorale Droit international, droit européen, relations internationales et droit comparé;;7;Sciences de la société;2021;2020-21;2020;2020;37;20;17;259;153;106;10;7;3;0;4;1;5;v1emR
39;École doctorale Mathématiques et Informatique;EDMIB;1;Mathématiques et leurs interactions;2021;2020-21;2020;2020;28;9;19;105;32;73;21;3;18;14;6;1;0;TBj2X
50;École doctorale Langues, littératures et sciences humaines;LLSH;6;Sciences humaines et humanités;2021;2020-21;2020;2020;33;24;9;175;130;45;26;21;5;0;8;5;13;8THzQ
52;École doctorale Physique et astrophysique de Lyon;PHAST;2;Physique;2021;2020-21;2020;2020;40;5;35;187;50;137;26;8;18;22;4;0;0;61XPb
52;École doctorale Physique et astrophysique de Lyon;PHAST;3;Sciences de la terre et de l'univers, espace;2021;2020-21;2020;2020;3;2;1;23;8;15;3;3;0;2;1;0;0;61XPb
60;École doctorale Territoires, temps, sociétés et développement;TTSD;10;Sciences agronomiques et écologiques;2021;2020-21;2020;2020;1;1;0;2;2;0;0;0;0;0;0;0;0;fkIh6
62;École doctorale Sciences de la vie et de la santé;;2;Physique;2021;2020-21;2020;2020;0;0;0;1;1;0;1;0;1;1;0;0;0;vZzE7
62;École doctorale Sciences de la vie et de la santé;;9;Sciences et technologies de l'information et de la communication;2021;2020-21;2020;2020;0;0;0;3;0;3;0;0;0;0;0;0;0;vZzE7
70;École doctorale Sciences pour l'ingénieur;EDSPI;8;Sciences pour l'ingénieur;2021;2020-21;2020;2020;53;22;31;133;40;93;22;5;17;9;12;1;0;G413P
71;École doctorale Sciences pour l'ingénieur;;1;Mathématiques et leurs interactions;2021;2020-21;2020;2020;2;1;1;10;5;5;5;3;2;3;2;0;0;H6UYp
71;École doctorale Sciences pour l'ingénieur;;4;Chimie;2021;2020-21;2020;2020;1;0;1;5;1;4;2;1;1;1;1;0;0;H6UYp
73;École doctorale Sciences économiques, sociales, de l'aménagement et du management;SESAM;6;Sciences humaines et humanités;2021;2020-21;2020;2020;15;8;7;59;31;28;7;2;5;0;4;1;2;IQ0Hk
73;École doctorale Sciences économiques, sociales, de l'aménagement et du management;SESAM;10;Sciences agronomiques et écologiques;2021;2020-21;2020;2020;0;0;0;1;0;1;0;0;0;0;0;0;0;IQ0Hk
86;École doctorale Sociétés, humanités, arts, lettres;LSHS;7;Sciences de la société;2021;2020-21;2020;2020;2;1;1;25;13;12;2;0;2;1;0;1;0;O8E6y
104;École doctorale Sciences de la matière, du rayonnement et de l'environnement;SMRE;8;Sciences pour l'ingénieur;2021;2020-21;2020;2020;0;0;0;9;1;8;4;1;3;2;2;0;0;Q5iFz
120;École doctorale Littérature française et comparée;;6;Sciences humaines et humanités;2021;2020-21;2020;2020;37;22;15;242;173;69;28;18;10;2;5;9;12;3ULpe
129;École doctorale Sciences de l'environnement d'Ile de France;SEIF;2;Physique;2021;2020-21;2020;2020;1;1;0;6;4;2;2;0;2;2;0;0;0;TnAPh
138;École doctorale Lettres, langues, spectacles;LLS;6;Sciences humaines et humanités;2021;2020-21;2020;2020;40;20;20;227;146;81;40;22;18;2;9;14;15;y9O3k
139;École doctorale Connaissance, langage, modélisation;CLM;1;Mathématiques et leurs interactions;2021;2020-21;2020;2020;1;1;0;4;2;2;0;0;0;0;0;0;0;1lxGH
139;École doctorale Connaissance, langage, modélisation;CLM;6;Sciences humaines et humanités;2021;2020-21;2020;2020;59;33;26;259;155;104;33;28;5;4;6;9;14;1lxGH
146;École doctorale Galilée;GALILEE;2;Physique;2021;2020-21;2020;2020;6;3;3;24;9;15;3;1;2;2;1;0;0;71hqm
146;École doctorale Galilée;GALILEE;5;Biologie, médecine et santé;2021;2020-21;2020;2020;17;12;5;59;43;16;9;5;4;5;4;0;0;71hqm
154;École doctorale Sciences de la vie et de la santé;SVS;5;Biologie, médecine et santé;2021;2020-21;2020;2020;95;49;46;391;225;166;51;33;18;30;20;1;0;hLn36
160;École doctorale Électronique, électrotechnique, automatique;EEA;5;Biologie, médecine et santé;2021;2020-21;2020;2020;1;1;0;12;10;2;4;3;1;3;1;0;0;EgfMQ
160;École doctorale Électronique, électrotechnique, automatique;EEA;8;Sciences pour l'ingénieur;2021;2020-21;2020;2020;13;5;8;87;18;69;22;6;16;14;8;0;0;EgfMQ
160;École doctorale Électronique, électrotechnique, automatique;EEA;9;Sciences et technologies de l'information et de la communication;2021;2020-21;2020;2020;25;6;19;92;24;68;19;3;16;9;8;2;0;EgfMQ
166;École doctorale Information, structures et systèmes;I2S;2;Physique;2021;2020-21;2020;2020;21;7;14;62;20;42;19;5;14;13;6;0;0;2uO68
166;École doctorale Information, structures et systèmes;I2S;5;Biologie, médecine et santé;2021;2020-21;2020;2020;4;2;2;11;4;7;3;0;3;1;0;2;0;2uO68
171;École doctorale Toulouse sciences économiques;TSE;7;Sciences de la société;2021;2020-21;2020;2020;18;2;16;93;28;65;18;5;13;0;1;15;2;Q5nNQ
182;École doctorale Physique et chimie-physique;;3;Sciences de la terre et de l'univers, espace;2021;2020-21;2020;2020;2;2;0;4;2;2;1;0;1;1;0;0;0;3My6I
184;École doctorale Mathématiques et informatique de Marseille;;8;Sciences pour l'ingénieur;2021;2020-21;2020;2020;5;1;4;10;2;8;0;0;0;0;0;0;0;DDObG
184;École doctorale Mathématiques et informatique de Marseille;;9;Sciences et technologies de l'information et de la communication;2021;2020-21;2020;2020;7;4;3;29;7;22;6;3;3;2;3;1;0;DDObG
205;École doctorale Interdisciplinaire Sciences-Santé;EDISS;5;Biologie, médecine et santé;2021;2020-21;2020;2020;59;43;16;247;150;97;77;41;36;35;35;6;1;69W38
205;École doctorale Interdisciplinaire Sciences-Santé;EDISS;6;Sciences humaines et humanités;2021;2020-21;2020;2020;1;0;1;12;4;8;2;0;2;2;0;0;0;69W38
209;École doctorale Sciences physiques et de L'ingénieur;SPI;2;Physique;2021;2020-21;2020;2020;29;6;23;114;24;90;25;2;23;12;11;2;0;tZcIZ
209;École doctorale Sciences physiques et de L'ingénieur;SPI;8;Sciences pour l'ingénieur;2021;2020-21;2020;2020;19;6;13;78;28;50;20;5;15;10;7;3;0;tZcIZ
216;École doctorale Ingénierie pour la santé, la cognition, l'environnement;EDISCE;2;Physique;2021;2020-21;2020;2020;1;0;1;3;0;3;1;0;1;0;1;0;0;fPs1t
216;École doctorale Ingénierie pour la santé, la cognition, l'environnement;EDISCE;6;Sciences humaines et humanités;2021;2020-21;2020;2020;11;9;2;48;32;16;10;8;2;3;5;2;0;fPs1t
216;École doctorale Ingénierie pour la santé, la cognition, l'environnement;EDISCE;7;Sciences de la société;2021;2020-21;2020;2020;0;0;0;2;2;0;0;0;0;0;0;0;0;fPs1t
216;École doctorale Ingénierie pour la santé, la cognition, l'environnement;EDISCE;10;Sciences agronomiques et écologiques;2021;2020-21;2020;2020;0;0;0;2;1;1;0;0;0;0;0;0;0;fPs1t
217;École doctorale Mathématiques, sciences et technologies de l'information, informatique;MSTII;8;Sciences pour l'ingénieur;2021;2020-21;2020;2020;4;1;3;16;7;9;3;0;3;1;2;0;0;Ehx7v
220;École doctorale Électronique, électrotechnique, automatique, traitement du signal;EEATS;9;Sciences et technologies de l'information et de la communication;2021;2020-21;2020;2020;36;6;30;146;32;114;44;5;39;24;17;3;0;IxEaw
221;École doctorale Augustin Cournot - Sciences économiques et de gestion - Sciences, technologies et sociétés;EDAC;5;Biologie, médecine et santé;2021;2020-21;2020;2020;0;0;0;1;0;1;0;0;0;0;0;0;0;5z9rW
221;École doctorale Augustin Cournot - Sciences économiques et de gestion - Sciences, technologies et sociétés;EDAC;6;Sciences humaines et humanités;2021;2020-21;2020;2020;1;0;1;10;4;6;1;0;1;0;0;1;0;5z9rW
227;École doctorale Sciences de la nature et de l'homme;;1;Mathématiques et leurs interactions;2021;2020-21;2020;2020;0;0;0;0;0;0;1;0;1;1;0;0;0;xiDA5
227;École doctorale Sciences de la nature et de l'homme;;7;Sciences de la société;2021;2020-21;2020;2020;1;1;0;8;5;3;0;0;0;0;0;0;0;xiDA5
234;École doctorale de Sciences Po;;6;Sciences humaines et humanités;2021;2020-21;2020;2020;64;31;33;290;152;138;46;20;26;1;7;24;14;ux756
251;École doctorale Sciences de l'environnement;;7;Sciences de la société;2021;2020-21;2020;2020;2;1;1;10;7;3;3;2;1;0;2;1;0;VR28y
251;École doctorale Sciences de l'environnement;;10;Sciences agronomiques et écologiques;2021;2020-21;2020;2020;18;11;7;48;28;20;11;6;5;4;7;0;0;VR28y
261;École doctorale Cognition, comportements, conduites humaines;3CH;6;Sciences humaines et humanités;2021;2020-21;2020;2020;42;28;14;148;102;46;25;17;8;11;10;4;0;KOLCy
262;École doctorale Sciences juridiques, politiques, économiques et de gestion;DEG;7;Sciences de la société;2021;2020-21;2020;2020;36;15;21;166;78;88;17;5;12;1;2;7;7;H7GyL
266;École doctorale Biologie, santé, environnement;BIOSE;5;Biologie, médecine et santé;2021;2020-21;2020;2020;41;19;22;144;78;66;25;13;12;13;7;5;0;386V9
267;École doctorale Arts et médias;;7;Sciences de la société;2021;2020-21;2020;2020;0;0;0;12;8;4;3;1;2;0;1;1;1;eCF5C
269;École doctorale Mathématiques, sciences de l'information et de l'ingénieur;MSII;2;Physique;2021;2020-21;2020;2020;1;0;1;7;2;5;0;0;0;0;0;0;0;5E625
269;École doctorale Mathématiques, sciences de l'information et de l'ingénieur;MSII;9;Sciences et technologies de l'information et de la communication;2021;2020-21;2020;2020;51;16;35;179;54;125;34;6;28;16;17;1;0;5E625
304;École doctorale Sciences et environnements;;3;Sciences de la terre et de l'univers, espace;2021;2020-21;2020;2020;3;1;2;20;9;11;4;2;2;3;1;0;0;2ywZn
304;École doctorale Sciences et environnements;;6;Sciences humaines et humanités;2021;2020-21;2020;2020;1;0;1;12;7;5;2;1;1;0;2;0;0;2ywZn
305;École doctorale Énergie et environnement;E2;1;Mathématiques et leurs interactions;2021;2020-21;2020;2020;0;0;0;5;2;3;4;1;3;3;1;0;0;Kbt8I
305;École doctorale Énergie et environnement;E2;3;Sciences de la terre et de l'univers, espace;2021;2020-21;2020;2020;2;1;1;12;5;7;1;1;0;1;0;0;0;Kbt8I
305;École doctorale Énergie et environnement;E2;4;Chimie;2021;2020-21;2020;2020;2;1;1;12;7;5;3;1;2;2;1;0;0;Kbt8I
323;École doctorale Génie électrique, électronique et télécommunications;GEET;2;Physique;2021;2020-21;2020;2020;7;2;5;9;3;6;0;0;0;0;0;0;0;arcz6
326;École doctorale Comportement, langage, éducation, socialisation, cognition;CLESCO;5;Biologie, médecine et santé;2021;2020-21;2020;2020;8;6;2;24;12;12;0;0;0;0;0;0;0;nWIlG
327;École doctorale Temps, espaces, sociétés, cultures;TESC;3;Sciences de la terre et de l'univers, espace;2021;2020-21;2020;2020;0;0;0;4;3;1;0;0;0;0;0;0;0;IjgiJ
327;École doctorale Temps, espaces, sociétés, cultures;TESC;6;Sciences humaines et humanités;2021;2020-21;2020;2020;57;37;20;257;150;107;23;13;10;2;6;9;6;IjgiJ
327;École doctorale Temps, espaces, sociétés, cultures;TESC;10;Sciences agronomiques et écologiques;2021;2020-21;2020;2020;0;0;0;6;5;1;1;0;1;0;0;0;1;IjgiJ
353;École doctorale Sciences pour l'ingénieur : mécanique, physique, micro et nanoélectronique;;2;Physique;2021;2020-21;2020;2020;0;0;0;0;0;0;5;2;3;2;3;0;0;vk5Kp
353;École doctorale Sciences pour l'ingénieur : mécanique, physique, micro et nanoélectronique;;8;Sciences pour l'ingénieur;2021;2020-21;2020;2020;50;8;42;184;41;143;38;9;29;23;15;0;0;vk5Kp
361;École doctorale Sciences et Technologies;ED ST;6;Sciences humaines et humanités;2021;2020-21;2020;2020;3;2;1;21;10;11;2;0;2;1;1;0;0;cOUmL
364;École doctorale Sciences fondamentales et appliquées;EDSFA;3;Sciences de la terre et de l'univers, espace;2021;2020-21;2020;2020;14;3;11;64;18;46;19;4;15;13;6;0;0;E483q
364;École doctorale Sciences fondamentales et appliquées;EDSFA;4;Chimie;2021;2020-21;2020;2020;29;8;21;67;26;41;11;7;4;5;6;0;0;E483q
364;École doctorale Sciences fondamentales et appliquées;EDSFA;8;Sciences pour l'ingénieur;2021;2020-21;2020;2020;17;3;14;64;15;49;11;0;11;6;5;0;0;E483q
372;École doctorale Sciences économiques et de gestion;;7;Sciences de la société;2021;2020-21;2020;2020;42;23;19;164;90;74;38;21;17;6;19;13;0;JK63A
377;École doctorale Environnement et société;;6;Sciences humaines et humanités;2021;2020-21;2020;2020;9;5;4;56;30;26;6;3;3;0;2;1;3;ZMG5u
398;École doctorale Géosciences, ressources naturelles et environnement;GRNE;3;Sciences de la terre et de l'univers, espace;2021;2020-21;2020;2020;27;8;19;112;38;74;28;18;10;17;11;0;0;Zi4Zf
405;École doctorale Économie, management,mathématiques et physique de Cergy;EM2C;7;Sciences de la société;2021;2020-21;2020;2020;25;11;14;81;36;45;14;5;9;8;3;2;1;QbwSB
411;École doctorale Humanités nouvelles : Fernand Braudel;;6;Sciences humaines et humanités;2021;2020-21;2020;2020;38;18;20;292;141;151;30;15;15;3;7;11;9;l2rFh
417;École doctorale Sciences et Ingénierie;S&I;8;Sciences pour l'ingénieur;2021;2020-21;2020;2020;18;7;11;52;19;33;17;8;9;4;12;1;0;SSBvE
441;École doctorale Histoire de l'art;;6;Sciences humaines et humanités;2021;2020-21;2020;2020;27;16;11;175;131;44;24;21;3;2;1;11;10;d5W3U
446;École doctorale Biologie - Santé;EDBSL;6;Sciences humaines et humanités;2021;2020-21;2020;2020;1;1;0;8;3;5;0;0;0;0;0;0;0;4iEUF
446;École doctorale Biologie - Santé;EDBSL;8;Sciences pour l'ingénieur;2021;2020-21;2020;2020;0;0;0;1;1;0;0;0;0;0;0;0;0;4iEUF
459;École doctorale Sciences chimiques Balard;;4;Chimie;2021;2020-21;2020;2020;68;31;37;243;127;116;61;33;28;45;14;2;0;YFs2W
460;École doctorale Sciences juridiques;SJ;7;Sciences de la société;2021;2020-21;2020;2020;4;3;1;118;71;47;11;6;5;0;1;4;6;ZB5I5
467;École doctorale Aéronautique, astronautique;AA;3;Sciences de la terre et de l'univers, espace;2021;2020-21;2020;2020;0;0;0;2;1;1;3;0;3;3;0;0;0;U7l45
468;École doctorale Mécanique, énergétique, génie civil, procédés;MEGEP;8;Sciences pour l'ingénieur;2021;2020-21;2020;2020;114;28;86;447;130;317;101;22;79;55;43;3;0;4XUTB
469;École doctorale du Pacifique;EDP;1;Mathématiques et leurs interactions;2021;2020-21;2020;2020;1;1;0;2;1;1;0;0;0;0;0;0;0;t9Z2n
469;École doctorale du Pacifique;EDP;6;Sciences humaines et humanités;2021;2020-21;2020;2020;6;5;1;26;17;9;2;2;0;1;0;1;0;t9Z2n
474;École doctorale Interdisciplinaire européenne frontières du vivant;FDV;2;Physique;2021;2020-21;2020;2020;0;0;0;1;1;0;2;1;1;1;1;0;0;E727j
478;École doctorale Sciences de Gestion;;7;Sciences de la société;2021;2020-21;2020;2020;14;8;6;59;33;26;10;7;3;2;3;5;0;q34kB
480;École doctorale Montaigne-humanités;;3;Sciences de la terre et de l'univers, espace;2021;2020-21;2020;2020;4;1;3;20;9;11;1;0;1;1;0;0;0;f3SeZ
480;École doctorale Montaigne-humanités;;6;Sciences humaines et humanités;2021;2020-21;2020;2020;97;53;44;557;327;230;25;6;19;1;12;4;8;f3SeZ
483;École doctorale Histoire, géographie, aménagement, urbanisme, archéologie, science politique, sociologie, anthropologie;SCSO;7;Sciences de la société;2021;2020-21;2020;2020;29;16;13;232;136;96;21;8;13;1;2;5;13;hc6u4
489;École doctorale Sciences et ingénierie des systèmes, de l'environnement et des organisations;SISEO;5;Biologie, médecine et santé;2021;2020-21;2020;2020;2;2;0;7;3;4;3;0;3;2;1;0;0;6pT77
492;École doctorale Droit;;7;Sciences de la société;2021;2020-21;2020;2020;45;27;18;277;141;136;24;11;13;3;2;8;11;kOQsX
493;École doctorale Erasme;;6;Sciences humaines et humanités;2021;2020-21;2020;2020;10;8;2;76;57;19;7;7;0;2;2;1;2;FPW4T
497;École doctorale Normande de Biologie Intégrative, Santé, Environnement;Ed NBISE;2;Physique;2021;2020-21;2020;2020;1;1;0;1;1;0;0;0;0;0;0;0;0;0D9Je
497;École doctorale Normande de Biologie Intégrative, Santé, Environnement;Ed NBISE;4;Chimie;2021;2020-21;2020;2020;1;1;0;1;1;0;0;0;0;0;0;0;0;0D9Je
519;École doctorale Sciences humaines et sociales - Perspectives européennes;SHS-PE;7;Sciences de la société;2021;2020-21;2020;2020;22;15;7;86;48;38;9;8;1;1;2;2;4;2f5qs
520;École doctorale Humanités;;6;Sciences humaines et humanités;2021;2020-21;2020;2020;53;34;19;256;159;97;34;20;14;8;4;11;11;rI175
528;École doctorale Ville, transports et territoires;VTT;3;Sciences de la terre et de l'univers, espace;2021;2020-21;2020;2020;0;0;0;1;1;0;0;0;0;0;0;0;0;68zCc
532;École doctorale Mathématiques et sciences et technologies de l'information et de la communication;MSTIC;3;Sciences de la terre et de l'univers, espace;2021;2020-21;2020;2020;1;0;1;4;2;2;3;1;2;2;1;0;0;t43KM
536;École doctorale Sciences et agrosciences;;8;Sciences pour l'ingénieur;2021;2020-21;2020;2020;0;0;0;6;4;2;2;1;1;0;1;1;0;pHfqe
536;École doctorale Sciences et agrosciences;;9;Sciences et technologies de l'information et de la communication;2021;2020-21;2020;2020;9;2;7;29;8;21;5;2;3;3;1;1;0;pHfqe
537;École doctorale Culture et patrimoine;C&P;7;Sciences de la société;2021;2020-21;2020;2020;4;3;1;16;11;5;1;1;0;0;0;0;1;GxI4a
540;"École doctorale École transdisciplinaire ""lettres/sciences""";;1;Mathématiques et leurs interactions;2021;2020-21;2020;2020;0;0;0;1;0;1;0;0;0;0;0;0;0;tWWw7
540;"École doctorale École transdisciplinaire ""lettres/sciences""";;4;Chimie;2021;2020-21;2020;2020;1;0;1;1;0;1;0;0;0;0;0;0;0;tWWw7
540;"École doctorale École transdisciplinaire ""lettres/sciences""";;10;Sciences agronomiques et écologiques;2021;2020-21;2020;2020;1;0;1;7;2;5;0;0;0;0;0;0;0;tWWw7
541;École doctorale de sciences humaines et sociales de La Réunion;SHS;10;Sciences agronomiques et écologiques;2021;2020-21;2020;2020;0;0;0;1;0;1;0;0;0;0;0;0;0;21SpE
543;École doctorale de Dauphine;;1;Mathématiques et leurs interactions;2021;2020-21;2020;2020;14;1;13;46;8;38;6;0;6;4;2;0;0;u8w6A
548;École doctorale Mer et Sciences;;8;Sciences pour l'ingénieur;2021;2020-21;2020;2020;0;0;0;4;1;3;1;0;1;1;0;0;0;QX0fS
549;École doctorale Santé, Sciences Biologiques et Chimie du Vivant;SSBCV;4;Chimie;2021;2020-21;2020;2020;16;7;9;50;22;28;17;9;8;9;8;0;0;B9ggO
551;École doctorale Mathématiques, Informatique, Physique Théorique et Ingénierie des Systèmes;MIPTIS;8;Sciences pour l'ingénieur;2021;2020-21;2020;2020;2;0;2;6;2;4;8;2;6;1;5;2;0;Mpudz
552;École doctorale Énergie - Matériaux - Sciences de la Terre et de l'Univers;EMTSU;8;Sciences pour l'ingénieur;2021;2020-21;2020;2020;26;6;20;93;28;65;25;2;23;3;18;3;1;NTZhw
553;École doctorale Carnot - Pasteur;;2;Physique;2021;2020-21;2020;2020;12;4;8;41;11;30;9;2;7;7;2;0;0;6h4Z7
553;École doctorale Carnot - Pasteur;;4;Chimie;2021;2020-21;2020;2020;12;4;8;73;30;43;15;7;8;6;7;1;1;6h4Z7
554;École doctorale Environnements - Santé;E-S;7;Sciences de la société;2021;2020-21;2020;2020;0;0;0;0;0;0;1;0;1;0;0;0;1;ElyFU
554;École doctorale Environnements - Santé;E-S;10;Sciences agronomiques et écologiques;2021;2020-21;2020;2020;25;19;6;91;50;41;14;4;10;8;6;0;0;ElyFU
555;École doctorale Sciences de l'Homme et de la Société;SHS;6;Sciences humaines et humanités;2021;2020-21;2020;2020;27;14;13;108;56;52;8;2;6;2;0;2;4;44G6m
556;École doctorale Homme, Sociétés, Risques, Territoire;HSRT;7;Sciences de la société;2021;2020-21;2020;2020;46;28;18;134;106;28;3;1;2;2;0;0;1;5QEaX
566;École doctorale Sciences du Sport, de la Motricité et du Mouvement Humain;SMMH;6;Sciences humaines et humanités;2021;2020-21;2020;2020;9;3;6;44;24;20;7;2;5;2;3;1;1;3iv8y
568;École doctorale Signalisations et Réseaux Intégratifs en Biologie;BIOSIGNE;5;Biologie, médecine et santé;2021;2020-21;2020;2020;23;13;10;95;65;30;14;9;5;8;5;1;0;CGttG
570;École doctorale Santé Publique;EDSP;6;Sciences humaines et humanités;2021;2020-21;2020;2020;2;2;0;7;6;1;0;0;0;0;0;0;0;9lgE4
575;École doctorale Electrical, Optical, Bio : Physics and Engineering;EOBE;4;Chimie;2021;2020-21;2020;2020;1;0;1;3;1;2;0;0;0;0;0;0;0;dfhyn
575;École doctorale Electrical, Optical, Bio : Physics and Engineering;EOBE;5;Biologie, médecine et santé;2021;2020-21;2020;2020;3;1;2;17;10;7;1;0;1;0;1;0;0;dfhyn
576;École doctorale Particules, Hadrons, Énergie, Noyau, Instrumentation, Imagerie, Cosmos et Simulation;PHENIICS;3;Sciences de la terre et de l'univers, espace;2021;2020-21;2020;2020;0;0;0;4;2;2;0;0;0;0;0;0;0;qC4rf
579;École doctorale Sciences mécaniques et energétiques, matériaux et géosciences;SMEMaG;2;Physique;2021;2020-21;2020;2020;11;4;7;32;5;27;4;0;4;1;3;0;0;atMj7
580;École doctorale Sciences et technologies de l'information et de la communication;STIC;8;Sciences pour l'ingénieur;2021;2020-21;2020;2020;1;0;1;17;2;15;1;0;1;1;0;0;0;AzCC0
581;École doctorale Agriculture, alimentation, biologie, environnement, santé;ABIES;8;Sciences pour l'ingénieur;2021;2020-21;2020;2020;7;2;5;52;22;30;6;5;1;5;1;0;0;c1x56
584;École doctorale Biodiversité, Agriculture, Alimentation, Environnement, Terre, Eau;GAIA;10;Sciences agronomiques et écologiques;2021;2020-21;2020;2020;100;56;44;425;229;196;91;45;46;63;26;2;0;F1h5f
585;École doctorale Sciences, Technologie,  Sante;EDSTS;3;Sciences de la terre et de l'univers, espace;2021;2020-21;2020;2020;4;3;1;16;7;9;0;0;0;0;0;0;0;NM3Dl
585;École doctorale Sciences, Technologie,  Sante;EDSTS;5;Biologie, médecine et santé;2021;2020-21;2020;2020;23;13;10;100;56;44;16;6;10;11;4;1;0;NM3Dl
587;École doctorale Diversites, santé et développement en Amazonie;;8;Sciences pour l'ingénieur;2021;2020-21;2020;2020;2;0;2;5;1;4;0;0;0;0;0;0;0;V14tj
593;École doctorale Droit, Gestion, sciences Économiques et Politique;DGEP;7;Sciences de la société;2021;2020-21;2020;2020;50;24;26;238;98;140;22;8;14;1;4;9;8;41pAm
596;École doctorale Matière, Molécules et Matériaux;ED 3M;4;Chimie;2021;2020-21;2020;2020;72;29;43;284;121;163;68;38;30;53;13;2;0;77947
596;École doctorale Matière, Molécules et Matériaux;ED 3M;9;Sciences et technologies de l'information et de la communication;2021;2020-21;2020;2020;11;1;10;42;10;32;8;5;3;4;4;0;0;77947
598;École doctorale Sciences de La Mer et du Littoral;SML;4;Chimie;2021;2020-21;2020;2020;1;0;1;3;1;2;0;0;0;0;0;0;0;Smen6
598;École doctorale Sciences de La Mer et du Littoral;SML;7;Sciences de la société;2021;2020-21;2020;2020;3;1;2;15;9;6;3;1;2;2;1;0;0;Smen6
600;École doctorale Écologie, Géosciences, Agronomie et Alimentation;EGAAL;1;Mathématiques et leurs interactions;2021;2020-21;2020;2020;1;0;1;3;1;2;2;1;1;2;0;0;0;urS33
601;École doctorale Mathématiques et Sciences et Technologies de l'information et de la Communication;MathSTIC;1;Mathématiques et leurs interactions;2021;2020-21;2020;2020;33;3;30;153;24;129;30;14;16;25;5;0;0;3Ue20
603;École doctorale Éducation, Langages, Interactions, Cognition, Clinique, Expertise - ED 603;ELICCE;9;Sciences et technologies de l'information et de la communication;2021;2020-21;2020;2020;0;0;0;3;1;2;0;0;0;0;0;0;0;1Mzw7
604;École doctorale Sociétés, Temps, Territoires;STT;8;Sciences pour l'ingénieur;2021;2020-21;2020;2020;0;0;0;0;0;0;8;4;4;0;0;4;4;SZI5T
604;École doctorale Sociétés, Temps, Territoires;STT;10;Sciences agronomiques et écologiques;2021;2020-21;2020;2020;0;0;0;5;2;3;1;1;0;0;0;1;0;SZI5T
606;École doctorale Chimie - Mécanique - Matériaux - Physique;C2MP;2;Physique;2021;2020-21;2020;2020;29;10;19;86;24;62;25;5;20;15;9;1;0;UkNR2
608;École doctorale Sciences et Ingénierie des Molécules, des Produits, des Procédés et de l'Énergie;SIMPPÉ;4;Chimie;2021;2020-21;2020;2020;2;0;2;7;3;4;2;2;0;0;2;0;0;TyNjM
609;École doctorale Sciences et Ingénierie des Matériaux, Mécanique, Énergétique -;SIMME;4;Chimie;2021;2020-21;2020;2020;5;3;2;29;14;15;2;2;0;1;1;0;0;N4Rjy
614;École doctorale Chimie, Écologie, Géosciences, Agrosciences - Théodore Monod;CEGA;3;Sciences de la terre et de l'univers, espace;2021;2020-21;2020;2020;8;4;4;22;11;11;4;3;1;4;0;0;0;uc10I
614;École doctorale Chimie, Écologie, Géosciences, Agrosciences - Théodore Monod;CEGA;5;Biologie, médecine et santé;2021;2020-21;2020;2020;4;2;2;13;7;6;1;1;0;1;0;0;0;uc10I
617;École doctorale Sciences de la Société : Territoires, Economie et Droit;SSTED;6;Sciences humaines et humanités;2021;2020-21;2020;2020;20;9;11;96;38;58;7;1;6;1;2;3;1;Kl9ZX
617;École doctorale Sciences de la Société : Territoires, Economie et Droit;SSTED;9;Sciences et technologies de l'information et de la communication;2021;2020-21;2020;2020;2;0;2;6;0;6;0;0;0;0;0;0;0;Kl9ZX
618;École doctorale EUCLIDE;;9;Sciences et technologies de l'information et de la communication;2021;2020-21;2020;2020;11;1;10;41;8;33;2;1;1;1;1;0;0;qveTN
619;École doctorale Sciences Fondamentales et Santé;SFS;2;Physique;2021;2020-21;2020;2020;1;1;0;5;4;1;1;1;0;0;1;0;0;JiZVW
620;École doctorale Sciences du Numérique et de l'Ingénieur;SNI;1;Mathématiques et leurs interactions;2021;2020-21;2020;2020;3;0;3;4;0;4;1;1;0;0;1;0;0;Dr40w
620;École doctorale Sciences du Numérique et de l'Ingénieur;SNI;10;Sciences agronomiques et écologiques;2021;2020-21;2020;2020;0;0;0;1;1;0;0;0;0;0;0;0;0;Dr40w
625;École doctorale Mondes Anglophones, Germanophones, Iraniens, Indiens, et Études Européennes;MAGIIE;6;Sciences humaines et humanités;2021;2020-21;2020;2020;30;18;12;146;103;43;12;10;2;1;2;3;6;JiOMD
626;École doctorale de l’Institut Polytechnique de Paris;;5;Biologie, médecine et santé;2021;2020-21;2020;2020;5;2;3;27;13;14;9;6;3;4;3;1;1;DL5fO
627;École doctorale Éducation, Didactiques, Cognition;EDC;6;Sciences humaines et humanités;2021;2020-21;2020;2020;13;8;5;75;54;21;0;0;0;0;0;0;0;dE3nH
630;École doctorale Droit, Economie et Management;DEM;6;Sciences humaines et humanités;2021;2020-21;2020;2020;9;4;5;27;14;13;6;5;1;0;1;4;1;78n8c
52;École doctorale Physique et astrophysique de Lyon;PHAST;2;Physique;2016;2015-16;2015;2015;45;10;35;169;36;133;48;7;41;;;;;61XPb
60;École doctorale Territoires, temps, sociétés et développement;TTSD;6;Sciences humaines et humanités;2016;2015-16;2015;2015;69;39;30;225;131;94;37;30;7;;;;;fkIh6
72;École doctorale Sciences pour l'ingénieur;SPI;9;Sciences et technologies de l'information et de la communication;2016;2015-16;2015;2015;115;26;89;392;97;295;125;32;93;;;;;47QPx
73;École doctorale Sciences économiques, sociales, de l'aménagement et du management;SESAM;1;Mathématiques et leurs interactions;2016;2015-16;2015;2015;1;1;0;8;1;7;1;0;1;;;;;IQ0Hk
77;École doctorale Informatique, automatique, électronique, électrotechnique, mathématiques;IAEM;6;Sciences humaines et humanités;2016;2015-16;2015;2015;1;0;1;3;0;3;0;0;0;;;;;TCHTA
78;École doctorale Sociétés, langages, temps, connaissances;STLC;6;Sciences humaines et humanités;2016;2015-16;2015;2015;48;28;20;216;148;68;28;13;15;;;;;vLU3i
92;École doctorale Vie -  Agro - Santé;;10;Sciences agronomiques et écologiques;2016;2015-16;2015;2015;19;13;6;90;56;34;21;11;10;;;;;RjvXY
101;École doctorale de Sciences juridiques;;7;Sciences de la société;2016;2015-16;2015;2015;35;13;22;224;115;109;36;21;15;;;;;569G2
104;École doctorale Sciences de la matière, du rayonnement et de l'environnement;SMRE;3;Sciences de la terre et de l'univers, espace;2016;2015-16;2015;2015;9;4;5;37;14;23;6;2;4;;;;;Q5iFz
105;École doctorale Terre, univers, environnement;;3;Sciences de la terre et de l'univers, espace;2016;2015-16;2015;2015;35;18;17;176;79;97;35;16;19;;;;;lcWAf
113;École doctorale Histoire;;6;Sciences humaines et humanités;2016;2015-16;2015;2015;49;24;25;322;157;165;52;21;31;;;;;G5wHs
132;École doctorale Sciences du langage;;6;Sciences humaines et humanités;2016;2015-16;2015;2015;20;15;5;96;66;30;18;10;8;;;;;5AUF1
139;École doctorale Connaissance, langage, modélisation;CLM;1;Mathématiques et leurs interactions;2016;2015-16;2015;2015;1;1;0;8;2;6;1;0;1;;;;;1lxGH
145;École doctorale Sciences du végétal : du gène à l'écosystème;;10;Sciences agronomiques et écologiques;2016;2015-16;2015;2015;0;0;0;0;0;0;4;2;2;;;;;ubDmM
146;École doctorale Galilée;GALILEE;8;Sciences pour l'ingénieur;2016;2015-16;2015;2015;2;1;1;28;8;20;7;5;2;;;;;71hqm
166;École doctorale Information, structures et systèmes;I2S;9;Sciences et technologies de l'information et de la communication;2016;2015-16;2015;2015;48;11;37;144;33;111;41;6;35;;;;;2uO68
168;École doctorale Sciences chimiques et biologiques pour la santé;SCBS;5;Biologie, médecine et santé;2016;2015-16;2015;2015;92;54;38;356;212;144;76;52;24;;;;;8cEME
171;École doctorale Toulouse sciences économiques;TSE;7;Sciences de la société;2016;2015-16;2015;2015;21;7;14;102;32;70;17;6;11;;;;;Q5nNQ
178;École doctorale Sciences fondamentales;;1;Mathématiques et leurs interactions;2016;2015-16;2015;2015;2;0;2;14;1;13;7;2;5;;;;;1AiR7
180;École doctorale Sciences humaines et sociales : cultures, individus, sociétés;SHS;7;Sciences de la société;2016;2015-16;2015;2015;21;13;8;113;65;48;24;17;7;;;;;D2BT3
182;École doctorale Physique et chimie-physique;;5;Biologie, médecine et santé;2016;2015-16;2015;2015;0;0;0;1;1;0;0;0;0;;;;;3My6I
184;École doctorale Mathématiques et informatique de Marseille;;5;Biologie, médecine et santé;2016;2015-16;2015;2015;0;0;0;1;0;1;0;0;0;;;;;DDObG
184;École doctorale Mathématiques et informatique de Marseille;;8;Sciences pour l'ingénieur;2016;2015-16;2015;2015;4;0;4;14;3;11;4;1;3;;;;;DDObG
188;École doctorale Histoire moderne et contemporaine;;6;Sciences humaines et humanités;2016;2015-16;2015;2015;29;15;14;167;78;89;19;7;12;;;;;RSZ7F
205;École doctorale Interdisciplinaire Sciences-Santé;EDISS;8;Sciences pour l'ingénieur;2016;2015-16;2015;2015;3;0;3;7;1;6;1;1;0;;;;;69W38
206;École doctorale Chimie : chimie, procédés, environnement;;4;Chimie;2016;2015-16;2015;2015;72;37;35;344;155;189;79;37;42;;;;;m0UhD
209;École doctorale Sciences physiques et de L'ingénieur;SPI;2;Physique;2016;2015-16;2015;2015;27;4;23;97;24;73;24;3;21;;;;;tZcIZ
211;École doctorale Sciences exactes et leurs applications;ED SEA;10;Sciences agronomiques et écologiques;2016;2015-16;2015;2015;3;2;1;10;5;5;3;2;1;;;;;1G1iC
216;École doctorale Ingénierie pour la santé, la cognition, l'environnement;EDISCE;7;Sciences de la société;2016;2015-16;2015;2015;0;0;0;6;3;3;2;0;2;;;;;fPs1t
216;École doctorale Ingénierie pour la santé, la cognition, l'environnement;EDISCE;9;Sciences et technologies de l'information et de la communication;2016;2015-16;2015;2015;3;3;0;21;10;11;7;1;6;;;;;fPs1t
216;École doctorale Ingénierie pour la santé, la cognition, l'environnement;EDISCE;10;Sciences agronomiques et écologiques;2016;2015-16;2015;2015;2;1;1;4;2;2;1;0;1;;;;;fPs1t
217;École doctorale Mathématiques, sciences et technologies de l'information, informatique;MSTII;9;Sciences et technologies de l'information et de la communication;2016;2015-16;2015;2015;69;13;56;307;72;235;64;12;52;;;;;Ehx7v
222;École doctorale Sciences chimiques;EDSC;10;Sciences agronomiques et écologiques;2016;2015-16;2015;2015;0;0;0;0;0;0;1;0;1;;;;;AdU8Q
224;École doctorale Cognition, langage, interaction;;1;Mathématiques et leurs interactions;2016;2015-16;2015;2015;1;0;1;3;1;2;0;0;0;;;;;7v43e
224;École doctorale Cognition, langage, interaction;;8;Sciences pour l'ingénieur;2016;2015-16;2015;2015;0;0;0;4;3;1;3;3;0;;;;;7v43e
227;École doctorale Sciences de la nature et de l'homme;;9;Sciences et technologies de l'information et de la communication;2016;2015-16;2015;2015;1;0;1;2;1;1;0;0;0;;;;;xiDA5
231;École doctorale Économie et gestion;EDEG;7;Sciences de la société;2016;2015-16;2015;2015;43;17;26;200;100;100;31;12;19;;;;;KT720
250;École doctorale Sciences chimiques;;4;Chimie;2016;2015-16;2015;2015;22;11;11;89;42;47;27;13;14;;;;;O0Fav
251;École doctorale Sciences de l'environnement;;8;Sciences pour l'ingénieur;2016;2015-16;2015;2015;3;1;2;15;9;6;5;1;4;;;;;VR28y
260;École doctorale pluridisciplinaire;;5;Biologie, médecine et santé;2016;2015-16;2015;2015;0;0;0;0;0;0;15;10;5;;;;;sCk1f
260;École doctorale pluridisciplinaire;;10;Sciences agronomiques et écologiques;2016;2015-16;2015;2015;0;0;0;0;0;0;2;1;1;;;;;sCk1f
268;École doctorale Langage et langues : description, théorisation, transmission;;7;Sciences de la société;2016;2015-16;2015;2015;1;0;1;7;6;1;2;1;1;;;;;wAIDE
269;École doctorale Mathématiques, sciences de l'information et de l'ingénieur;MSII;5;Biologie, médecine et santé;2016;2015-16;2015;2015;3;3;0;7;5;2;1;1;0;;;;;5E625
285;École doctorale Sciences pratiques;;2;Physique;2016;2015-16;2015;2015;0;0;0;0;0;0;5;1;4;;;;;Jd3t2
285;École doctorale Sciences pratiques;;4;Chimie;2016;2015-16;2015;2015;0;0;0;0;0;0;3;2;1;;;;;Jd3t2
285;École doctorale Sciences pratiques;;9;Sciences et technologies de l'information et de la communication;2016;2015-16;2015;2015;0;0;0;0;0;0;3;0;3;;;;;Jd3t2
304;École doctorale Sciences et environnements;;10;Sciences agronomiques et écologiques;2016;2015-16;2015;2015;9;4;5;57;30;27;10;3;7;;;;;2ywZn
305;École doctorale Énergie et environnement;E2;4;Chimie;2016;2015-16;2015;2015;3;0;3;9;5;4;0;0;0;;;;;Kbt8I
309;École doctorale Systèmes;EDSYS;9;Sciences et technologies de l'information et de la communication;2016;2015-16;2015;2015;21;7;14;97;20;77;23;5;18;;;;;8TT4b
323;École doctorale Génie électrique, électronique et télécommunications;GEET;8;Sciences pour l'ingénieur;2016;2015-16;2015;2015;60;16;44;267;65;202;58;16;42;;;;;arcz6
323;École doctorale Génie électrique, électronique et télécommunications;GEET;9;Sciences et technologies de l'information et de la communication;2016;2015-16;2015;2015;13;0;13;22;2;20;8;2;6;;;;;arcz6
340;École doctorale Biologie moléculaire, intégrative et cellulaire;BMIC;5;Biologie, médecine et santé;2016;2015-16;2015;2015;84;54;30;270;165;105;52;28;24;;;;;db7xq
356;École doctorale Cognition, langage, éducation;;6;Sciences humaines et humanités;2016;2015-16;2015;2015;79;49;30;303;176;127;74;45;29;;;;;55Cpz
359;École doctorale Mathématiques, télécommunications, informatique, signal, systèmes, électronique;MATISSE;1;Mathématiques et leurs interactions;2016;2015-16;2015;2015;18;6;12;67;18;49;18;4;14;;;;;Y0r76
364;École doctorale Sciences fondamentales et appliquées;EDSFA;1;Mathématiques et leurs interactions;2016;2015-16;2015;2015;11;5;6;54;19;35;13;4;9;;;;;E483q
364;École doctorale Sciences fondamentales et appliquées;EDSFA;2;Physique;2016;2015-16;2015;2015;12;5;7;45;16;29;12;1;11;;;;;E483q
364;École doctorale Sciences fondamentales et appliquées;EDSFA;3;Sciences de la terre et de l'univers, espace;2016;2015-16;2015;2015;15;6;9;82;29;53;20;7;13;;;;;E483q
370;École doctorale Lettres, sciences humaines et sociales;LSHS;6;Sciences humaines et humanités;2016;2015-16;2015;2015;32;19;13;205;122;83;30;16;14;;;;;xAXXx
370;École doctorale Lettres, sciences humaines et sociales;LSHS;7;Sciences de la société;2016;2015-16;2015;2015;0;0;0;4;3;1;0;0;0;;;;;xAXXx
373;École doctorale Santé, information/communications et mathématiques, matière;SICMA;8;Sciences pour l'ingénieur;2016;2015-16;2015;2015;11;2;9;59;13;46;11;5;6;;;;;hTJF5
377;École doctorale Environnement et société;;4;Chimie;2016;2015-16;2015;2015;2;2;0;15;10;5;1;0;1;;;;;ZMG5u
377;École doctorale Environnement et société;;6;Sciences humaines et humanités;2016;2015-16;2015;2015;14;10;4;63;42;21;8;4;4;;;;;ZMG5u
377;École doctorale Environnement et société;;8;Sciences pour l'ingénieur;2016;2015-16;2015;2015;3;0;3;9;3;6;2;0;2;;;;;ZMG5u
382;École doctorale Économie, espaces, sociétés, civilisations : pensée critique, politique et pratique sociale;EESC;6;Sciences humaines et humanités;2016;2015-16;2015;2015;24;8;16;72;37;35;12;7;5;;;;;9NI1W
396;École doctorale Économie, organisations, société;EOS;7;Sciences de la société;2016;2015-16;2015;2015;40;19;21;223;104;119;36;20;16;;;;;Es5e7
397;École doctorale Physique et chimie des matériaux;;4;Chimie;2016;2015-16;2015;2015;38;16;22;127;56;71;38;15;23;;;;;WxSt9
400;École doctorale Savoirs scientifiques : épistémologie, histoire des sciences, didactique des disciplines;;1;Mathématiques et leurs interactions;2016;2015-16;2015;2015;4;3;1;34;16;18;8;5;3;;;;;nRax3
401;École doctorale Sciences sociales;;6;Sciences humaines et humanités;2016;2015-16;2015;2015;30;13;17;166;80;86;15;8;7;;;;;raQ7K
401;École doctorale Sciences sociales;;7;Sciences de la société;2016;2015-16;2015;2015;35;17;18;176;99;77;23;11;12;;;;;raQ7K
402;École doctorale Sciences de la vie et de la santé;SVS;8;Sciences pour l'ingénieur;2016;2015-16;2015;2015;0;0;0;0;0;0;1;0;1;;;;;YKgsU
410;École doctorale Sciences et ingénierie des ressources, procédés, produits, environnement;RP2E;3;Sciences de la terre et de l'univers, espace;2016;2015-16;2015;2015;16;8;8;85;31;54;18;4;14;;;;;Q5fxV
410;École doctorale Sciences et ingénierie des ressources, procédés, produits, environnement;RP2E;4;Chimie;2016;2015-16;2015;2015;1;1;0;11;8;3;3;2;1;;;;;Q5fxV
411;École doctorale Humanités nouvelles : Fernand Braudel;;6;Sciences humaines et humanités;2016;2015-16;2015;2015;58;29;29;182;102;80;24;11;13;;;;;l2rFh
411;École doctorale Humanités nouvelles : Fernand Braudel;;7;Sciences de la société;2016;2015-16;2015;2015;19;11;8;43;16;27;3;2;1;;;;;l2rFh
413;École doctorale Sciences de la terre et de l'environnement;STE;2;Physique;2016;2015-16;2015;2015;6;4;2;26;10;16;5;4;1;;;;;u9BA9
414;École doctorale Sciences de la vie et de la santé;;2;Physique;2016;2015-16;2015;2015;0;0;0;2;1;1;0;0;0;;;;;YI4xS
414;École doctorale Sciences de la vie et de la santé;;6;Sciences humaines et humanités;2016;2015-16;2015;2015;0;0;0;2;0;2;0;0;0;;;;;YI4xS
417;École doctorale Sciences et Ingénierie;S&I;1;Mathématiques et leurs interactions;2016;2015-16;2015;2015;0;0;0;1;1;0;0;0;0;;;;;SSBvE
422;École doctorale Sciences et technologies de l'information, des télécommunications et des systèmes;;8;Sciences pour l'ingénieur;2016;2015-16;2015;2015;0;0;0;0;0;0;44;8;36;;;;;998UM
435;École doctorale Agriculture, alimentation, biologie, environnement et santé;;7;Sciences de la société;2016;2015-16;2015;2015;0;0;0;0;0;0;3;1;2;;;;;mC35U
435;École doctorale Agriculture, alimentation, biologie, environnement et santé;;8;Sciences pour l'ingénieur;2016;2015-16;2015;2015;0;0;0;0;0;0;5;3;2;;;;;mC35U
435;École doctorale Agriculture, alimentation, biologie, environnement et santé;;9;Sciences et technologies de l'information et de la communication;2016;2015-16;2015;2015;0;0;0;0;0;0;1;0;1;;;;;mC35U
446;École doctorale Biologie - Santé;EDBSL;2;Physique;2016;2015-16;2015;2015;0;0;0;0;0;0;1;0;1;;;;;4iEUF
456;École doctorale Sciences du sport, de la motricité et du mouvement humain;;5;Biologie, médecine et santé;2016;2015-16;2015;2015;0;0;0;0;0;0;5;3;2;;;;;GqvEI
463;École doctorale Sciences du mouvement humain;SMH;5;Biologie, médecine et santé;2016;2015-16;2015;2015;12;4;8;62;24;38;15;4;11;;;;;UbtlY
463;École doctorale Sciences du mouvement humain;SMH;6;Sciences humaines et humanités;2016;2015-16;2015;2015;8;4;4;31;15;16;3;0;3;;;;;UbtlY
463;École doctorale Sciences du mouvement humain;SMH;7;Sciences de la société;2016;2015-16;2015;2015;0;0;0;2;0;2;0;0;0;;;;;UbtlY
465;École doctorale Économie Panthéon Sorbonne;EPS;7;Sciences de la société;2016;2015-16;2015;2015;71;27;44;331;144;187;64;29;35;;;;;MV68S
467;École doctorale Aéronautique, astronautique;AA;9;Sciences et technologies de l'information et de la communication;2016;2015-16;2015;2015;2;0;2;5;3;2;0;0;0;;;;;U7l45
469;École doctorale du Pacifique;EDP;9;Sciences et technologies de l'information et de la communication;2016;2015-16;2015;2015;1;0;1;2;0;2;1;0;1;;;;;t9Z2n
469;École doctorale du Pacifique;EDP;10;Sciences agronomiques et écologiques;2016;2015-16;2015;2015;1;0;1;7;3;4;1;0;1;;;;;t9Z2n
474;École doctorale Interdisciplinaire européenne frontières du vivant;FDV;3;Sciences de la terre et de l'univers, espace;2016;2015-16;2015;2015;1;0;1;5;0;5;1;1;0;;;;;E727j
474;École doctorale Interdisciplinaire européenne frontières du vivant;FDV;5;Biologie, médecine et santé;2016;2015-16;2015;2015;24;9;15;83;44;39;11;5;6;;;;;E727j
474;École doctorale Interdisciplinaire européenne frontières du vivant;FDV;9;Sciences et technologies de l'information et de la communication;2016;2015-16;2015;2015;1;0;1;2;0;2;0;0;0;;;;;E727j
477;École doctorale Systèmes intégrés en biologie, agronomie, géosciences, hydrosciences, environnement;SIBAGHE;3;Sciences de la terre et de l'univers, espace;2016;2015-16;2015;2015;0;0;0;0;0;0;27;10;17;;;;;zfN3N
484;École doctorale Lettres, langues, linguistique, arts;3LA;6;Sciences humaines et humanités;2016;2015-16;2015;2015;118;71;47;566;343;223;62;32;30;;;;;BlCQD
485;École doctorale Éducation, Psychologie, Information et Communication;EPIC;7;Sciences de la société;2016;2015-16;2015;2015;0;0;0;1;0;1;0;0;0;;;;;O82eL
487;École doctorale Philosophie;PHCR;6;Sciences humaines et humanités;2016;2015-16;2015;2015;22;10;12;153;60;93;18;10;8;;;;;3BRzJ
488;École doctorale Sciences, ingénierie, santé;SIS;10;Sciences agronomiques et écologiques;2016;2015-16;2015;2015;1;0;1;7;5;2;1;1;0;;;;;Fy2lK
489;École doctorale Sciences et ingénierie des systèmes, de l'environnement et des organisations;SISEO;4;Chimie;2016;2015-16;2015;2015;2;0;2;6;3;3;3;1;2;;;;;6pT77
489;École doctorale Sciences et ingénierie des systèmes, de l'environnement et des organisations;SISEO;7;Sciences de la société;2016;2015-16;2015;2015;8;3;5;27;15;12;4;1;3;;;;;6pT77
489;École doctorale Sciences et ingénierie des systèmes, de l'environnement et des organisations;SISEO;10;Sciences agronomiques et écologiques;2016;2015-16;2015;2015;8;3;5;13;5;8;2;1;1;;;;;6pT77
495;École doctorale Végétal, environnement, nutrition, agroalimentaire, mer;VENAM;3;Sciences de la terre et de l'univers, espace;2016;2015-16;2015;2015;2;0;2;7;1;6;3;2;1;;;;;HL495
497;École doctorale Normande de Biologie Intégrative, Santé, Environnement;Ed NBISE;4;Chimie;2016;2015-16;2015;2015;1;1;0;1;1;0;0;0;0;;;;;0D9Je
497;École doctorale Normande de Biologie Intégrative, Santé, Environnement;Ed NBISE;5;Biologie, médecine et santé;2016;2015-16;2015;2015;73;42;31;259;135;124;60;26;34;;;;;0D9Je
498;École doctorale Sciences pour l'ingénieur, géosciences, architecture;SPIGA;3;Sciences de la terre et de l'univers, espace;2016;2015-16;2015;2015;6;4;2;27;13;14;9;7;2;;;;;0vlKH
498;École doctorale Sciences pour l'ingénieur, géosciences, architecture;SPIGA;6;Sciences humaines et humanités;2016;2015-16;2015;2015;3;3;0;9;4;5;3;3;0;;;;;0vlKH
500;École doctorale Matière, molécules, matériaux en Pays de Loire;3MPL;5;Biologie, médecine et santé;2016;2015-16;2015;2015;0;0;0;1;1;0;0;0;0;;;;;822tM
502;École doctorale Biologie - Santé;;4;Chimie;2016;2015-16;2015;2015;1;0;1;8;4;4;0;0;0;;;;;JCFV7
504;École doctorale Cognition, éducation, interactions;CEI;6;Sciences humaines et humanités;2016;2015-16;2015;2015;41;25;16;199;120;79;21;13;8;;;;;39naT
505;École doctorale Sciences de l'homme, des organisations et de la société;SHOS;7;Sciences de la société;2016;2015-16;2015;2015;71;32;39;354;163;191;40;19;21;;;;;qts78
506;École doctorale arts, lettres et langues;;6;Sciences humaines et humanités;2016;2015-16;2015;2015;45;32;13;211;145;66;22;12;10;;;;;m9yqI
508;École doctorale Normande de chimie;EDNC;5;Biologie, médecine et santé;2016;2015-16;2015;2015;1;1;0;1;1;0;0;0;0;;;;;E52OO
510;École doctorale Ingénierie - Matériaux, mécanique, environnement, énergétique, procédés, production;IMEP2;9;Sciences et technologies de l'information et de la communication;2016;2015-16;2015;2015;1;0;1;5;0;5;0;0;0;;;;;Ce7NF
517;École doctorale Particules, noyaux, cosmologie;;2;Physique;2016;2015-16;2015;2015;0;0;0;0;0;0;19;4;15;;;;;9kK48
522;École doctorale Sciences et ingénierie en matériaux, mécanique, énergétique et aéronautique;SI-MMEA;8;Sciences pour l'ingénieur;2016;2015-16;2015;2015;43;7;36;214;42;172;60;15;45;;;;;82F19
523;École doctorale Sciences pour l'environnement - Gay Lussac;;4;Chimie;2016;2015-16;2015;2015;19;7;12;92;38;54;26;11;15;;;;;6xD69
526;École doctorale Sociétés et organisations;SORG;6;Sciences humaines et humanités;2016;2015-16;2015;2015;15;4;11;63;29;34;10;3;7;;;;;5F3Fd
528;École doctorale Ville, transports et territoires;VTT;7;Sciences de la société;2016;2015-16;2015;2015;12;9;3;58;34;24;6;2;4;;;;;68zCc
529;École doctorale Cultures et sociétés;CS;7;Sciences de la société;2016;2015-16;2015;2015;5;3;2;28;16;12;2;0;2;;;;;XU9tb
530;École doctorale Organisations, marchés, institutions;OMI;10;Sciences agronomiques et écologiques;2016;2015-16;2015;2015;0;0;0;1;1;0;0;0;0;;;;;4htv7
532;École doctorale Mathématiques et sciences et technologies de l'information et de la communication;MSTIC;9;Sciences et technologies de l'information et de la communication;2016;2015-16;2015;2015;25;9;16;139;40;99;45;12;33;;;;;t43KM
534;École doctorale Modélisation et instrumentation en physique, énergie, géosciences et environnement;MIPEGE;2;Physique;2016;2015-16;2015;2015;0;0;0;0;0;0;19;6;13;;;;;K93eR
535;École doctorale Sciences de la société;SDS;7;Sciences de la société;2016;2015-16;2015;2015;0;0;0;0;0;0;6;4;2;;;;;iEUOV
536;École doctorale Sciences et agrosciences;;1;Mathématiques et leurs interactions;2016;2015-16;2015;2015;12;1;11;43;11;32;7;1;6;;;;;pHfqe
536;École doctorale Sciences et agrosciences;;3;Sciences de la terre et de l'univers, espace;2016;2015-16;2015;2015;4;2;2;16;8;8;1;0;1;;;;;pHfqe
536;École doctorale Sciences et agrosciences;;5;Biologie, médecine et santé;2016;2015-16;2015;2015;0;0;0;8;2;6;2;0;2;;;;;pHfqe
537;École doctorale Culture et patrimoine;C&P;6;Sciences humaines et humanités;2016;2015-16;2015;2015;19;11;8;40;19;21;5;1;4;;;;;GxI4a
539;École doctorale Sciences et technologies de Versailles;;4;Chimie;2016;2015-16;2015;2015;0;0;0;0;0;0;5;2;3;;;;;nv3h8
542;École doctorale de sciences de La Réunion;STS;5;Biologie, médecine et santé;2016;2015-16;2015;2015;4;0;4;9;0;9;4;2;2;;;;;2pAql
542;École doctorale de sciences de La Réunion;STS;9;Sciences et technologies de l'information et de la communication;2016;2015-16;2015;2015;3;0;3;10;0;10;0;0;0;;;;;2pAql
544;École doctorale Inter-Med : Espaces, temps, cultures;INTER-MED;7;Sciences de la société;2016;2015-16;2015;2015;33;18;15;145;70;75;15;5;10;;;;;7VjtD
546;École doctorale Abbé Grégoire;;6;Sciences humaines et humanités;2016;2015-16;2015;2015;35;22;13;137;81;56;17;13;4;;;;;ZSn7q
547;École doctorale Sciences, Technologie, Santé;EDSTS;4;Chimie;2016;2015-16;2015;2015;3;0;3;27;11;16;14;5;9;;;;;wEdn2
548;École doctorale Mer et Sciences;;4;Chimie;2016;2015-16;2015;2015;5;1;4;19;8;11;2;0;2;;;;;QX0fS
549;École doctorale Santé, Sciences Biologiques et Chimie du Vivant;SSBCV;2;Physique;2016;2015-16;2015;2015;1;1;0;2;1;1;1;0;1;;;;;B9ggO
549;École doctorale Santé, Sciences Biologiques et Chimie du Vivant;SSBCV;10;Sciences agronomiques et écologiques;2016;2015-16;2015;2015;1;0;1;26;15;11;3;1;2;;;;;B9ggO
551;École doctorale Mathématiques, Informatique, Physique Théorique et Ingénierie des Systèmes;MIPTIS;2;Physique;2016;2015-16;2015;2015;1;0;1;5;0;5;0;0;0;;;;;Mpudz
552;École doctorale Énergie - Matériaux - Sciences de la Terre et de l'Univers;EMTSU;3;Sciences de la terre et de l'univers, espace;2016;2015-16;2015;2015;13;3;10;53;17;36;18;7;11;;;;;NTZhw
552;École doctorale Énergie - Matériaux - Sciences de la Terre et de l'Univers;EMTSU;8;Sciences pour l'ingénieur;2016;2015-16;2015;2015;27;8;19;88;20;68;21;6;15;;;;;NTZhw
556;École doctorale Homme, Sociétés, Risques, Territoire;HSRT;6;Sciences humaines et humanités;2016;2015-16;2015;2015;59;27;32;240;109;131;30;14;16;;;;;5QEaX
560;École doctorale Sciences de la terre et de l'environnement et Physique de l'univers, Paris;STEP'UP;2;Physique;2016;2015-16;2015;2015;8;2;6;23;3;20;8;0;8;;;;;Z2VI9
569;École doctorale Innovation thérapeutique : du fondamental à l'appliqué;;4;Chimie;2016;2015-16;2015;2015;11;7;4;42;23;19;10;4;6;;;;;jx8ET
569;École doctorale Innovation thérapeutique : du fondamental à l'appliqué;;5;Biologie, médecine et santé;2016;2015-16;2015;2015;65;36;29;253;140;113;20;12;8;;;;;jx8ET
570;École doctorale Santé Publique;EDSP;7;Sciences de la société;2016;2015-16;2015;2015;2;0;2;16;11;5;0;0;0;;;;;9lgE4
572;École doctorale Ondes et matière;EDOM;2;Physique;2016;2015-16;2015;2015;64;18;46;234;63;171;19;4;15;;;;;etSIi
573;École doctorale Interfaces : Approches Interdisciplinaires, Fondements, Applications et Innovation;ED INTERFACES;1;Mathématiques et leurs interactions;2016;2015-16;2015;2015;7;1;6;34;7;27;3;0;3;;;;;gG820
576;École doctorale Particules, Hadrons, Énergie, Noyau, Instrumentation, Imagerie, Cosmos et Simulation;PHENIICS;8;Sciences pour l'ingénieur;2016;2015-16;2015;2015;5;3;2;5;3;2;0;0;0;;;;;qC4rf
577;École doctorale Structure et dynamique des systèmes vivants;SDSV;2;Physique;2016;2015-16;2015;2015;0;0;0;1;0;1;0;0;0;;;;;4bsxJ
577;École doctorale Structure et dynamique des systèmes vivants;SDSV;10;Sciences agronomiques et écologiques;2016;2015-16;2015;2015;0;0;0;6;4;2;0;0;0;;;;;4bsxJ
579;École doctorale Sciences mécaniques et energétiques, matériaux et géosciences;SMEMaG;8;Sciences pour l'ingénieur;2016;2015-16;2015;2015;76;14;62;297;73;224;25;7;18;;;;;atMj7
581;École doctorale Agriculture, alimentation, biologie, environnement, santé;ABIES;2;Physique;2016;2015-16;2015;2015;1;1;0;3;2;1;1;1;0;;;;;c1x56
581;École doctorale Agriculture, alimentation, biologie, environnement, santé;ABIES;5;Biologie, médecine et santé;2016;2015-16;2015;2015;22;12;10;105;63;42;19;13;6;;;;;c1x56
581;École doctorale Agriculture, alimentation, biologie, environnement, santé;ABIES;7;Sciences de la société;2016;2015-16;2015;2015;6;3;3;40;24;16;9;6;3;;;;;c1x56
581;École doctorale Agriculture, alimentation, biologie, environnement, santé;ABIES;9;Sciences et technologies de l'information et de la communication;2016;2015-16;2015;2015;2;0;2;4;0;4;0;0;0;;;;;c1x56
581;École doctorale Agriculture, alimentation, biologie, environnement, santé;ABIES;10;Sciences agronomiques et écologiques;2016;2015-16;2015;2015;25;13;12;136;77;59;21;9;12;;;;;c1x56
583;École doctorale Risques et Société;;5;Biologie, médecine et santé;2016;2015-16;2015;2015;1;0;1;1;0;1;0;0;0;;;;;wUBi9
583;École doctorale Risques et Société;;9;Sciences et technologies de l'information et de la communication;2016;2015-16;2015;2015;2;1;1;2;1;1;0;0;0;;;;;wUBi9
584;École doctorale Biodiversité, Agriculture, Alimentation, Environnement, Terre, Eau;GAIA;8;Sciences pour l'ingénieur;2016;2015-16;2015;2015;16;6;10;59;26;33;0;0;0;;;;;F1h5f
584;École doctorale Biodiversité, Agriculture, Alimentation, Environnement, Terre, Eau;GAIA;10;Sciences agronomiques et écologiques;2016;2015-16;2015;2015;91;47;44;300;159;141;0;0;0;;;;;F1h5f
585;École doctorale Sciences, Technologie,  Sante;EDSTS;5;Biologie, médecine et santé;2016;2015-16;2015;2015;24;10;14;77;41;36;11;3;8;;;;;NM3Dl
587;École doctorale Diversites, santé et développement en Amazonie;;5;Biologie, médecine et santé;2016;2015-16;2015;2015;7;6;1;29;19;10;3;3;0;;;;;V14tj
587;École doctorale Diversites, santé et développement en Amazonie;;7;Sciences de la société;2016;2015-16;2015;2015;1;0;1;7;3;4;0;0;0;;;;;V14tj
8;École doctorale Histoire du droit, philosophie du droit et sociologie du droit;;7;Sciences de la société;2017;2016-17;2016;2016;8;3;5;88;37;51;6;2;4;;;;;pGSed
47;École doctorale Physique;;2;Physique;2017;2016-17;2016;2016;99;25;74;359;99;260;95;31;64;;;;;8kNpd
50;École doctorale Langues, littératures et sciences humaines;LLSH;6;Sciences humaines et humanités;2017;2016-17;2016;2016;39;29;10;204;139;65;32;21;11;;;;;8THzQ
60;École doctorale Territoires, temps, sociétés et développement;TTSD;6;Sciences humaines et humanités;2017;2016-17;2016;2016;44;27;17;190;116;74;26;11;15;;;;;fkIh6
60;École doctorale Territoires, temps, sociétés et développement;TTSD;10;Sciences agronomiques et écologiques;2017;2016-17;2016;2016;2;1;1;6;4;2;0;0;0;;;;;fkIh6
62;École doctorale Sciences de la vie et de la santé;;5;Biologie, médecine et santé;2017;2016-17;2016;2016;172;97;75;707;413;294;132;74;58;;;;;vZzE7
67;École doctorale Sciences juridiques et politiques;;9;Sciences et technologies de l'information et de la communication;2017;2016-17;2016;2016;0;0;0;3;1;2;0;0;0;;;;;qrOj1
70;École doctorale Sciences pour l'ingénieur;EDSPI;9;Sciences et technologies de l'information et de la communication;2017;2016-17;2016;2016;36;9;27;146;31;115;42;9;33;;;;;G413P
71;École doctorale Sciences pour l'ingénieur;;9;Sciences et technologies de l'information et de la communication;2017;2016-17;2016;2016;12;1;11;63;16;47;25;5;20;;;;;H6UYp
77;École doctorale Informatique, automatique, électronique, électrotechnique, mathématiques;IAEM;2;Physique;2017;2016-17;2016;2016;1;0;1;1;0;1;0;0;0;;;;;TCHTA
77;École doctorale Informatique, automatique, électronique, électrotechnique, mathématiques;IAEM;6;Sciences humaines et humanités;2017;2016-17;2016;2016;2;2;0;5;2;3;0;0;0;;;;;TCHTA
78;École doctorale Sociétés, langages, temps, connaissances;STLC;6;Sciences humaines et humanités;2017;2016-17;2016;2016;47;30;17;204;135;69;30;21;9;;;;;vLU3i
84;École doctorale Sciences et technologies de l'information et de la communication;STIC;1;Mathématiques et leurs interactions;2017;2016-17;2016;2016;0;0;0;2;1;1;0;0;0;;;;;9wS2W
86;École doctorale Sociétés, humanités, arts, lettres;LSHS;6;Sciences humaines et humanités;2017;2016-17;2016;2016;56;33;23;232;136;96;47;30;17;;;;;O8E6y
104;École doctorale Sciences de la matière, du rayonnement et de l'environnement;SMRE;6;Sciences humaines et humanités;2017;2016-17;2016;2016;1;1;0;5;2;3;2;0;2;;;;;Q5iFz
122;École doctorale Europe latine - Amérique latine;;6;Sciences humaines et humanités;2017;2016-17;2016;2016;17;11;6;133;84;49;16;10;6;;;;;z9lZY
122;École doctorale Europe latine - Amérique latine;;7;Sciences de la société;2017;2016-17;2016;2016;7;5;2;40;27;13;11;7;4;;;;;z9lZY
129;École doctorale Sciences de l'environnement d'Ile de France;SEIF;2;Physique;2017;2016-17;2016;2016;0;0;0;4;2;2;2;1;1;;;;;TnAPh
139;École doctorale Connaissance, langage, modélisation;CLM;1;Mathématiques et leurs interactions;2017;2016-17;2016;2016;2;0;2;7;1;6;2;0;2;;;;;1lxGH
146;École doctorale Galilée;GALILEE;1;Mathématiques et leurs interactions;2017;2016-17;2016;2016;11;3;8;36;5;31;6;2;4;;;;;71hqm
156;École doctorale Sciences de la mer;;3;Sciences de la terre et de l'univers, espace;2017;2016-17;2016;2016;24;7;17;68;30;38;19;12;7;;;;;EGY9P
160;École doctorale Électronique, électrotechnique, automatique;EEA;5;Biologie, médecine et santé;2017;2016-17;2016;2016;4;1;3;13;5;8;4;1;3;;;;;EgfMQ
160;École doctorale Électronique, électrotechnique, automatique;EEA;8;Sciences pour l'ingénieur;2017;2016-17;2016;2016;22;7;15;92;25;67;28;3;25;;;;;EgfMQ
160;École doctorale Électronique, électrotechnique, automatique;EEA;9;Sciences et technologies de l'information et de la communication;2017;2016-17;2016;2016;27;6;21;97;25;72;39;15;24;;;;;EgfMQ
166;École doctorale Information, structures et systèmes;I2S;1;Mathématiques et leurs interactions;2017;2016-17;2016;2016;11;3;8;46;16;30;17;2;15;;;;;2uO68
166;École doctorale Information, structures et systèmes;I2S;9;Sciences et technologies de l'information et de la communication;2017;2016-17;2016;2016;33;4;29;127;26;101;50;10;40;;;;;2uO68
166;École doctorale Information, structures et systèmes;I2S;10;Sciences agronomiques et écologiques;2017;2016-17;2016;2016;1;1;0;3;1;2;0;0;0;;;;;2uO68
178;École doctorale Sciences fondamentales;;4;Chimie;2017;2016-17;2016;2016;11;4;7;45;23;22;16;5;11;;;;;1AiR7
181;École doctorale Structure, informations, matière et matériaux;Simem;3;Sciences de la terre et de l'univers, espace;2017;2016-17;2016;2016;0;0;0;0;0;0;1;0;1;;;;;c1D6f
182;École doctorale Physique et chimie-physique;;5;Biologie, médecine et santé;2017;2016-17;2016;2016;0;0;0;3;3;0;0;0;0;;;;;3My6I
182;École doctorale Physique et chimie-physique;;9;Sciences et technologies de l'information et de la communication;2017;2016-17;2016;2016;1;0;1;3;1;2;0;0;0;;;;;3My6I
182;École doctorale Physique et chimie-physique;;10;Sciences agronomiques et écologiques;2017;2016-17;2016;2016;0;0;0;0;0;0;1;1;0;;;;;3My6I
184;École doctorale Mathématiques et informatique de Marseille;;2;Physique;2017;2016-17;2016;2016;1;0;1;1;0;1;1;1;0;;;;;DDObG
188;École doctorale Histoire moderne et contemporaine;;6;Sciences humaines et humanités;2017;2016-17;2016;2016;37;18;19;172;82;90;31;12;19;;;;;RSZ7F
205;École doctorale Interdisciplinaire Sciences-Santé;EDISS;4;Chimie;2017;2016-17;2016;2016;0;0;0;1;1;0;0;0;0;;;;;69W38
209;École doctorale Sciences physiques et de L'ingénieur;SPI;2;Physique;2017;2016-17;2016;2016;31;8;23;105;26;79;25;6;19;;;;;tZcIZ
209;École doctorale Sciences physiques et de L'ingénieur;SPI;3;Sciences de la terre et de l'univers, espace;2017;2016-17;2016;2016;2;1;1;5;2;3;2;1;1;;;;;tZcIZ
211;École doctorale Sciences exactes et leurs applications;ED SEA;4;Chimie;2017;2016-17;2016;2016;25;13;12;73;36;37;21;15;6;;;;;1G1iC
211;École doctorale Sciences exactes et leurs applications;ED SEA;5;Biologie, médecine et santé;2017;2016-17;2016;2016;2;2;0;15;10;5;6;4;2;;;;;1G1iC
216;École doctorale Ingénierie pour la santé, la cognition, l'environnement;EDISCE;3;Sciences de la terre et de l'univers, espace;2017;2016-17;2016;2016;0;0;0;1;0;1;0;0;0;;;;;fPs1t
216;École doctorale Ingénierie pour la santé, la cognition, l'environnement;EDISCE;6;Sciences humaines et humanités;2017;2016-17;2016;2016;14;10;4;51;35;16;9;6;3;;;;;fPs1t
220;École doctorale Électronique, électrotechnique, automatique, traitement du signal;EEATS;2;Physique;2017;2016-17;2016;2016;25;8;17;55;15;40;1;0;1;;;;;IxEaw
221;École doctorale Augustin Cournot - Sciences économiques et de gestion - Sciences, technologies et sociétés;EDAC;7;Sciences de la société;2017;2016-17;2016;2016;20;10;10;76;41;35;17;9;8;;;;;5z9rW
222;École doctorale Sciences chimiques;EDSC;2;Physique;2017;2016-17;2016;2016;2;1;1;9;3;6;4;1;3;;;;;AdU8Q
222;École doctorale Sciences chimiques;EDSC;4;Chimie;2017;2016-17;2016;2016;64;29;35;271;107;164;63;28;35;;;;;AdU8Q
227;École doctorale Sciences de la nature et de l'homme;;7;Sciences de la société;2017;2016-17;2016;2016;0;0;0;3;1;2;2;2;0;;;;;xiDA5
240;École doctorale Sciences de l'homme et de la société;SHS;5;Biologie, médecine et santé;2017;2016-17;2016;2016;1;1;0;8;2;6;0;0;0;;;;;j345k
251;École doctorale Sciences de l'environnement;;3;Sciences de la terre et de l'univers, espace;2017;2016-17;2016;2016;20;10;10;106;52;54;16;11;5;;;;;VR28y
251;École doctorale Sciences de l'environnement;;4;Chimie;2017;2016-17;2016;2016;8;5;3;16;11;5;3;0;3;;;;;VR28y
267;École doctorale Arts et médias;;6;Sciences humaines et humanités;2017;2016-17;2016;2016;31;24;7;287;193;94;39;28;11;;;;;eCF5C
269;École doctorale Mathématiques, sciences de l'information et de l'ingénieur;MSII;2;Physique;2017;2016-17;2016;2016;0;0;0;3;1;2;1;0;1;;;;;5E625
286;École doctorale de l'Ehess;;7;Sciences de la société;2017;2016-17;2016;2016;154;81;73;1034;586;448;121;84;37;;;;;2S146
305;École doctorale Énergie et environnement;E2;8;Sciences pour l'ingénieur;2017;2016-17;2016;2016;9;4;5;34;12;22;7;2;5;;;;;Kbt8I
309;École doctorale Systèmes;EDSYS;9;Sciences et technologies de l'information et de la communication;2017;2016-17;2016;2016;26;5;21;99;17;82;26;4;22;;;;;8TT4b
341;École doctorale Évolution, écosystèmes, microbiologie, modélisation;E2M2;5;Biologie, médecine et santé;2017;2016-17;2016;2016;22;8;14;106;49;57;26;12;14;;;;;J83I0
351;École doctorale Sciences physiques, mathématiques et de l'information pour l'ingénieur;SPMII;2;Physique;2017;2016-17;2016;2016;0;0;0;0;0;0;9;0;9;;;;;rY4EP
351;École doctorale Sciences physiques, mathématiques et de l'information pour l'ingénieur;SPMII;9;Sciences et technologies de l'information et de la communication;2017;2016-17;2016;2016;0;0;0;0;0;0;32;12;20;;;;;rY4EP
352;École doctorale Physique et sciences de la matière;;2;Physique;2017;2016-17;2016;2016;72;17;55;260;77;183;70;17;53;;;;;fb5YC
353;École doctorale Sciences pour l'ingénieur : mécanique, physique, micro et nanoélectronique;;4;Chimie;2017;2016-17;2016;2016;0;0;0;5;3;2;0;0;0;;;;;vk5Kp
361;École doctorale Sciences et Technologies;ED ST;8;Sciences pour l'ingénieur;2017;2016-17;2016;2016;8;5;3;40;11;29;12;3;9;;;;;cOUmL
364;École doctorale Sciences fondamentales et appliquées;EDSFA;8;Sciences pour l'ingénieur;2017;2016-17;2016;2016;14;6;8;54;20;34;26;7;19;;;;;E483q
370;École doctorale Lettres, sciences humaines et sociales;LSHS;6;Sciences humaines et humanités;2017;2016-17;2016;2016;34;20;14;236;137;99;30;21;9;;;;;xAXXx
373;École doctorale Santé, information/communications et mathématiques, matière;SICMA;1;Mathématiques et leurs interactions;2017;2016-17;2016;2016;3;2;1;23;10;13;3;0;3;;;;;hTJF5
373;École doctorale Santé, information/communications et mathématiques, matière;SICMA;10;Sciences agronomiques et écologiques;2017;2016-17;2016;2016;2;1;1;10;8;2;3;2;1;;;;;hTJF5
377;École doctorale Environnement et société;;9;Sciences et technologies de l'information et de la communication;2017;2016-17;2016;2016;5;1;4;10;2;8;1;0;1;;;;;ZMG5u
377;École doctorale Environnement et société;;10;Sciences agronomiques et écologiques;2017;2016-17;2016;2016;2;0;2;17;10;7;3;0;3;;;;;ZMG5u
396;École doctorale Économie, organisations, société;EOS;1;Mathématiques et leurs interactions;2017;2016-17;2016;2016;1;1;0;4;3;1;0;0;0;;;;;Es5e7
396;École doctorale Économie, organisations, société;EOS;8;Sciences pour l'ingénieur;2017;2016-17;2016;2016;0;0;0;2;2;0;0;0;0;;;;;Es5e7
396;École doctorale Économie, organisations, société;EOS;9;Sciences et technologies de l'information et de la communication;2017;2016-17;2016;2016;0;0;0;0;0;0;1;1;0;;;;;Es5e7
397;École doctorale Physique et chimie des matériaux;;2;Physique;2017;2016-17;2016;2016;30;8;22;102;34;68;38;8;30;;;;;WxSt9
398;École doctorale Géosciences, ressources naturelles et environnement;GRNE;8;Sciences pour l'ingénieur;2017;2016-17;2016;2016;0;0;0;0;0;0;1;0;1;;;;;Zi4Zf
401;École doctorale Sciences sociales;;6;Sciences humaines et humanités;2017;2016-17;2016;2016;25;12;13;158;76;82;16;7;9;;;;;raQ7K
412;École doctorale Lorraine de chimie et physique moléculaires : synthèses, expériences, simulations, applications : de la molécule aux édifices supramoléculaires;SESAMES;2;Physique;2017;2016-17;2016;2016;5;0;5;18;5;13;5;2;3;;;;;mvHX2
413;École doctorale Sciences de la terre et de l'environnement;STE;2;Physique;2017;2016-17;2016;2016;0;0;0;0;0;0;2;1;1;;;;;u9BA9
414;École doctorale Sciences de la vie et de la santé;;2;Physique;2017;2016-17;2016;2016;1;0;1;2;1;1;1;1;0;;;;;YI4xS
414;École doctorale Sciences de la vie et de la santé;;5;Biologie, médecine et santé;2017;2016-17;2016;2016;127;81;46;530;293;237;116;69;47;;;;;YI4xS
414;École doctorale Sciences de la vie et de la santé;;6;Sciences humaines et humanités;2017;2016-17;2016;2016;0;0;0;3;0;3;1;1;0;;;;;YI4xS
414;École doctorale Sciences de la vie et de la santé;;10;Sciences agronomiques et écologiques;2017;2016-17;2016;2016;4;2;2;16;7;9;4;2;2;;;;;YI4xS
417;École doctorale Sciences et Ingénierie;S&I;2;Physique;2017;2016-17;2016;2016;3;1;2;6;2;4;0;0;0;;;;;SSBvE
433;École doctorale Concepts et langages;;6;Sciences humaines et humanités;2017;2016-17;2016;2016;88;47;41;466;255;211;50;26;24;;;;;v8q34
446;École doctorale Biologie - Santé;EDBSL;1;Mathématiques et leurs interactions;2017;2016-17;2016;2016;0;0;0;0;0;0;1;0;1;;;;;4iEUF
455;École doctorale Économie, Gestion, Information et Communication;EGIC;7;Sciences de la société;2017;2016-17;2016;2016;19;5;14;78;33;45;15;7;8;;;;;qCOg3
459;École doctorale Sciences chimiques Balard;;4;Chimie;2017;2016-17;2016;2016;85;32;53;227;91;136;84;36;48;;;;;YFs2W
465;École doctorale Économie Panthéon Sorbonne;EPS;7;Sciences de la société;2017;2016-17;2016;2016;67;25;42;317;132;185;60;25;35;;;;;MV68S
467;École doctorale Aéronautique, astronautique;AA;6;Sciences humaines et humanités;2017;2016-17;2016;2016;2;0;2;9;1;8;2;0;2;;;;;U7l45
469;École doctorale du Pacifique;EDP;1;Mathématiques et leurs interactions;2017;2016-17;2016;2016;1;0;1;1;0;1;0;0;0;;;;;t9Z2n
469;École doctorale du Pacifique;EDP;2;Physique;2017;2016-17;2016;2016;1;0;1;2;1;1;0;0;0;;;;;t9Z2n
469;École doctorale du Pacifique;EDP;4;Chimie;2017;2016-17;2016;2016;1;0;1;6;3;3;3;2;1;;;;;t9Z2n
469;École doctorale du Pacifique;EDP;8;Sciences pour l'ingénieur;2017;2016-17;2016;2016;1;0;1;2;0;2;0;0;0;;;;;t9Z2n
469;École doctorale du Pacifique;EDP;9;Sciences et technologies de l'information et de la communication;2017;2016-17;2016;2016;0;0;0;2;0;2;1;0;1;;;;;t9Z2n
474;École doctorale Interdisciplinaire européenne frontières du vivant;FDV;6;Sciences humaines et humanités;2017;2016-17;2016;2016;4;3;1;8;5;3;0;0;0;;;;;E727j
476;École doctorale Neurosciences et cognition;NSCO;5;Biologie, médecine et santé;2017;2016-17;2016;2016;33;20;13;116;64;52;25;12;13;;;;;B1H0x
480;École doctorale Montaigne-humanités;;6;Sciences humaines et humanités;2017;2016-17;2016;2016;124;67;57;565;353;212;60;39;21;;;;;f3SeZ
483;École doctorale Histoire, géographie, aménagement, urbanisme, archéologie, science politique, sociologie, anthropologie;SCSO;6;Sciences humaines et humanités;2017;2016-17;2016;2016;105;59;46;560;290;270;69;34;35;;;;;hc6u4
484;École doctorale Lettres, langues, linguistique, arts;3LA;6;Sciences humaines et humanités;2017;2016-17;2016;2016;77;48;29;513;319;194;78;49;29;;;;;BlCQD
485;École doctorale Éducation, Psychologie, Information et Communication;EPIC;7;Sciences de la société;2017;2016-17;2016;2016;0;0;0;1;0;1;0;0;0;;;;;O82eL
488;École doctorale Sciences, ingénierie, santé;SIS;4;Chimie;2017;2016-17;2016;2016;3;3;0;13;7;6;5;3;2;;;;;Fy2lK
489;École doctorale Sciences et ingénierie des systèmes, de l'environnement et des organisations;SISEO;7;Sciences de la société;2017;2016-17;2016;2016;8;5;3;41;26;15;10;7;3;;;;;6pT77
489;École doctorale Sciences et ingénierie des systèmes, de l'environnement et des organisations;SISEO;8;Sciences pour l'ingénieur;2017;2016-17;2016;2016;14;5;9;60;18;42;10;2;8;;;;;6pT77
493;École doctorale Erasme;;7;Sciences de la société;2017;2016-17;2016;2016;35;15;20;209;93;116;23;9;14;;;;;FPW4T
497;École doctorale Normande de Biologie Intégrative, Santé, Environnement;Ed NBISE;6;Sciences humaines et humanités;2017;2016-17;2016;2016;3;3;0;6;5;1;1;0;1;;;;;0D9Je
500;École doctorale Matière, molécules, matériaux en Pays de Loire;3MPL;8;Sciences pour l'ingénieur;2017;2016-17;2016;2016;2;0;2;6;0;6;1;0;1;;;;;822tM
500;École doctorale Matière, molécules, matériaux en Pays de Loire;3MPL;10;Sciences agronomiques et écologiques;2017;2016-17;2016;2016;0;0;0;1;0;1;0;0;0;;;;;822tM
502;École doctorale Biologie - Santé;;2;Physique;2017;2016-17;2016;2016;0;0;0;0;0;0;1;1;0;;;;;JCFV7
502;École doctorale Biologie - Santé;;5;Biologie, médecine et santé;2017;2016-17;2016;2016;94;53;41;328;178;150;77;40;37;;;;;JCFV7
503;École doctorale Sciences et technologies de l'information et de mathématiques;STIM;4;Chimie;2017;2016-17;2016;2016;0;0;0;1;0;1;0;0;0;;;;;JQevP
503;École doctorale Sciences et technologies de l'information et de mathématiques;STIM;8;Sciences pour l'ingénieur;2017;2016-17;2016;2016;11;6;5;26;9;17;2;0;2;;;;;JQevP
504;École doctorale Cognition, éducation, interactions;CEI;7;Sciences de la société;2017;2016-17;2016;2016;0;0;0;1;0;1;0;0;0;;;;;39naT
514;École doctorale Études anglophones, germanophones et européennes;EDEAGE;6;Sciences humaines et humanités;2017;2016-17;2016;2016;27;19;8;147;113;34;26;22;4;;;;;fuIQs
519;École doctorale Sciences humaines et sociales - Perspectives européennes;SHS-PE;6;Sciences humaines et humanités;2017;2016-17;2016;2016;55;33;22;250;150;100;25;7;18;;;;;2f5qs
520;École doctorale Humanités;;6;Sciences humaines et humanités;2017;2016-17;2016;2016;62;30;32;343;203;140;52;24;28;;;;;rI175
521;École doctorale Sciences et ingénierie pour l'information, mathématiques;S2I;2;Physique;2017;2016-17;2016;2016;3;1;2;26;4;22;6;1;5;;;;;V6i83
523;École doctorale Sciences pour l'environnement - Gay Lussac;;3;Sciences de la terre et de l'univers, espace;2017;2016-17;2016;2016;8;1;7;25;9;16;8;3;5;;;;;6xD69
523;École doctorale Sciences pour l'environnement - Gay Lussac;;4;Chimie;2017;2016-17;2016;2016;17;5;12;74;24;50;28;16;12;;;;;6xD69
528;École doctorale Ville, transports et territoires;VTT;6;Sciences humaines et humanités;2017;2016-17;2016;2016;29;20;9;120;62;58;17;9;8;;;;;68zCc
528;École doctorale Ville, transports et territoires;VTT;7;Sciences de la société;2017;2016-17;2016;2016;6;1;5;54;31;23;3;1;2;;;;;68zCc
528;École doctorale Ville, transports et territoires;VTT;8;Sciences pour l'ingénieur;2017;2016-17;2016;2016;4;2;2;21;7;14;2;1;1;;;;;68zCc
529;École doctorale Cultures et sociétés;CS;6;Sciences humaines et humanités;2017;2016-17;2016;2016;46;20;26;251;137;114;42;26;16;;;;;XU9tb
532;École doctorale Mathématiques et sciences et technologies de l'information et de la communication;MSTIC;9;Sciences et technologies de l'information et de la communication;2017;2016-17;2016;2016;50;8;42;147;34;113;34;9;25;;;;;t43KM
536;École doctorale Sciences et agrosciences;;4;Chimie;2017;2016-17;2016;2016;4;2;2;18;11;7;4;1;3;;;;;pHfqe
540;"École doctorale École transdisciplinaire ""lettres/sciences""";;2;Physique;2017;2016-17;2016;2016;1;0;1;2;1;1;0;0;0;;;;;tWWw7
540;"École doctorale École transdisciplinaire ""lettres/sciences""";;6;Sciences humaines et humanités;2017;2016-17;2016;2016;35;21;14;143;76;67;5;0;5;;;;;tWWw7
540;"École doctorale École transdisciplinaire ""lettres/sciences""";;9;Sciences et technologies de l'information et de la communication;2017;2016-17;2016;2016;0;0;0;2;0;2;0;0;0;;;;;tWWw7
541;École doctorale de sciences humaines et sociales de La Réunion;SHS;6;Sciences humaines et humanités;2017;2016-17;2016;2016;33;17;16;157;79;78;14;9;5;;;;;21SpE
547;École doctorale Sciences, Technologie, Santé;EDSTS;1;Mathématiques et leurs interactions;2017;2016-17;2016;2016;2;0;2;8;2;6;3;2;1;;;;;wEdn2
547;École doctorale Sciences, Technologie, Santé;EDSTS;3;Sciences de la terre et de l'univers, espace;2017;2016-17;2016;2016;1;1;0;6;3;3;3;0;3;;;;;wEdn2
547;École doctorale Sciences, Technologie, Santé;EDSTS;10;Sciences agronomiques et écologiques;2017;2016-17;2016;2016;4;2;2;28;10;18;3;1;2;;;;;wEdn2
548;École doctorale Mer et Sciences;;4;Chimie;2017;2016-17;2016;2016;5;3;2;18;8;10;6;2;4;;;;;QX0fS
548;École doctorale Mer et Sciences;;5;Biologie, médecine et santé;2017;2016-17;2016;2016;2;1;1;9;3;6;2;0;2;;;;;QX0fS
549;École doctorale Santé, Sciences Biologiques et Chimie du Vivant;SSBCV;1;Mathématiques et leurs interactions;2017;2016-17;2016;2016;0;0;0;0;0;0;1;1;0;;;;;B9ggO
552;École doctorale Énergie - Matériaux - Sciences de la Terre et de l'Univers;EMTSU;8;Sciences pour l'ingénieur;2017;2016-17;2016;2016;23;5;18;93;19;74;20;5;15;;;;;NTZhw
552;École doctorale Énergie - Matériaux - Sciences de la Terre et de l'Univers;EMTSU;9;Sciences et technologies de l'information et de la communication;2017;2016-17;2016;2016;2;0;2;4;1;3;3;0;3;;;;;NTZhw
553;École doctorale Carnot - Pasteur;;4;Chimie;2017;2016-17;2016;2016;21;10;11;89;26;63;18;5;13;;;;;6h4Z7
560;École doctorale Sciences de la terre et de l'environnement et Physique de l'univers, Paris;STEP'UP;2;Physique;2017;2016-17;2016;2016;6;2;4;21;6;15;5;0;5;;;;;Z2VI9
561;École doctorale Hématologie, Oncogenèse et Biothérapies;HOB;5;Biologie, médecine et santé;2017;2016-17;2016;2016;47;31;16;193;118;75;45;29;16;;;;;7Klb2
563;École doctorale Médicament - Toxicologie - Chimie - Imageries;MTCI;5;Biologie, médecine et santé;2017;2016-17;2016;2016;47;19;28;167;85;82;37;22;15;;;;;j8uk1
566;École doctorale Sciences du Sport, de la Motricité et du Mouvement Humain;SMMH;8;Sciences pour l'ingénieur;2017;2016-17;2016;2016;2;1;1;2;1;1;0;0;0;;;;;3iv8y
567;École doctorale Sciences du Végétal : du gène à l'écosystème;;10;Sciences agronomiques et écologiques;2017;2016-17;2016;2016;2;1;1;9;4;5;1;1;0;;;;;tuDkA
571;École doctorale Sciences Chimiques : Molécules, Matériaux, Instrumentation et Biosystemes;2MIB;4;Chimie;2017;2016-17;2016;2016;78;32;46;290;134;156;77;46;31;;;;;zbi37
573;École doctorale Interfaces : Approches Interdisciplinaires, Fondements, Applications et Innovation;ED INTERFACES;2;Physique;2017;2016-17;2016;2016;25;6;19;99;32;67;31;9;22;;;;;gG820
575;École doctorale Electrical, Optical, Bio : Physics and Engineering;EOBE;5;Biologie, médecine et santé;2017;2016-17;2016;2016;3;1;2;4;2;2;0;0;0;;;;;dfhyn
576;École doctorale Particules, Hadrons, Énergie, Noyau, Instrumentation, Imagerie, Cosmos et Simulation;PHENIICS;3;Sciences de la terre et de l'univers, espace;2017;2016-17;2016;2016;3;1;2;4;2;2;1;1;0;;;;;qC4rf
579;École doctorale Sciences mécaniques et energétiques, matériaux et géosciences;SMEMaG;2;Physique;2017;2016-17;2016;2016;11;3;8;41;12;29;7;3;4;;;;;atMj7
580;École doctorale Sciences et technologies de l'information et de la communication;STIC;9;Sciences et technologies de l'information et de la communication;2017;2016-17;2016;2016;170;50;120;662;184;478;131;38;93;;;;;AzCC0
581;École doctorale Agriculture, alimentation, biologie, environnement, santé;ABIES;1;Mathématiques et leurs interactions;2017;2016-17;2016;2016;2;1;1;12;4;8;4;1;3;;;;;c1x56
581;École doctorale Agriculture, alimentation, biologie, environnement, santé;ABIES;3;Sciences de la terre et de l'univers, espace;2017;2016-17;2016;2016;1;1;0;4;3;1;0;0;0;;;;;c1x56
581;École doctorale Agriculture, alimentation, biologie, environnement, santé;ABIES;5;Biologie, médecine et santé;2017;2016-17;2016;2016;21;15;6;98;57;41;30;17;13;;;;;c1x56
581;École doctorale Agriculture, alimentation, biologie, environnement, santé;ABIES;7;Sciences de la société;2017;2016-17;2016;2016;2;1;1;29;16;13;9;6;3;;;;;c1x56
583;École doctorale Risques et Société;;5;Biologie, médecine et santé;2017;2016-17;2016;2016;0;0;0;1;0;1;0;0;0;;;;;wUBi9
583;École doctorale Risques et Société;;6;Sciences humaines et humanités;2017;2016-17;2016;2016;2;1;1;10;4;6;1;0;1;;;;;wUBi9
583;École doctorale Risques et Société;;7;Sciences de la société;2017;2016-17;2016;2016;3;1;2;4;2;2;0;0;0;;;;;wUBi9
585;École doctorale Sciences, Technologie,  Sante;EDSTS;5;Biologie, médecine et santé;2017;2016-17;2016;2016;24;11;13;97;47;50;11;5;6;;;;;NM3Dl
585;École doctorale Sciences, Technologie,  Sante;EDSTS;8;Sciences pour l'ingénieur;2017;2016-17;2016;2016;8;2;6;34;13;21;7;1;6;;;;;NM3Dl
587;École doctorale Diversites, santé et développement en Amazonie;;3;Sciences de la terre et de l'univers, espace;2017;2016-17;2016;2016;3;2;1;12;10;2;1;0;1;;;;;V14tj
587;École doctorale Diversites, santé et développement en Amazonie;;8;Sciences pour l'ingénieur;2017;2016-17;2016;2016;2;1;1;3;1;2;1;0;1;;;;;V14tj
587;École doctorale Diversites, santé et développement en Amazonie;;10;Sciences agronomiques et écologiques;2017;2016-17;2016;2016;1;1;0;4;1;3;0;0;0;;;;;V14tj
589;École doctorale Milieu insulaire tropical à risques : protection, valorisation , santé et développement;;5;Biologie, médecine et santé;2017;2016-17;2016;2016;6;4;2;46;28;18;9;7;2;;;;;2cqi3
589;École doctorale Milieu insulaire tropical à risques : protection, valorisation , santé et développement;;9;Sciences et technologies de l'information et de la communication;2017;2016-17;2016;2016;2;0;2;3;0;3;0;0;0;;;;;2cqi3
589;École doctorale Milieu insulaire tropical à risques : protection, valorisation , santé et développement;;10;Sciences agronomiques et écologiques;2017;2016-17;2016;2016;1;1;0;5;2;3;1;1;0;;;;;2cqi3
591;École doctorale Physique, Sciences de l'Ingenieur, Materiaux, Énergie;PSIME;3;Sciences de la terre et de l'univers, espace;2017;2016-17;2016;2016;1;0;1;8;4;4;0;0;0;;;;;Hn5Om
591;École doctorale Physique, Sciences de l'Ingenieur, Materiaux, Énergie;PSIME;4;Chimie;2017;2016-17;2016;2016;8;3;5;26;8;18;0;0;0;;;;;Hn5Om
591;École doctorale Physique, Sciences de l'Ingenieur, Materiaux, Énergie;PSIME;9;Sciences et technologies de l'information et de la communication;2017;2016-17;2016;2016;4;2;2;22;8;14;0;0;0;;;;;Hn5Om
592;École doctorale Lettres, Communication, Langues, Arts;LECLA;6;Sciences humaines et humanités;2017;2016-17;2016;2016;39;25;14;187;117;70;0;0;0;;;;;sY7f3
34;École doctorale Matériaux;;2;Physique;2022;2021-22;2021;2021;14;5;9;40;17;23;6;3;3;4;2;0;0;1Iufh
37;École doctorale Sciences physiques pour l'ingénieur et microtechniques;SPIM;8;Sciences pour l'ingénieur;2022;2021-22;2021;2021;53;14;39;186;50;136;34;10;24;16;15;3;0;F7G1B
47;École doctorale Physique;;4;Chimie;2022;2021-22;2021;2021;1;1;0;3;2;1;0;0;0;0;0;0;0;8kNpd
52;École doctorale Physique et astrophysique de Lyon;PHAST;2;Physique;2022;2021-22;2021;2021;58;13;45;197;50;147;60;15;45;51;6;2;1;61XPb
62;École doctorale Sciences de la vie et de la santé;;5;Biologie, médecine et santé;2022;2021-22;2021;2021;182;118;64;711;420;291;170;98;72;55;87;27;1;vZzE7
71;École doctorale Sciences pour l'ingénieur;;5;Biologie, médecine et santé;2022;2021-22;2021;2021;3;1;2;11;3;8;3;2;1;0;3;0;0;H6UYp
71;École doctorale Sciences pour l'ingénieur;;6;Sciences humaines et humanités;2022;2021-22;2021;2021;2;0;2;17;8;9;3;1;2;1;0;1;1;H6UYp
71;École doctorale Sciences pour l'ingénieur;;10;Sciences agronomiques et écologiques;2022;2021-22;2021;2021;0;0;0;6;5;1;0;0;0;0;0;0;0;H6UYp
74;École doctorale Sciences juridiques, politique et de gestion;SJPG;7;Sciences de la société;2022;2021-22;2021;2021;38;26;12;240;126;114;23;15;8;2;2;5;14;3A2RY
79;École doctorale Sciences juridiques, politiques, économiques et de gestion;SJPEG;7;Sciences de la société;2022;2021-22;2021;2021;37;18;19;190;96;94;29;16;13;3;10;9;7;ea4x6
84;École doctorale Sciences et technologies de l'information et de la communication;STIC;1;Mathématiques et leurs interactions;2022;2021-22;2021;2021;1;0;1;3;1;2;0;0;0;0;0;0;0;9wS2W
84;École doctorale Sciences et technologies de l'information et de la communication;STIC;9;Sciences et technologies de l'information et de la communication;2022;2021-22;2021;2021;58;11;47;215;57;158;55;16;39;21;28;4;2;9wS2W
86;École doctorale Sociétés, humanités, arts, lettres;LSHS;5;Biologie, médecine et santé;2022;2021-22;2021;2021;1;1;0;1;1;0;0;0;0;0;0;0;0;O8E6y
86;École doctorale Sociétés, humanités, arts, lettres;LSHS;7;Sciences de la société;2022;2021-22;2021;2021;7;3;4;25;13;12;4;3;1;0;2;2;0;O8E6y
101;École doctorale de Sciences juridiques;;7;Sciences de la société;2022;2021-22;2021;2021;33;13;20;191;89;102;36;14;22;1;6;9;20;569G2
104;École doctorale Sciences de la matière, du rayonnement et de l'environnement;SMRE;3;Sciences de la terre et de l'univers, espace;2022;2021-22;2021;2021;13;7;6;42;22;20;8;4;4;4;4;0;0;Q5iFz
104;École doctorale Sciences de la matière, du rayonnement et de l'environnement;SMRE;4;Chimie;2022;2021-22;2021;2021;47;15;32;190;78;112;49;24;25;29;20;0;0;Q5iFz
113;École doctorale Histoire;;6;Sciences humaines et humanités;2022;2021-22;2021;2021;43;17;26;270;127;143;27;14;13;3;4;8;12;G5wHs
120;École doctorale Littérature française et comparée;;6;Sciences humaines et humanités;2022;2021-22;2021;2021;25;20;5;218;153;65;33;27;6;5;7;7;14;3ULpe
129;École doctorale Sciences de l'environnement d'Ile de France;SEIF;7;Sciences de la société;2022;2021-22;2021;2021;0;0;0;1;0;1;0;0;0;0;0;0;0;TnAPh
139;École doctorale Connaissance, langage, modélisation;CLM;7;Sciences de la société;2022;2021-22;2021;2021;2;1;1;5;4;1;0;0;0;0;0;0;0;1lxGH
146;École doctorale Galilée;GALILEE;1;Mathématiques et leurs interactions;2022;2021-22;2021;2021;11;4;7;39;10;29;8;3;5;5;1;2;0;71hqm
146;École doctorale Galilée;GALILEE;9;Sciences et technologies de l'information et de la communication;2022;2021-22;2021;2021;16;5;11;55;17;38;18;5;13;13;4;1;0;71hqm
160;École doctorale Électronique, électrotechnique, automatique;EEA;8;Sciences pour l'ingénieur;2022;2021-22;2021;2021;8;1;7;52;11;41;11;4;7;6;4;1;0;EgfMQ
166;École doctorale Information, structures et systèmes;I2S;2;Physique;2022;2021-22;2021;2021;17;5;12;65;19;46;17;6;11;11;6;0;0;2uO68
166;École doctorale Information, structures et systèmes;I2S;7;Sciences de la société;2022;2021-22;2021;2021;0;0;0;0;0;0;1;0;1;0;0;1;0;2uO68
171;École doctorale Toulouse sciences économiques;TSE;7;Sciences de la société;2022;2021-22;2021;2021;12;4;8;92;29;63;17;4;13;0;0;10;7;Q5nNQ
173;École doctorale Sciences de l'univers, de l'environnement et de l'espace;SDU2E;3;Sciences de la terre et de l'univers, espace;2022;2021-22;2021;2021;70;24;46;246;91;155;55;18;37;30;21;4;0;R0Z9c
178;École doctorale Sciences fondamentales;;1;Mathématiques et leurs interactions;2022;2021-22;2021;2021;6;0;6;18;2;16;7;0;7;4;2;0;1;1AiR7
182;École doctorale Physique et chimie-physique;;8;Sciences pour l'ingénieur;2022;2021-22;2021;2021;3;1;2;3;1;2;0;0;0;0;0;0;0;3My6I
209;École doctorale Sciences physiques et de L'ingénieur;SPI;3;Sciences de la terre et de l'univers, espace;2022;2021-22;2021;2021;5;2;3;11;3;8;2;0;2;2;0;0;0;tZcIZ
211;École doctorale Sciences exactes et leurs applications;ED SEA;5;Biologie, médecine et santé;2022;2021-22;2021;2021;1;1;0;3;1;2;11;7;4;5;5;1;0;1G1iC
211;École doctorale Sciences exactes et leurs applications;ED SEA;10;Sciences agronomiques et écologiques;2022;2021-22;2021;2021;9;6;3;29;17;12;1;1;0;1;0;0;0;1G1iC
216;École doctorale Ingénierie pour la santé, la cognition, l'environnement;EDISCE;9;Sciences et technologies de l'information et de la communication;2022;2021-22;2021;2021;3;1;2;12;9;3;1;0;1;0;0;1;0;fPs1t
217;École doctorale Mathématiques, sciences et technologies de l'information, informatique;MSTII;6;Sciences humaines et humanités;2022;2021-22;2021;2021;1;0;1;1;0;1;0;0;0;0;0;0;0;Ehx7v
220;École doctorale Électronique, électrotechnique, automatique, traitement du signal;EEATS;1;Mathématiques et leurs interactions;2022;2021-22;2021;2021;1;0;1;7;1;6;2;1;1;2;0;0;0;IxEaw
220;École doctorale Électronique, électrotechnique, automatique, traitement du signal;EEATS;3;Sciences de la terre et de l'univers, espace;2022;2021-22;2021;2021;1;1;0;1;1;0;0;0;0;0;0;0;0;IxEaw
222;École doctorale Sciences chimiques;EDSC;8;Sciences pour l'ingénieur;2022;2021-22;2021;2021;0;0;0;1;0;1;0;0;0;0;0;0;0;AdU8Q
224;École doctorale Cognition, langage, interaction;;1;Mathématiques et leurs interactions;2022;2021-22;2021;2021;1;0;1;12;3;9;2;1;1;0;1;1;0;7v43e
224;École doctorale Cognition, langage, interaction;;8;Sciences pour l'ingénieur;2022;2021-22;2021;2021;1;1;0;13;8;5;2;2;0;0;1;1;0;7v43e
234;École doctorale de Sciences Po;;6;Sciences humaines et humanités;2022;2021-22;2021;2021;8;4;4;37;18;19;9;3;6;1;1;5;2;ux756
242;École doctorale Économie - Gestion - Normandie;;7;Sciences de la société;2022;2021-22;2021;2021;15;5;10;75;27;48;16;10;6;3;2;6;5;z35ku
251;École doctorale Sciences de l'environnement;;8;Sciences pour l'ingénieur;2022;2021-22;2021;2021;6;3;3;16;10;6;3;2;1;2;1;0;0;VR28y
279;École doctorale Arts plastiques, esthétique et sciences de l'art;APESA;6;Sciences humaines et humanités;2022;2021-22;2021;2021;29;19;10;157;109;48;16;10;6;2;1;5;8;BpW1j
305;École doctorale Énergie et environnement;E2;4;Chimie;2022;2021-22;2021;2021;5;3;2;13;8;5;3;2;1;1;2;0;0;Kbt8I
323;École doctorale Génie électrique, électronique et télécommunications;GEET;2;Physique;2022;2021-22;2021;2021;6;0;6;15;3;12;0;0;0;0;0;0;0;arcz6
323;École doctorale Génie électrique, électronique et télécommunications;GEET;5;Biologie, médecine et santé;2022;2021-22;2021;2021;1;0;1;5;3;2;4;1;3;2;1;0;1;arcz6
326;École doctorale Comportement, langage, éducation, socialisation, cognition;CLESCO;7;Sciences de la société;2022;2021-22;2021;2021;2;1;1;11;8;3;0;0;0;0;0;0;0;nWIlG
327;École doctorale Temps, espaces, sociétés, cultures;TESC;3;Sciences de la terre et de l'univers, espace;2022;2021-22;2021;2021;1;0;1;4;2;2;0;0;0;0;0;0;0;IjgiJ
327;École doctorale Temps, espaces, sociétés, cultures;TESC;8;Sciences pour l'ingénieur;2022;2021-22;2021;2021;0;0;0;3;2;1;2;0;2;0;1;1;0;IjgiJ
328;École doctorale Arts, lettres, langues, philosophie et communication;ALLPH@;5;Biologie, médecine et santé;2022;2021-22;2021;2021;0;0;0;1;1;0;0;0;0;0;0;0;0;xLxMh
341;École doctorale Évolution, écosystèmes, microbiologie, modélisation;E2M2;3;Sciences de la terre et de l'univers, espace;2022;2021-22;2021;2021;0;0;0;1;1;0;2;1;1;0;1;1;0;J83I0
352;École doctorale Physique et sciences de la matière;;2;Physique;2022;2021-22;2021;2021;71;14;57;242;78;164;76;16;60;46;29;1;0;fb5YC
355;École doctorale Espaces, cultures, sociétés;;6;Sciences humaines et humanités;2022;2021-22;2021;2021;31;20;11;187;96;91;29;14;15;1;4;16;8;2kMf5
361;École doctorale Sciences et Technologies;ED ST;2;Physique;2022;2021-22;2021;2021;6;4;2;44;19;25;8;4;4;4;1;3;0;cOUmL
364;École doctorale Sciences fondamentales et appliquées;EDSFA;2;Physique;2022;2021-22;2021;2021;20;7;13;74;13;61;16;2;14;12;4;0;0;E483q
364;École doctorale Sciences fondamentales et appliquées;EDSFA;3;Sciences de la terre et de l'univers, espace;2022;2021-22;2021;2021;15;8;7;62;21;41;15;5;10;9;3;2;1;E483q
377;École doctorale Environnement et société;;3;Sciences de la terre et de l'univers, espace;2022;2021-22;2021;2021;1;0;1;2;1;1;1;1;0;0;1;0;0;ZMG5u
377;École doctorale Environnement et société;;7;Sciences de la société;2022;2021-22;2021;2021;7;5;2;37;26;11;5;4;1;0;3;1;1;ZMG5u
377;École doctorale Environnement et société;;10;Sciences agronomiques et écologiques;2022;2021-22;2021;2021;2;1;1;9;6;3;2;0;2;0;1;0;1;ZMG5u
394;École doctorale Physiologie et physiopathologie;p2t;5;Biologie, médecine et santé;2022;2021-22;2021;2021;65;47;18;231;141;90;51;27;24;21;26;3;1;VMYmT
398;École doctorale Géosciences, ressources naturelles et environnement;GRNE;1;Mathématiques et leurs interactions;2022;2021-22;2021;2021;1;0;1;4;1;3;0;0;0;0;0;0;0;Zi4Zf
398;École doctorale Géosciences, ressources naturelles et environnement;GRNE;2;Physique;2022;2021-22;2021;2021;0;0;0;2;0;2;1;1;0;0;1;0;0;Zi4Zf
401;École doctorale Sciences sociales;;7;Sciences de la société;2022;2021-22;2021;2021;25;12;13;164;84;80;21;8;13;1;4;3;13;raQ7K
402;École doctorale Sciences de la vie et de la santé;SVS;4;Chimie;2022;2021-22;2021;2021;1;0;1;1;0;1;0;0;0;0;0;0;0;YKgsU
405;École doctorale Économie, management,mathématiques et physique de Cergy;EM2C;7;Sciences de la société;2022;2021-22;2021;2021;16;5;11;85;37;48;13;4;9;2;7;2;2;QbwSB
405;École doctorale Économie, management,mathématiques et physique de Cergy;EM2C;9;Sciences et technologies de l'information et de la communication;2022;2021-22;2021;2021;20;8;12;53;12;41;12;5;7;6;3;2;1;QbwSB
413;École doctorale Sciences de la terre et de l'environnement;STE;3;Sciences de la terre et de l'univers, espace;2022;2021-22;2021;2021;13;6;7;54;20;34;10;3;7;2;6;0;2;u9BA9
417;École doctorale Sciences et Ingénierie;S&I;8;Sciences pour l'ingénieur;2022;2021-22;2021;2021;13;6;7;56;21;35;14;5;9;6;6;0;2;SSBvE
432;École doctorale Sciences des métiers de l'ingénieur;SMI;2;Physique;2022;2021-22;2021;2021;0;0;0;2;1;1;0;0;0;0;0;0;0;nSsHB
432;École doctorale Sciences des métiers de l'ingénieur;SMI;5;Biologie, médecine et santé;2022;2021-22;2021;2021;0;0;0;1;0;1;1;0;1;1;0;0;0;nSsHB
446;École doctorale Biologie - Santé;EDBSL;1;Mathématiques et leurs interactions;2022;2021-22;2021;2021;1;0;1;4;2;2;0;0;0;0;0;0;0;4iEUF
446;École doctorale Biologie - Santé;EDBSL;5;Biologie, médecine et santé;2022;2021-22;2021;2021;80;47;33;345;207;138;74;36;38;32;29;13;0;4iEUF
463;École doctorale Sciences du mouvement humain;SMH;8;Sciences pour l'ingénieur;2022;2021-22;2021;2021;11;2;9;42;13;29;13;6;7;2;6;4;1;UbtlY
465;École doctorale Économie Panthéon Sorbonne;EPS;1;Mathématiques et leurs interactions;2022;2021-22;2021;2021;8;3;5;20;4;16;4;1;3;2;0;1;1;MV68S
467;École doctorale Aéronautique, astronautique;AA;8;Sciences pour l'ingénieur;2022;2021-22;2021;2021;7;2;5;30;7;23;5;2;3;2;3;0;0;U7l45
469;École doctorale du Pacifique;EDP;9;Sciences et technologies de l'information et de la communication;2022;2021-22;2021;2021;2;0;2;4;1;3;2;0;2;0;0;2;0;t9Z2n
472;École doctorale de l'EPHE;;1;Mathématiques et leurs interactions;2022;2021-22;2021;2021;2;0;2;3;0;3;0;0;0;0;0;0;0;27zK4
472;École doctorale de l'EPHE;;10;Sciences agronomiques et écologiques;2022;2021-22;2021;2021;4;3;1;10;8;2;1;0;1;0;1;0;0;27zK4
478;École doctorale Sciences de Gestion;;7;Sciences de la société;2022;2021-22;2021;2021;16;10;6;61;37;24;10;6;4;3;3;4;0;q34kB
479;École doctorale Sciences juridiques et politiques;;7;Sciences de la société;2022;2021-22;2021;2021;50;27;23;269;140;129;35;12;23;0;4;12;19;34mid
481;École doctorale Sciences sociales et humanités;SSH;6;Sciences humaines et humanités;2022;2021-22;2021;2021;21;10;11;119;61;58;15;7;8;5;2;2;6;E3z5j
483;École doctorale Histoire, géographie, aménagement, urbanisme, archéologie, science politique, sociologie, anthropologie;SCSO;6;Sciences humaines et humanités;2022;2021-22;2021;2021;57;39;18;348;194;154;37;19;18;5;3;11;18;hc6u4
488;École doctorale Sciences, ingénierie, santé;SIS;5;Biologie, médecine et santé;2022;2021-22;2021;2021;21;12;9;87;40;47;19;8;11;10;5;4;0;Fy2lK
489;École doctorale Sciences et ingénierie des systèmes, de l'environnement et des organisations;SISEO;4;Chimie;2022;2021-22;2021;2021;0;0;0;0;0;0;2;2;0;0;2;0;0;6pT77
489;École doctorale Sciences et ingénierie des systèmes, de l'environnement et des organisations;SISEO;10;Sciences agronomiques et écologiques;2022;2021-22;2021;2021;0;0;0;0;0;0;2;0;2;0;1;1;0;6pT77
497;École doctorale Normande de Biologie Intégrative, Santé, Environnement;Ed NBISE;3;Sciences de la terre et de l'univers, espace;2022;2021-22;2021;2021;2;0;2;12;2;10;0;0;0;0;0;0;0;0D9Je
512;École doctorale Informatique et mathématiques;InfoMaths;9;Sciences et technologies de l'information et de la communication;2022;2021-22;2021;2021;43;8;35;195;43;152;41;11;30;21;19;1;0;t86bi
515;École doctorale Complexité du vivant;CdV;5;Biologie, médecine et santé;2022;2021-22;2021;2021;98;54;44;312;180;132;79;53;26;19;60;0;0;CbV9s
520;École doctorale Humanités;;6;Sciences humaines et humanités;2022;2021-22;2021;2021;43;27;16;246;159;87;36;22;14;3;6;16;11;rI175
528;École doctorale Ville, transports et territoires;VTT;5;Biologie, médecine et santé;2022;2021-22;2021;2021;0;0;0;1;1;0;0;0;0;0;0;0;0;68zCc
528;École doctorale Ville, transports et territoires;VTT;7;Sciences de la société;2022;2021-22;2021;2021;14;3;11;56;27;29;2;0;2;0;2;0;0;68zCc
531;École doctorale Sciences, ingénierie et environnement;SIE;1;Mathématiques et leurs interactions;2022;2021-22;2021;2021;0;0;0;5;2;3;0;0;0;0;0;0;0;b5BYq
531;École doctorale Sciences, ingénierie et environnement;SIE;2;Physique;2022;2021-22;2021;2021;14;4;10;30;7;23;4;0;4;2;1;1;0;b5BYq
531;École doctorale Sciences, ingénierie et environnement;SIE;8;Sciences pour l'ingénieur;2022;2021-22;2021;2021;43;10;33;150;45;105;38;14;24;13;22;3;0;b5BYq
536;École doctorale Sciences et agrosciences;;3;Sciences de la terre et de l'univers, espace;2022;2021-22;2021;2021;2;0;2;8;4;4;2;0;2;1;1;0;0;pHfqe
536;École doctorale Sciences et agrosciences;;4;Chimie;2022;2021-22;2021;2021;2;0;2;12;7;5;5;2;3;3;2;0;0;pHfqe
536;École doctorale Sciences et agrosciences;;10;Sciences agronomiques et écologiques;2022;2021-22;2021;2021;9;4;5;44;22;22;16;6;10;7;9;0;0;pHfqe
540;"École doctorale École transdisciplinaire ""lettres/sciences""";;6;Sciences humaines et humanités;2022;2021-22;2021;2021;46;23;23;207;92;115;29;15;14;3;8;11;7;tWWw7
543;École doctorale de Dauphine;;7;Sciences de la société;2022;2021-22;2021;2021;77;37;40;291;136;155;43;19;24;7;16;17;3;u8w6A
546;École doctorale Abbé Grégoire;;6;Sciences humaines et humanités;2022;2021-22;2021;2021;61;39;22;220;127;93;17;9;8;3;3;1;10;ZSn7q
548;École doctorale Mer et Sciences;;2;Physique;2022;2021-22;2021;2021;0;0;0;2;0;2;1;0;1;1;0;0;0;QX0fS
548;École doctorale Mer et Sciences;;5;Biologie, médecine et santé;2022;2021-22;2021;2021;1;0;1;8;5;3;0;0;0;0;0;0;0;QX0fS
548;École doctorale Mer et Sciences;;8;Sciences pour l'ingénieur;2022;2021-22;2021;2021;2;0;2;3;0;3;3;1;2;3;0;0;0;QX0fS
548;École doctorale Mer et Sciences;;9;Sciences et technologies de l'information et de la communication;2022;2021-22;2021;2021;4;2;2;20;5;15;7;2;5;2;3;2;0;QX0fS
551;École doctorale Mathématiques, Informatique, Physique Théorique et Ingénierie des Systèmes;MIPTIS;1;Mathématiques et leurs interactions;2022;2021-22;2021;2021;8;1;7;25;7;18;9;1;8;4;3;2;0;Mpudz
551;École doctorale Mathématiques, Informatique, Physique Théorique et Ingénierie des Systèmes;MIPTIS;8;Sciences pour l'ingénieur;2022;2021-22;2021;2021;4;1;3;19;8;11;3;0;3;1;2;0;0;Mpudz
552;École doctorale Énergie - Matériaux - Sciences de la Terre et de l'Univers;EMTSU;8;Sciences pour l'ingénieur;2022;2021-22;2021;2021;27;8;19;116;31;85;19;6;13;8;10;1;0;NTZhw
553;École doctorale Carnot - Pasteur;;3;Sciences de la terre et de l'univers, espace;2022;2021-22;2021;2021;1;0;1;3;2;1;0;0;0;0;0;0;0;6h4Z7
559;École doctorale Management Panthéon-Sorbonne;;1;Mathématiques et leurs interactions;2022;2021-22;2021;2021;2;1;1;11;5;6;3;1;2;0;2;1;0;4SP7k
559;École doctorale Management Panthéon-Sorbonne;;7;Sciences de la société;2022;2021-22;2021;2021;43;29;14;174;94;80;27;16;11;4;11;10;2;4SP7k
560;École doctorale Sciences de la terre et de l'environnement et Physique de l'univers, Paris;STEP'UP;2;Physique;2022;2021-22;2021;2021;27;6;21;71;15;56;22;6;16;22;0;0;0;Z2VI9
561;École doctorale Hématologie, Oncogenèse et Biothérapies;HOB;5;Biologie, médecine et santé;2022;2021-22;2021;2021;56;36;20;205;123;82;62;43;19;20;31;10;1;7Klb2
566;École doctorale Sciences du Sport, de la Motricité et du Mouvement Humain;SMMH;7;Sciences de la société;2022;2021-22;2021;2021;2;2;0;4;2;2;5;3;2;1;1;1;2;3iv8y
566;École doctorale Sciences du Sport, de la Motricité et du Mouvement Humain;SMMH;8;Sciences pour l'ingénieur;2022;2021-22;2021;2021;3;0;3;4;1;3;0;0;0;0;0;0;0;3iv8y
567;École doctorale Sciences du Végétal : du gène à l'écosystème;;5;Biologie, médecine et santé;2022;2021-22;2021;2021;14;8;6;48;24;24;16;8;8;6;8;1;1;tuDkA
569;École doctorale Innovation thérapeutique : du fondamental à l'appliqué;;4;Chimie;2022;2021-22;2021;2021;10;7;3;39;23;16;12;8;4;4;7;1;0;jx8ET
569;École doctorale Innovation thérapeutique : du fondamental à l'appliqué;;5;Biologie, médecine et santé;2022;2021-22;2021;2021;80;48;32;250;149;101;46;25;21;20;21;5;0;jx8ET
570;École doctorale Santé Publique;EDSP;1;Mathématiques et leurs interactions;2022;2021-22;2021;2021;3;1;2;5;1;4;0;0;0;0;0;0;0;9lgE4
570;École doctorale Santé Publique;EDSP;7;Sciences de la société;2022;2021-22;2021;2021;1;0;1;3;1;2;0;0;0;0;0;0;0;9lgE4
571;École doctorale Sciences Chimiques : Molécules, Matériaux, Instrumentation et Biosystemes;2MIB;3;Sciences de la terre et de l'univers, espace;2022;2021-22;2021;2021;1;0;1;1;0;1;0;0;0;0;0;0;0;zbi37
573;École doctorale Interfaces : Approches Interdisciplinaires, Fondements, Applications et Innovation;ED INTERFACES;8;Sciences pour l'ingénieur;2022;2021-22;2021;2021;17;7;10;52;20;32;10;3;7;2;6;2;0;gG820
575;École doctorale Electrical, Optical, Bio : Physics and Engineering;EOBE;1;Mathématiques et leurs interactions;2022;2021-22;2021;2021;1;0;1;2;0;2;0;0;0;0;0;0;0;dfhyn
575;École doctorale Electrical, Optical, Bio : Physics and Engineering;EOBE;8;Sciences pour l'ingénieur;2022;2021-22;2021;2021;36;12;24;151;40;111;30;3;27;10;17;3;0;dfhyn
576;École doctorale Particules, Hadrons, Énergie, Noyau, Instrumentation, Imagerie, Cosmos et Simulation;PHENIICS;2;Physique;2022;2021-22;2021;2021;62;16;46;195;55;140;45;12;33;34;11;0;0;qC4rf
576;École doctorale Particules, Hadrons, Énergie, Noyau, Instrumentation, Imagerie, Cosmos et Simulation;PHENIICS;8;Sciences pour l'ingénieur;2022;2021-22;2021;2021;0;0;0;0;0;0;3;0;3;3;0;0;0;qC4rf
577;École doctorale Structure et dynamique des systèmes vivants;SDSV;5;Biologie, médecine et santé;2022;2021-22;2021;2021;62;34;28;237;136;101;49;30;19;10;33;6;0;4bsxJ
580;École doctorale Sciences et technologies de l'information et de la communication;STIC;1;Mathématiques et leurs interactions;2022;2021-22;2021;2021;6;3;3;15;6;9;1;0;1;0;1;0;0;AzCC0
580;École doctorale Sciences et technologies de l'information et de la communication;STIC;8;Sciences pour l'ingénieur;2022;2021-22;2021;2021;10;3;7;22;4;18;7;1;6;4;3;0;0;AzCC0
580;École doctorale Sciences et technologies de l'information et de la communication;STIC;9;Sciences et technologies de l'information et de la communication;2022;2021-22;2021;2021;160;37;123;500;120;380;109;28;81;47;52;10;0;AzCC0
583;École doctorale Risques et Société;;1;Mathématiques et leurs interactions;2022;2021-22;2021;2021;1;0;1;1;0;1;0;0;0;0;0;0;0;wUBi9
583;École doctorale Risques et Société;;5;Biologie, médecine et santé;2022;2021-22;2021;2021;1;1;0;5;4;1;1;0;1;1;0;0;0;wUBi9
583;École doctorale Risques et Société;;6;Sciences humaines et humanités;2022;2021-22;2021;2021;4;3;1;24;14;10;2;1;1;1;0;1;0;wUBi9
583;École doctorale Risques et Société;;7;Sciences de la société;2022;2021-22;2021;2021;3;1;2;9;3;6;2;1;1;0;1;1;0;wUBi9
583;École doctorale Risques et Société;;8;Sciences pour l'ingénieur;2022;2021-22;2021;2021;1;0;1;1;0;1;0;0;0;0;0;0;0;wUBi9
585;École doctorale Sciences, Technologie,  Sante;EDSTS;3;Sciences de la terre et de l'univers, espace;2022;2021-22;2021;2021;0;0;0;3;2;1;4;3;1;3;1;0;0;NM3Dl
586;École doctorale Sciences Humaines et Sociales;EDSHS;6;Sciences humaines et humanités;2022;2021-22;2021;2021;84;50;34;359;201;158;37;22;15;8;8;11;10;0RKVX
587;École doctorale Diversites, santé et développement en Amazonie;;6;Sciences humaines et humanités;2022;2021-22;2021;2021;1;1;0;14;12;2;3;1;2;0;1;0;2;V14tj
587;École doctorale Diversites, santé et développement en Amazonie;;8;Sciences pour l'ingénieur;2022;2021-22;2021;2021;0;0;0;4;1;3;2;1;1;0;0;2;0;V14tj
589;École doctorale Milieu insulaire tropical à risques : protection, valorisation , santé et développement;;2;Physique;2022;2021-22;2021;2021;1;1;0;7;2;5;2;0;2;1;1;0;0;2cqi3
589;École doctorale Milieu insulaire tropical à risques : protection, valorisation , santé et développement;;3;Sciences de la terre et de l'univers, espace;2022;2021-22;2021;2021;0;0;0;2;1;1;3;1;2;0;1;1;1;2cqi3
589;École doctorale Milieu insulaire tropical à risques : protection, valorisation , santé et développement;;5;Biologie, médecine et santé;2022;2021-22;2021;2021;13;7;6;53;36;17;8;5;3;2;4;1;1;2cqi3
589;École doctorale Milieu insulaire tropical à risques : protection, valorisation , santé et développement;;9;Sciences et technologies de l'information et de la communication;2022;2021-22;2021;2021;0;0;0;2;1;1;2;0;2;1;1;0;0;2cqi3
593;École doctorale Droit, Gestion, sciences Économiques et Politique;DGEP;7;Sciences de la société;2022;2021-22;2021;2021;47;18;29;236;94;142;26;10;16;5;4;9;8;41pAm
594;École doctorale Sociétés, Espaces, Pratiques, Temps;ED SEPT;6;Sciences humaines et humanités;2022;2021-22;2021;2021;58;26;32;273;142;131;54;16;38;6;9;15;24;N85H3
594;École doctorale Sociétés, Espaces, Pratiques, Temps;ED SEPT;7;Sciences de la société;2022;2021-22;2021;2021;13;3;10;46;23;23;13;4;9;4;3;0;6;N85H3
595;École doctorale Arts, Lettres, Langues;ED ALL;6;Sciences humaines et humanités;2022;2021-22;2021;2021;58;43;15;361;246;115;45;28;17;2;6;16;21;a8f9b
596;École doctorale Matière, Molécules et Matériaux;ED 3M;2;Physique;2022;2021-22;2021;2021;56;22;34;178;59;119;58;27;31;37;13;7;1;77947
598;École doctorale Sciences de La Mer et du Littoral;SML;4;Chimie;2022;2021-22;2021;2021;0;0;0;7;3;4;0;0;0;0;0;0;0;Smen6
599;École doctorale Droit et Science Politique;DSP;6;Sciences humaines et humanités;2022;2021-22;2021;2021;1;1;0;1;1;0;0;0;0;0;0;0;0;6rwtT
599;École doctorale Droit et Science Politique;DSP;7;Sciences de la société;2022;2021-22;2021;2021;48;24;24;350;173;177;38;18;20;1;1;11;25;6rwtT
601;École doctorale Mathématiques et Sciences et Technologies de l'information et de la Communication;MathSTIC;1;Mathématiques et leurs interactions;2022;2021-22;2021;2021;51;14;37;149;32;117;37;5;32;25;11;1;0;3Ue20
604;École doctorale Sociétés, Temps, Territoires;STT;10;Sciences agronomiques et écologiques;2022;2021-22;2021;2021;1;0;1;2;1;1;0;0;0;0;0;0;0;SZI5T
606;École doctorale Chimie - Mécanique - Matériaux - Physique;C2MP;4;Chimie;2022;2021-22;2021;2021;15;3;12;58;25;33;15;9;6;9;4;2;0;UkNR2
606;École doctorale Chimie - Mécanique - Matériaux - Physique;C2MP;8;Sciences pour l'ingénieur;2022;2021-22;2021;2021;29;6;23;128;36;92;25;11;14;11;11;3;0;UkNR2
608;École doctorale Sciences et Ingénierie des Molécules, des Produits, des Procédés et de l'Énergie;SIMPPÉ;4;Chimie;2022;2021-22;2021;2021;2;2;0;8;5;3;1;0;1;1;0;0;0;TyNjM
610;École doctorale Sciences et Ingénierie des Systèmes, Mathématiques, Informatique;SISMI;1;Mathématiques et leurs interactions;2022;2021-22;2021;2021;7;3;4;33;10;23;10;1;9;3;4;3;0;dBCUB
610;École doctorale Sciences et Ingénierie des Systèmes, Mathématiques, Informatique;SISMI;8;Sciences pour l'ingénieur;2022;2021-22;2021;2021;18;3;15;55;18;37;17;6;11;7;10;0;0;dBCUB
618;École doctorale EUCLIDE;;1;Mathématiques et leurs interactions;2022;2021-22;2021;2021;1;1;0;10;2;8;0;0;0;0;0;0;0;qveTN
618;École doctorale EUCLIDE;;4;Chimie;2022;2021-22;2021;2021;10;6;4;22;10;12;4;3;1;2;2;0;0;qveTN
618;École doctorale EUCLIDE;;7;Sciences de la société;2022;2021-22;2021;2021;7;3;4;37;15;22;2;0;2;1;0;1;0;qveTN
620;École doctorale Sciences du Numérique et de l'Ingénieur;SNI;4;Chimie;2022;2021-22;2021;2021;0;0;0;2;1;1;0;0;0;0;0;0;0;Dr40w
623;École doctorale Savoir, Sciences, Éducation;SSE;1;Mathématiques et leurs interactions;2022;2021-22;2021;2021;2;0;2;14;9;5;6;3;3;2;1;2;1;98lMD
623;École doctorale Savoir, Sciences, Éducation;SSE;6;Sciences humaines et humanités;2022;2021-22;2021;2021;15;11;4;58;36;22;7;1;6;1;3;3;0;98lMD
625;École doctorale Mondes Anglophones, Germanophones, Iraniens, Indiens, et Études Européennes;MAGIIE;6;Sciences humaines et humanités;2022;2021-22;2021;2021;26;12;14;140;86;54;13;13;0;3;5;3;2;JiOMD
626;École doctorale de l’Institut Polytechnique de Paris;;1;Mathématiques et leurs interactions;2022;2021-22;2021;2021;10;3;7;37;4;33;5;3;2;2;3;0;0;DL5fO
626;École doctorale de l’Institut Polytechnique de Paris;;7;Sciences de la société;2022;2021-22;2021;2021;25;13;12;109;48;61;25;9;16;2;12;11;0;DL5fO
627;École doctorale Éducation, Didactiques, Cognition;EDC;6;Sciences humaines et humanités;2022;2021-22;2021;2021;18;12;6;79;55;24;9;6;3;1;2;4;2;dE3nH
631;École doctorale Mathématiques, sciences du numérique et de leurs interactions;MADIS;9;Sciences et technologies de l'information et de la communication;2022;2021-22;2021;2021;50;17;33;196;52;144;34;9;25;22;10;2;0;OImap
632;École doctorale Science de l’ingénierie et des systèmes;ENGSYS;8;Sciences pour l'ingénieur;2022;2021-22;2021;2021;42;8;34;167;48;119;39;10;29;26;11;2;0;1jT2e
633;École doctorale Cultures, Sociétés, Territoires;CST;6;Sciences humaines et humanités;2022;2021-22;2021;2021;10;9;1;49;25;24;3;0;3;1;1;0;1;54818
634;École doctorale Sciences, Ingénierie, Environnement;SIE;4;Chimie;2022;2021-22;2021;2021;2;2;0;9;5;4;0;0;0;0;0;0;0;TOc8f
634;École doctorale Sciences, Ingénierie, Environnement;SIE;5;Biologie, médecine et santé;2022;2021-22;2021;2021;2;0;2;7;3;4;0;0;0;0;0;0;0;TOc8f
634;École doctorale Sciences, Ingénierie, Environnement;SIE;8;Sciences pour l'ingénieur;2022;2021-22;2021;2021;14;6;8;56;26;30;5;3;2;4;1;0;0;TOc8f
634;École doctorale Sciences, Ingénierie, Environnement;SIE;10;Sciences agronomiques et écologiques;2022;2021-22;2021;2021;4;1;3;7;3;4;1;1;0;1;0;0;0;TOc8f
635;École doctorale Polytechnique Hauts-de-France;PHF;4;Chimie;2022;2021-22;2021;2021;2;1;1;6;2;4;5;2;3;2;3;0;0;p2m23
635;École doctorale Polytechnique Hauts-de-France;PHF;5;Biologie, médecine et santé;2022;2021-22;2021;2021;3;0;3;3;0;3;0;0;0;0;0;0;0;p2m23
635;École doctorale Polytechnique Hauts-de-France;PHF;6;Sciences humaines et humanités;2022;2021-22;2021;2021;15;9;6;99;53;46;5;2;3;1;2;0;2;p2m23
6;École doctorale Droit privé;;7;Sciences de la société;2020;2019-20;2019;2019;43;15;28;284;135;149;21;10;11;;;;;UMnW1
31;École doctorale Pratiques et théories du sens;;6;Sciences humaines et humanités;2020;2019-20;2019;2019;65;34;31;391;214;177;32;13;19;;;;;1S466
34;École doctorale Matériaux;;8;Sciences pour l'ingénieur;2020;2019-20;2019;2019;21;8;13;109;47;62;31;12;19;;;;;1Iufh
39;École doctorale Mathématiques et Informatique;EDMIB;1;Mathématiques et leurs interactions;2020;2019-20;2019;2019;30;13;17;95;27;68;21;6;15;;;;;TBj2X
42;École doctorale Entreprise, économie, société;EES;7;Sciences de la société;2020;2019-20;2019;2019;25;15;10;115;48;67;21;6;15;;;;;uO01d
47;École doctorale Physique;;1;Mathématiques et leurs interactions;2020;2019-20;2019;2019;1;0;1;1;0;1;0;0;0;;;;;8kNpd
50;École doctorale Langues, littératures et sciences humaines;LLSH;6;Sciences humaines et humanités;2020;2019-20;2019;2019;34;23;11;181;133;48;23;11;12;;;;;8THzQ
60;École doctorale Territoires, temps, sociétés et développement;TTSD;6;Sciences humaines et humanités;2020;2019-20;2019;2019;53;30;23;207;125;82;35;22;13;;;;;fkIh6
67;École doctorale Sciences juridiques et politiques;;7;Sciences de la société;2020;2019-20;2019;2019;83;46;37;475;231;244;56;23;33;;;;;qrOj1
70;École doctorale Sciences pour l'ingénieur;EDSPI;8;Sciences pour l'ingénieur;2020;2019-20;2019;2019;21;11;10;113;27;86;41;11;30;;;;;G413P
71;École doctorale Sciences pour l'ingénieur;;6;Sciences humaines et humanités;2020;2019-20;2019;2019;2;2;0;18;10;8;3;1;2;;;;;H6UYp
71;École doctorale Sciences pour l'ingénieur;;9;Sciences et technologies de l'information et de la communication;2020;2019-20;2019;2019;11;2;9;46;10;36;16;2;14;;;;;H6UYp
73;École doctorale Sciences économiques, sociales, de l'aménagement et du management;SESAM;7;Sciences de la société;2020;2019-20;2019;2019;46;21;25;176;81;95;32;13;19;;;;;IQ0Hk
74;École doctorale Sciences juridiques, politique et de gestion;SJPG;7;Sciences de la société;2020;2019-20;2019;2019;66;24;42;270;132;138;23;8;15;;;;;3A2RY
77;École doctorale Informatique, automatique, électronique, électrotechnique, mathématiques;IAEM;9;Sciences et technologies de l'information et de la communication;2020;2019-20;2019;2019;74;23;51;276;74;202;66;21;45;;;;;TCHTA
78;École doctorale Sociétés, langages, temps, connaissances;STLC;6;Sciences humaines et humanités;2020;2019-20;2019;2019;47;30;17;197;120;77;14;10;4;;;;;vLU3i
79;École doctorale Sciences juridiques, politiques, économiques et de gestion;SJPEG;7;Sciences de la société;2020;2019-20;2019;2019;41;17;24;178;91;87;25;10;15;;;;;ea4x6
86;École doctorale Sociétés, humanités, arts, lettres;LSHS;7;Sciences de la société;2020;2019-20;2019;2019;6;4;2;28;14;14;3;3;0;;;;;O8E6y
98;École doctorale Droit-Normandie;EDDN;7;Sciences de la société;2020;2019-20;2019;2019;26;8;18;131;57;74;24;11;13;;;;;9fYyW
104;École doctorale Sciences de la matière, du rayonnement et de l'environnement;SMRE;5;Biologie, médecine et santé;2020;2019-20;2019;2019;1;0;1;7;5;2;2;2;0;;;;;Q5iFz
104;École doctorale Sciences de la matière, du rayonnement et de l'environnement;SMRE;8;Sciences pour l'ingénieur;2020;2019-20;2019;2019;8;1;7;13;2;11;0;0;0;;;;;Q5iFz
112;École doctorale Archéologie;;6;Sciences humaines et humanités;2020;2019-20;2019;2019;29;19;10;185;116;69;27;13;14;;;;;EvU7R
122;École doctorale Europe latine - Amérique latine;;6;Sciences humaines et humanités;2020;2019-20;2019;2019;10;7;3;100;69;31;16;11;5;;;;;z9lZY
127;École doctorale Astronomie et astrophysique d'Ile de France;A&A;3;Sciences de la terre et de l'univers, espace;2020;2019-20;2019;2019;48;11;37;149;45;104;50;12;38;;;;;cPXrq
129;École doctorale Sciences de l'environnement d'Ile de France;SEIF;8;Sciences pour l'ingénieur;2020;2019-20;2019;2019;1;1;0;1;1;0;0;0;0;;;;;TnAPh
129;École doctorale Sciences de l'environnement d'Ile de France;SEIF;10;Sciences agronomiques et écologiques;2020;2019-20;2019;2019;0;0;0;2;1;1;1;1;0;;;;;TnAPh
139;École doctorale Connaissance, langage, modélisation;CLM;1;Mathématiques et leurs interactions;2020;2019-20;2019;2019;2;1;1;7;1;6;0;0;0;;;;;1lxGH
146;École doctorale Galilée;GALILEE;5;Biologie, médecine et santé;2020;2019-20;2019;2019;14;10;4;61;36;25;18;11;7;;;;;71hqm
158;École doctorale Cerveau, cognition, comportement;3C;5;Biologie, médecine et santé;2020;2019-20;2019;2019;72;46;26;298;162;136;81;47;34;;;;;Il62F
162;École doctorale Mécanique, énergétique, génie civil, acoustique;MEGA;2;Physique;2020;2019-20;2019;2019;0;0;0;4;2;2;0;0;0;;;;;7wCke
162;École doctorale Mécanique, énergétique, génie civil, acoustique;MEGA;5;Biologie, médecine et santé;2020;2019-20;2019;2019;14;3;11;40;14;26;4;2;2;;;;;7wCke
162;École doctorale Mécanique, énergétique, génie civil, acoustique;MEGA;8;Sciences pour l'ingénieur;2020;2019-20;2019;2019;71;23;48;400;108;292;101;20;81;;;;;7wCke
178;École doctorale Sciences fondamentales;;2;Physique;2020;2019-20;2019;2019;10;5;5;15;6;9;9;1;8;;;;;1AiR7
180;École doctorale Sciences humaines et sociales : cultures, individus, sociétés;SHS;7;Sciences de la société;2020;2019-20;2019;2019;0;0;0;0;0;0;3;1;2;;;;;D2BT3
182;École doctorale Physique et chimie-physique;;4;Chimie;2020;2019-20;2019;2019;28;12;16;109;48;61;24;16;8;;;;;3My6I
182;École doctorale Physique et chimie-physique;;5;Biologie, médecine et santé;2020;2019-20;2019;2019;0;0;0;4;2;2;1;1;0;;;;;3My6I
182;École doctorale Physique et chimie-physique;;8;Sciences pour l'ingénieur;2020;2019-20;2019;2019;0;0;0;1;0;1;2;1;1;;;;;3My6I
205;École doctorale Interdisciplinaire Sciences-Santé;EDISS;5;Biologie, médecine et santé;2020;2019-20;2019;2019;49;30;19;255;140;115;66;32;34;;;;;69W38
205;École doctorale Interdisciplinaire Sciences-Santé;EDISS;6;Sciences humaines et humanités;2020;2019-20;2019;2019;2;1;1;13;6;7;2;2;0;;;;;69W38
206;École doctorale Chimie : chimie, procédés, environnement;;4;Chimie;2020;2019-20;2019;2019;80;39;41;342;163;179;83;46;37;;;;;m0UhD
209;École doctorale Sciences physiques et de L'ingénieur;SPI;2;Physique;2020;2019-20;2019;2019;27;7;20;102;18;84;33;7;26;;;;;tZcIZ
211;École doctorale Sciences exactes et leurs applications;ED SEA;2;Physique;2020;2019-20;2019;2019;3;0;3;13;7;6;4;4;0;;;;;1G1iC
216;École doctorale Ingénierie pour la santé, la cognition, l'environnement;EDISCE;4;Chimie;2020;2019-20;2019;2019;0;0;0;1;0;1;1;1;0;;;;;fPs1t
216;École doctorale Ingénierie pour la santé, la cognition, l'environnement;EDISCE;5;Biologie, médecine et santé;2020;2019-20;2019;2019;33;12;21;116;52;64;26;10;16;;;;;fPs1t
216;École doctorale Ingénierie pour la santé, la cognition, l'environnement;EDISCE;10;Sciences agronomiques et écologiques;2020;2019-20;2019;2019;1;0;1;3;1;2;1;0;1;;;;;fPs1t
216;École doctorale Ingénierie pour la santé, la cognition, l'environnement;EDISCE;2;Physique;2020;2019-20;2019;2019;0;0;0;3;0;3;3;0;3;;;;;fPs1t
217;École doctorale Mathématiques, sciences et technologies de l'information, informatique;MSTII;9;Sciences et technologies de l'information et de la communication;2020;2019-20;2019;2019;60;13;47;243;60;183;56;12;44;;;;;Ehx7v
218;École doctorale Chimie et sciences du vivant;EDCSV;5;Biologie, médecine et santé;2020;2019-20;2019;2019;57;36;21;195;120;75;46;24;22;;;;;8bcJh
221;École doctorale Augustin Cournot - Sciences économiques et de gestion - Sciences, technologies et sociétés;EDAC;7;Sciences de la société;2020;2019-20;2019;2019;20;7;13;92;41;51;24;15;9;;;;;5z9rW
222;École doctorale Sciences chimiques;EDSC;8;Sciences pour l'ingénieur;2020;2019-20;2019;2019;3;1;2;8;4;4;3;2;1;;;;;AdU8Q
224;École doctorale Cognition, langage, interaction;;1;Mathématiques et leurs interactions;2020;2019-20;2019;2019;5;2;3;9;4;5;0;0;0;;;;;7v43e
224;École doctorale Cognition, langage, interaction;;8;Sciences pour l'ingénieur;2020;2019-20;2019;2019;4;3;1;12;7;5;2;2;0;;;;;7v43e
227;École doctorale Sciences de la nature et de l'homme;;4;Chimie;2020;2019-20;2019;2019;1;0;1;4;2;2;1;1;0;;;;;xiDA5
227;École doctorale Sciences de la nature et de l'homme;;10;Sciences agronomiques et écologiques;2020;2019-20;2019;2019;33;13;20;113;57;56;29;14;15;;;;;xiDA5
231;École doctorale Économie et gestion;EDEG;7;Sciences de la société;2020;2019-20;2019;2019;38;21;17;178;88;90;27;13;14;;;;;KT720
234;École doctorale de Sciences Po;;6;Sciences humaines et humanités;2020;2019-20;2019;2019;58;31;27;317;160;157;61;23;38;;;;;ux756
242;École doctorale Économie - Gestion - Normandie;;6;Sciences humaines et humanités;2020;2019-20;2019;2019;14;6;8;88;46;42;9;4;5;;;;;z35ku
251;École doctorale Sciences de l'environnement;;3;Sciences de la terre et de l'univers, espace;2020;2019-20;2019;2019;26;14;12;83;36;47;21;12;9;;;;;VR28y
251;École doctorale Sciences de l'environnement;;6;Sciences humaines et humanités;2020;2019-20;2019;2019;0;0;0;11;8;3;3;2;1;;;;;VR28y
262;École doctorale Sciences juridiques, politiques, économiques et de gestion;DEG;7;Sciences de la société;2020;2019-20;2019;2019;37;15;22;174;82;92;20;9;11;;;;;H7GyL
266;École doctorale Biologie, santé, environnement;BIOSE;5;Biologie, médecine et santé;2020;2019-20;2019;2019;41;24;17;130;73;57;40;29;11;;;;;386V9
268;École doctorale Langage et langues : description, théorisation, transmission;;6;Sciences humaines et humanités;2020;2019-20;2019;2019;0;0;0;0;0;0;19;11;8;;;;;wAIDE
269;École doctorale Mathématiques, sciences de l'information et de l'ingénieur;MSII;8;Sciences pour l'ingénieur;2020;2019-20;2019;2019;37;14;23;149;42;107;37;11;26;;;;;5E625
284;École doctorale Droit et Science Politique;DSP;6;Sciences humaines et humanités;2020;2019-20;2019;2019;79;49;30;282;165;117;25;10;15;;;;;ahH92
305;École doctorale Énergie et environnement;E2;5;Biologie, médecine et santé;2020;2019-20;2019;2019;10;2;8;29;15;14;8;6;2;;;;;Kbt8I
323;École doctorale Génie électrique, électronique et télécommunications;GEET;9;Sciences et technologies de l'information et de la communication;2020;2019-20;2019;2019;12;3;9;55;7;48;21;3;18;;;;;arcz6
327;École doctorale Temps, espaces, sociétés, cultures;TESC;3;Sciences de la terre et de l'univers, espace;2020;2019-20;2019;2019;1;1;0;4;3;1;1;1;0;;;;;IjgiJ
327;École doctorale Temps, espaces, sociétés, cultures;TESC;7;Sciences de la société;2020;2019-20;2019;2019;13;12;1;93;59;34;15;11;4;;;;;IjgiJ
328;École doctorale Arts, lettres, langues, philosophie et communication;ALLPH@;5;Biologie, médecine et santé;2020;2019-20;2019;2019;0;0;0;1;1;0;0;0;0;;;;;xLxMh
341;École doctorale Évolution, écosystèmes, microbiologie, modélisation;E2M2;3;Sciences de la terre et de l'univers, espace;2020;2019-20;2019;2019;0;0;0;5;2;3;0;0;0;;;;;J83I0
355;École doctorale Espaces, cultures, sociétés;;7;Sciences de la société;2020;2019-20;2019;2019;16;11;5;63;39;24;16;11;5;;;;;2kMf5
356;École doctorale Cognition, langage, éducation;;6;Sciences humaines et humanités;2020;2019-20;2019;2019;71;42;29;222;134;88;44;27;17;;;;;55Cpz
361;École doctorale Sciences et Technologies;ED ST;8;Sciences pour l'ingénieur;2020;2019-20;2019;2019;12;3;9;38;14;24;5;1;4;;;;;cOUmL
361;École doctorale Sciences et Technologies;ED ST;9;Sciences et technologies de l'information et de la communication;2020;2019-20;2019;2019;37;16;21;131;54;77;27;10;17;;;;;cOUmL
364;École doctorale Sciences fondamentales et appliquées;EDSFA;1;Mathématiques et leurs interactions;2020;2019-20;2019;2019;14;1;13;59;10;49;13;5;8;;;;;E483q
364;École doctorale Sciences fondamentales et appliquées;EDSFA;4;Chimie;2020;2019-20;2019;2019;19;9;10;57;26;31;8;7;1;;;;;E483q
364;École doctorale Sciences fondamentales et appliquées;EDSFA;8;Sciences pour l'ingénieur;2020;2019-20;2019;2019;18;7;11;71;18;53;14;6;8;;;;;E483q
364;École doctorale Sciences fondamentales et appliquées;EDSFA;10;Sciences agronomiques et écologiques;2020;2019-20;2019;2019;1;0;1;3;0;3;1;1;0;;;;;E483q
377;École doctorale Environnement et société;;4;Chimie;2020;2019-20;2019;2019;2;0;2;6;1;5;1;1;0;;;;;ZMG5u
377;École doctorale Environnement et société;;7;Sciences de la société;2020;2019-20;2019;2019;9;6;3;39;28;11;6;2;4;;;;;ZMG5u
382;École doctorale Économie, espaces, sociétés, civilisations : pensée critique, politique et pratique sociale;EESC;7;Sciences de la société;2020;2019-20;2019;2019;0;0;0;0;0;0;8;4;4;;;;;9NI1W
386;École doctorale Sciences mathématiques de Paris centre;SMPC;1;Mathématiques et leurs interactions;2020;2019-20;2019;2019;35;4;31;130;16;114;36;7;29;;;;;wMj98
388;École doctorale Chimie physique et chimie analytique de Paris centre;CPCA;4;Chimie;2020;2019-20;2019;2019;74;31;43;307;136;171;71;29;42;;;;;M0Hnd
396;École doctorale Économie, organisations, société;EOS;7;Sciences de la société;2020;2019-20;2019;2019;25;13;12;129;62;67;13;7;6;;;;;Es5e7
397;École doctorale Physique et chimie des matériaux;;2;Physique;2020;2019-20;2019;2019;23;15;8;97;34;63;25;6;19;;;;;WxSt9
398;École doctorale Géosciences, ressources naturelles et environnement;GRNE;3;Sciences de la terre et de l'univers, espace;2020;2019-20;2019;2019;35;10;25;157;51;106;35;13;22;;;;;Zi4Zf
400;École doctorale Savoirs scientifiques : épistémologie, histoire des sciences, didactique des disciplines;;7;Sciences de la société;2020;2019-20;2019;2019;0;0;0;0;0;0;2;1;1;;;;;nRax3
405;École doctorale Économie, management,mathématiques et physique de Cergy;EM2C;9;Sciences et technologies de l'information et de la communication;2020;2019-20;2019;2019;14;3;11;47;13;34;12;4;8;;;;;QbwSB
413;École doctorale Sciences de la terre et de l'environnement;STE;3;Sciences de la terre et de l'univers, espace;2020;2019-20;2019;2019;10;5;5;58;21;37;17;7;10;;;;;u9BA9
433;École doctorale Concepts et langages;;1;Mathématiques et leurs interactions;2020;2019-20;2019;2019;27;15;12;106;46;60;13;3;10;;;;;v8q34
450;École doctorale Recherches en psychanalyse et psychopathologie;PSY²;6;Sciences humaines et humanités;2020;2019-20;2019;2019;27;15;12;191;123;68;26;20;6;;;;;8jI3f
458;École doctorale Sciences écologiques, vétérinaires, agronomiques et bioingénieries;SEVAB;10;Sciences agronomiques et écologiques;2020;2019-20;2019;2019;54;29;25;256;138;118;53;26;27;;;;;Yf3TI
459;École doctorale Sciences chimiques Balard;;5;Biologie, médecine et santé;2020;2019-20;2019;2019;1;0;1;4;2;2;0;0;0;;;;;YFs2W
461;École doctorale Droit et science politique;;7;Sciences de la société;2020;2019-20;2019;2019;62;29;33;276;144;132;33;17;16;;;;;QGArN
463;École doctorale Sciences du mouvement humain;SMH;6;Sciences humaines et humanités;2020;2019-20;2019;2019;4;2;2;18;12;6;3;3;0;;;;;UbtlY
469;École doctorale du Pacifique;EDP;7;Sciences de la société;2020;2019-20;2019;2019;4;2;2;20;10;10;1;0;1;;;;;t9Z2n
469;École doctorale du Pacifique;EDP;10;Sciences agronomiques et écologiques;2020;2019-20;2019;2019;6;5;1;18;12;6;5;3;2;;;;;t9Z2n
472;École doctorale de l'EPHE;;6;Sciences humaines et humanités;2020;2019-20;2019;2019;106;53;53;487;268;219;56;32;24;;;;;27zK4
472;École doctorale de l'EPHE;;9;Sciences et technologies de l'information et de la communication;2020;2019-20;2019;2019;0;0;0;4;1;3;1;0;1;;;;;27zK4
472;École doctorale de l'EPHE;;10;Sciences agronomiques et écologiques;2020;2019-20;2019;2019;2;2;0;9;4;5;1;0;1;;;;;27zK4
473;École doctorale Sciences de l'homme et de la société;SHS;7;Sciences de la société;2020;2019-20;2019;2019;1;1;0;2;2;0;0;0;0;;;;;8qKD9
482;École doctorale Sciences de la matière;SDM;5;Biologie, médecine et santé;2020;2019-20;2019;2019;2;0;2;4;1;3;1;1;0;;;;;kmeZ4
488;École doctorale Sciences, ingénierie, santé;SIS;3;Sciences de la terre et de l'univers, espace;2020;2019-20;2019;2019;0;0;0;4;1;3;1;1;0;;;;;Fy2lK
488;École doctorale Sciences, ingénierie, santé;SIS;8;Sciences pour l'ingénieur;2020;2019-20;2019;2019;19;4;15;82;31;51;24;8;16;;;;;Fy2lK
488;École doctorale Sciences, ingénierie, santé;SIS;10;Sciences agronomiques et écologiques;2020;2019-20;2019;2019;0;0;0;0;0;0;2;1;1;;;;;Fy2lK
489;École doctorale Sciences et ingénierie des systèmes, de l'environnement et des organisations;SISEO;3;Sciences de la terre et de l'univers, espace;2020;2019-20;2019;2019;4;2;2;12;6;6;2;0;2;;;;;6pT77
492;École doctorale Droit;;7;Sciences de la société;2020;2019-20;2019;2019;47;19;28;297;144;153;35;15;20;;;;;kOQsX
493;École doctorale Erasme;;7;Sciences de la société;2020;2019-20;2019;2019;28;11;17;172;80;92;33;15;18;;;;;FPW4T
497;École doctorale Normande de Biologie Intégrative, Santé, Environnement;Ed NBISE;3;Sciences de la terre et de l'univers, espace;2020;2019-20;2019;2019;2;2;0;11;3;8;1;1;0;;;;;0D9Je
512;École doctorale Informatique et mathématiques;InfoMaths;1;Mathématiques et leurs interactions;2020;2019-20;2019;2019;30;6;24;105;20;85;18;9;9;;;;;t86bi
512;École doctorale Informatique et mathématiques;InfoMaths;9;Sciences et technologies de l'information et de la communication;2020;2019-20;2019;2019;39;6;33;210;49;161;46;8;38;;;;;t86bi
528;École doctorale Ville, transports et territoires;VTT;3;Sciences de la terre et de l'univers, espace;2020;2019-20;2019;2019;1;1;0;1;1;0;0;0;0;;;;;68zCc
528;École doctorale Ville, transports et territoires;VTT;8;Sciences pour l'ingénieur;2020;2019-20;2019;2019;7;4;3;28;8;20;3;1;2;;;;;68zCc
528;École doctorale Ville, transports et territoires;VTT;5;Biologie, médecine et santé;2020;2019-20;2019;2019;0;0;0;1;0;1;0;0;0;;;;;68zCc
531;École doctorale Sciences, ingénierie et environnement;SIE;1;Mathématiques et leurs interactions;2020;2019-20;2019;2019;2;1;1;2;1;1;0;0;0;;;;;b5BYq
531;École doctorale Sciences, ingénierie et environnement;SIE;5;Biologie, médecine et santé;2020;2019-20;2019;2019;3;3;0;46;25;21;6;2;4;;;;;b5BYq
531;École doctorale Sciences, ingénierie et environnement;SIE;8;Sciences pour l'ingénieur;2020;2019-20;2019;2019;46;17;29;154;52;102;57;24;33;;;;;b5BYq
536;École doctorale Sciences et agrosciences;;8;Sciences pour l'ingénieur;2020;2019-20;2019;2019;6;2;4;21;8;13;6;4;2;;;;;pHfqe
537;École doctorale Culture et patrimoine;C&P;6;Sciences humaines et humanités;2020;2019-20;2019;2019;15;9;6;82;38;44;8;6;2;;;;;GxI4a
541;École doctorale de sciences humaines et sociales de La Réunion;SHS;7;Sciences de la société;2020;2019-20;2019;2019;3;0;3;15;6;9;4;3;1;;;;;21SpE
542;École doctorale de sciences de La Réunion;STS;6;Sciences humaines et humanités;2020;2019-20;2019;2019;1;1;0;3;1;2;0;0;0;;;;;2pAql
543;École doctorale de Dauphine;;1;Mathématiques et leurs interactions;2020;2019-20;2019;2019;16;5;11;40;7;33;13;2;11;;;;;u8w6A
546;École doctorale Abbé Grégoire;;9;Sciences et technologies de l'information et de la communication;2020;2019-20;2019;2019;0;0;0;5;4;1;0;0;0;;;;;ZSn7q
548;École doctorale Mer et Sciences;;3;Sciences de la terre et de l'univers, espace;2020;2019-20;2019;2019;1;1;0;7;3;4;1;1;0;;;;;QX0fS
548;École doctorale Mer et Sciences;;4;Chimie;2020;2019-20;2019;2019;2;1;1;16;8;8;4;1;3;;;;;QX0fS
548;École doctorale Mer et Sciences;;9;Sciences et technologies de l'information et de la communication;2020;2019-20;2019;2019;3;1;2;25;9;16;4;3;1;;;;;QX0fS
549;École doctorale Santé, Sciences Biologiques et Chimie du Vivant;SSBCV;5;Biologie, médecine et santé;2020;2019-20;2019;2019;65;39;26;205;129;76;56;34;22;;;;;B9ggO
549;École doctorale Santé, Sciences Biologiques et Chimie du Vivant;SSBCV;10;Sciences agronomiques et écologiques;2020;2019-20;2019;2019;0;0;0;4;1;3;0;0;0;;;;;B9ggO
551;École doctorale Mathématiques, Informatique, Physique Théorique et Ingénierie des Systèmes;MIPTIS;8;Sciences pour l'ingénieur;2020;2019-20;2019;2019;0;0;0;15;6;9;4;1;3;;;;;Mpudz
552;École doctorale Énergie - Matériaux - Sciences de la Terre et de l'Univers;EMTSU;8;Sciences pour l'ingénieur;2020;2019-20;2019;2019;29;10;19;90;23;67;16;5;11;;;;;NTZhw
553;École doctorale Carnot - Pasteur;;4;Chimie;2020;2019-20;2019;2019;19;9;10;76;34;42;19;8;11;;;;;6h4Z7
554;École doctorale Environnements - Santé;E-S;2;Physique;2020;2019-20;2019;2019;1;0;1;4;1;3;0;0;0;;;;;ElyFU
554;École doctorale Environnements - Santé;E-S;10;Sciences agronomiques et écologiques;2020;2019-20;2019;2019;20;12;8;84;38;46;17;9;8;;;;;ElyFU
555;École doctorale Sciences de l'Homme et de la Société;SHS;7;Sciences de la société;2020;2019-20;2019;2019;30;18;12;132;55;77;15;8;7;;;;;44G6m
561;École doctorale Hématologie, Oncogenèse et Biothérapies;HOB;5;Biologie, médecine et santé;2020;2019-20;2019;2019;57;31;26;204;122;82;45;24;21;;;;;7Klb2
567;École doctorale Sciences du Végétal : du gène à l'écosystème;;5;Biologie, médecine et santé;2020;2019-20;2019;2019;8;3;5;53;25;28;25;12;13;;;;;tuDkA
568;École doctorale Signalisations et Réseaux Intégratifs en Biologie;BIOSIGNE;5;Biologie, médecine et santé;2020;2019-20;2019;2019;23;18;5;88;62;26;32;20;12;;;;;CGttG
569;École doctorale Innovation thérapeutique : du fondamental à l'appliqué;;5;Biologie, médecine et santé;2020;2019-20;2019;2019;75;46;29;274;167;107;65;36;29;;;;;jx8ET
573;École doctorale Interfaces : Approches Interdisciplinaires, Fondements, Applications et Innovation;ED INTERFACES;4;Chimie;2020;2019-20;2019;2019;6;4;2;15;9;6;11;8;3;;;;;gG820
573;École doctorale Interfaces : Approches Interdisciplinaires, Fondements, Applications et Innovation;ED INTERFACES;8;Sciences pour l'ingénieur;2020;2019-20;2019;2019;20;9;11;52;22;30;20;7;13;;;;;gG820
573;École doctorale Interfaces : Approches Interdisciplinaires, Fondements, Applications et Innovation;ED INTERFACES;9;Sciences et technologies de l'information et de la communication;2020;2019-20;2019;2019;3;0;3;12;1;11;6;1;5;;;;;gG820
575;École doctorale Electrical, Optical, Bio : Physics and Engineering;EOBE;8;Sciences pour l'ingénieur;2020;2019-20;2019;2019;30;6;24;128;30;98;29;7;22;;;;;dfhyn
576;École doctorale Particules, Hadrons, Énergie, Noyau, Instrumentation, Imagerie, Cosmos et Simulation;PHENIICS;5;Biologie, médecine et santé;2020;2019-20;2019;2019;0;0;0;1;0;1;2;1;1;;;;;qC4rf
576;École doctorale Particules, Hadrons, Énergie, Noyau, Instrumentation, Imagerie, Cosmos et Simulation;PHENIICS;8;Sciences pour l'ingénieur;2020;2019-20;2019;2019;3;0;3;7;0;7;2;2;0;;;;;qC4rf
578;École doctorale Sciences de l'Homme et de la Société;ED SHS;7;Sciences de la société;2020;2019-20;2019;2019;37;18;19;313;144;169;78;30;48;;;;;Ud43O
581;École doctorale Agriculture, alimentation, biologie, environnement, santé;ABIES;8;Sciences pour l'ingénieur;2020;2019-20;2019;2019;2;1;1;18;8;10;10;4;6;;;;;c1x56
581;École doctorale Agriculture, alimentation, biologie, environnement, santé;ABIES;10;Sciences agronomiques et écologiques;2020;2019-20;2019;2019;33;14;19;144;80;64;46;26;20;;;;;c1x56
583;École doctorale Risques et Société;;7;Sciences de la société;2020;2019-20;2019;2019;4;1;3;12;4;8;1;1;0;;;;;wUBi9
583;École doctorale Risques et Société;;9;Sciences et technologies de l'information et de la communication;2020;2019-20;2019;2019;3;2;1;8;6;2;1;1;0;;;;;wUBi9
584;École doctorale Biodiversité, Agriculture, Alimentation, Environnement, Terre, Eau;GAIA;10;Sciences agronomiques et écologiques;2020;2019-20;2019;2019;116;69;47;419;217;202;82;41;41;;;;;F1h5f
585;École doctorale Sciences, Technologie,  Sante;EDSTS;2;Physique;2020;2019-20;2019;2019;2;1;1;13;6;7;2;1;1;;;;;NM3Dl
585;École doctorale Sciences, Technologie,  Sante;EDSTS;3;Sciences de la terre et de l'univers, espace;2020;2019-20;2019;2019;0;0;0;3;3;0;0;0;0;;;;;NM3Dl
585;École doctorale Sciences, Technologie,  Sante;EDSTS;5;Biologie, médecine et santé;2020;2019-20;2019;2019;16;10;6;91;42;49;14;5;9;;;;;NM3Dl
587;École doctorale Diversites, santé et développement en Amazonie;;8;Sciences pour l'ingénieur;2020;2019-20;2019;2019;2;0;2;5;1;4;0;0;0;;;;;V14tj
587;École doctorale Diversites, santé et développement en Amazonie;;10;Sciences agronomiques et écologiques;2020;2019-20;2019;2019;2;1;1;2;1;1;2;1;1;;;;;V14tj
589;École doctorale Milieu insulaire tropical à risques : protection, valorisation , santé et développement;;3;Sciences de la terre et de l'univers, espace;2020;2019-20;2019;2019;1;1;0;4;2;2;1;1;0;;;;;2cqi3
589;École doctorale Milieu insulaire tropical à risques : protection, valorisation , santé et développement;;10;Sciences agronomiques et écologiques;2020;2019-20;2019;2019;2;1;1;3;1;2;1;0;1;;;;;2cqi3
590;École doctorale Mathematiques, Information, Ingenierie des Systemes;MIIS;1;Mathématiques et leurs interactions;2020;2019-20;2019;2019;12;4;8;51;18;33;14;6;8;;;;;L20t5
590;École doctorale Mathematiques, Information, Ingenierie des Systemes;MIIS;9;Sciences et technologies de l'information et de la communication;2020;2019-20;2019;2019;30;5;25;130;33;97;31;7;24;;;;;L20t5
591;École doctorale Physique, Sciences de l'Ingenieur, Materiaux, Énergie;PSIME;4;Chimie;2020;2019-20;2019;2019;11;5;6;36;15;21;6;3;3;;;;;Hn5Om
591;École doctorale Physique, Sciences de l'Ingenieur, Materiaux, Énergie;PSIME;8;Sciences pour l'ingénieur;2020;2019-20;2019;2019;37;11;26;144;46;98;44;10;34;;;;;Hn5Om
594;École doctorale Sociétés, Espaces, Pratiques, Temps;ED SEPT;7;Sciences de la société;2020;2019-20;2019;2019;5;2;3;58;28;30;8;5;3;;;;;N85H3
596;École doctorale Matière, Molécules et Matériaux;ED 3M;2;Physique;2020;2019-20;2019;2019;37;15;22;129;54;75;52;12;40;;;;;77947
598;École doctorale Sciences de La Mer et du Littoral;SML;6;Sciences humaines et humanités;2020;2019-20;2019;2019;5;3;2;19;11;8;5;5;0;;;;;Smen6
598;École doctorale Sciences de La Mer et du Littoral;SML;10;Sciences agronomiques et écologiques;2020;2019-20;2019;2019;15;7;8;62;35;27;19;7;12;;;;;Smen6
600;École doctorale Écologie, Géosciences, Agronomie et Alimentation;EGAAL;3;Sciences de la terre et de l'univers, espace;2020;2019-20;2019;2019;23;5;18;60;19;41;23;15;8;;;;;urS33
600;École doctorale Écologie, Géosciences, Agronomie et Alimentation;EGAAL;10;Sciences agronomiques et écologiques;2020;2019-20;2019;2019;51;24;27;194;104;90;45;27;18;;;;;urS33
601;École doctorale Mathématiques et Sciences et Technologies de l'information et de la Communication;MathSTIC;1;Mathématiques et leurs interactions;2020;2019-20;2019;2019;39;6;33;130;34;96;40;13;27;;;;;3Ue20
603;École doctorale Éducation, Langages, Interactions, Cognition, Clinique, Expertise - ED 603;ELICCE;6;Sciences humaines et humanités;2020;2019-20;2019;2019;76;43;33;408;238;170;59;29;30;;;;;1Mzw7
604;École doctorale Sociétés, Temps, Territoires;STT;6;Sciences humaines et humanités;2020;2019-20;2019;2019;78;42;36;376;181;195;52;24;28;;;;;SZI5T
605;École doctorale Biologie Santé;ED BS;6;Sciences humaines et humanités;2020;2019-20;2019;2019;1;1;0;2;2;0;0;0;0;;;;;w8CxU
605;École doctorale Biologie Santé;ED BS;10;Sciences agronomiques et écologiques;2020;2019-20;2019;2019;1;0;1;2;0;2;0;0;0;;;;;w8CxU
606;École doctorale Chimie - Mécanique - Matériaux - Physique;C2MP;4;Chimie;2020;2019-20;2019;2019;22;11;11;76;39;37;33;15;18;;;;;UkNR2
607;École doctorale Sciences et Ingénierie des Ressources Naturelles;SIReNA;3;Sciences de la terre et de l'univers, espace;2020;2019-20;2019;2019;20;9;11;69;28;41;17;8;9;;;;;vi9w2
607;École doctorale Sciences et Ingénierie des Ressources Naturelles;SIReNA;10;Sciences agronomiques et écologiques;2020;2019-20;2019;2019;21;11;10;93;48;45;28;16;12;;;;;vi9w2
610;École doctorale Sciences et Ingénierie des Systèmes, Mathématiques, Informatique;SISMI;8;Sciences pour l'ingénieur;2020;2019-20;2019;2019;10;6;4;44;16;28;12;1;11;;;;;dBCUB
614;École doctorale Chimie, Écologie, Géosciences, Agrosciences - Théodore Monod;CEGA;10;Sciences agronomiques et écologiques;2020;2019-20;2019;2019;2;1;1;12;5;7;5;3;2;;;;;uc10I
618;École doctorale EUCLIDE;;7;Sciences de la société;2020;2019-20;2019;2019;6;3;3;39;21;18;0;0;0;;;;;qveTN
619;École doctorale Sciences Fondamentales et Santé;SFS;6;Sciences humaines et humanités;2020;2019-20;2019;2019;0;0;0;3;0;3;0;0;0;;;;;JiZVW
620;École doctorale Sciences du Numérique et de l'Ingénieur;SNI;8;Sciences pour l'ingénieur;2020;2019-20;2019;2019;15;9;6;52;19;33;6;2;4;;;;;Dr40w
620;École doctorale Sciences du Numérique et de l'Ingénieur;SNI;9;Sciences et technologies de l'information et de la communication;2020;2019-20;2019;2019;17;5;12;50;9;41;12;0;12;;;;;Dr40w
622;École doctorale Sciences du langage;SDL;6;Sciences humaines et humanités;2020;2019-20;2019;2019;48;33;15;273;184;89;16;11;5;;;;;9DsG2
623;École doctorale Savoir, Sciences, Éducation;SSE;7;Sciences de la société;2020;2019-20;2019;2019;5;2;3;9;4;5;4;3;1;;;;;98lMD
624;École doctorale Sciences des Sociétés;SDS;6;Sciences humaines et humanités;2020;2019-20;2019;2019;31;16;15;176;94;82;15;7;8;;;;;cGIjW
626;École doctorale de l’Institut Polytechnique de Paris;;2;Physique;2020;2019-20;2019;2019;49;12;37;154;43;111;7;2;5;;;;;DL5fO
626;École doctorale de l’Institut Polytechnique de Paris;;5;Biologie, médecine et santé;2020;2019-20;2019;2019;7;5;2;23;13;10;2;0;2;;;;;DL5fO
626;École doctorale de l’Institut Polytechnique de Paris;;6;Sciences humaines et humanités;2020;2019-20;2019;2019;2;1;1;14;6;8;0;0;0;;;;;DL5fO
6;École doctorale Droit privé;;7;Sciences de la société;2023;2022-23;2022;2022;31;11;20;232;112;120;36;15;21;5;2;7;22;UMnW1
20;École doctorale Civilisations, cultures, littératures et sociétés;;6;Sciences humaines et humanités;2023;2022-23;2022;2022;29;15;14;187;134;53;25;19;6;5;10;7;3;agjNi
34;École doctorale Matériaux;;8;Sciences pour l'ingénieur;2023;2022-23;2022;2022;18;4;14;109;35;74;30;15;15;4;25;1;0;1Iufh
39;École doctorale Mathématiques et Informatique;EDMIB;1;Mathématiques et leurs interactions;2023;2022-23;2022;2022;27;3;24;110;30;80;28;13;15;13;14;1;0;TBj2X
39;École doctorale Mathématiques et Informatique;EDMIB;8;Sciences pour l'ingénieur;2023;2022-23;2022;2022;1;0;1;1;0;1;0;0;0;0;0;0;0;TBj2X
40;École doctorale Sciences chimiques;EDSC;4;Chimie;2023;2022-23;2022;2022;82;43;39;311;151;160;71;24;47;29;42;0;0;wde3D
52;École doctorale Physique et astrophysique de Lyon;PHAST;2;Physique;2023;2022-23;2022;2022;48;17;31;185;50;135;56;18;38;43;12;1;0;61XPb
62;École doctorale Sciences de la vie et de la santé;;3;Sciences de la terre et de l'univers, espace;2023;2022-23;2022;2022;0;0;0;1;1;0;0;0;0;0;0;0;0;vZzE7
62;École doctorale Sciences de la vie et de la santé;;5;Biologie, médecine et santé;2023;2022-23;2022;2022;162;101;61;673;410;263;169;93;76;45;87;32;5;vZzE7
62;École doctorale Sciences de la vie et de la santé;;6;Sciences humaines et humanités;2023;2022-23;2022;2022;4;3;1;9;6;3;0;0;0;0;0;0;0;vZzE7
70;École doctorale Sciences pour l'ingénieur;EDSPI;8;Sciences pour l'ingénieur;2023;2022-23;2022;2022;27;8;19;114;36;78;29;6;23;7;17;3;2;G413P
71;École doctorale Sciences pour l'ingénieur;;1;Mathématiques et leurs interactions;2023;2022-23;2022;2022;3;1;2;9;3;6;2;2;0;2;0;0;0;H6UYp
71;École doctorale Sciences pour l'ingénieur;;6;Sciences humaines et humanités;2023;2022-23;2022;2022;2;1;1;8;5;3;3;1;2;0;1;2;0;H6UYp
71;École doctorale Sciences pour l'ingénieur;;10;Sciences agronomiques et écologiques;2023;2022-23;2022;2022;1;1;0;3;3;0;1;0;1;0;1;0;0;H6UYp
73;École doctorale Sciences économiques, sociales, de l'aménagement et du management;SESAM;6;Sciences humaines et humanités;2023;2022-23;2022;2022;7;2;5;40;13;27;7;5;2;1;2;0;4;IQ0Hk
78;École doctorale Sociétés, langages, temps, connaissances;STLC;7;Sciences de la société;2023;2022-23;2022;2022;12;7;5;56;33;23;4;2;2;0;0;1;3;vLU3i
104;École doctorale Sciences de la matière, du rayonnement et de l'environnement;SMRE;2;Physique;2023;2022-23;2022;2022;14;4;10;52;14;38;20;3;17;8;12;0;0;Q5iFz
104;École doctorale Sciences de la matière, du rayonnement et de l'environnement;SMRE;10;Sciences agronomiques et écologiques;2023;2022-23;2022;2022;11;5;6;64;41;23;22;18;4;11;11;0;0;Q5iFz
105;École doctorale Terre, univers, environnement;;3;Sciences de la terre et de l'univers, espace;2023;2022-23;2022;2022;34;16;18;167;67;100;39;8;31;16;21;2;0;lcWAf
113;École doctorale Histoire;;6;Sciences humaines et humanités;2023;2022-23;2022;2022;49;19;30;270;125;145;42;18;24;6;4;9;23;G5wHs
120;École doctorale Littérature française et comparée;;6;Sciences humaines et humanités;2023;2022-23;2022;2022;36;27;9;217;156;61;23;16;7;2;2;9;10;3ULpe
124;École doctorale Histoire de l'art et archéologie;;6;Sciences humaines et humanités;2023;2022-23;2022;2022;17;8;9;124;82;42;14;8;6;0;1;7;6;MBN4L
129;École doctorale Sciences de l'environnement d'Ile de France;SEIF;8;Sciences pour l'ingénieur;2023;2022-23;2022;2022;0;0;0;1;0;1;0;0;0;0;0;0;0;TnAPh
139;École doctorale Connaissance, langage, modélisation;CLM;1;Mathématiques et leurs interactions;2023;2022-23;2022;2022;0;0;0;5;2;3;0;0;0;0;0;0;0;1lxGH
139;École doctorale Connaissance, langage, modélisation;CLM;8;Sciences pour l'ingénieur;2023;2022-23;2022;2022;3;0;3;8;1;7;7;0;7;1;4;2;0;1lxGH
146;École doctorale Galilée;GALILEE;5;Biologie, médecine et santé;2023;2022-23;2022;2022;15;10;5;60;41;19;15;6;9;6;9;0;0;71hqm
166;École doctorale Information, structures et systèmes;I2S;5;Biologie, médecine et santé;2023;2022-23;2022;2022;0;0;0;6;2;4;3;2;1;0;1;2;0;2uO68
166;École doctorale Information, structures et systèmes;I2S;9;Sciences et technologies de l'information et de la communication;2023;2022-23;2022;2022;24;9;15;113;35;78;27;3;24;15;12;0;0;2uO68
178;École doctorale Sciences fondamentales;;1;Mathématiques et leurs interactions;2023;2022-23;2022;2022;4;2;2;20;5;15;5;0;5;2;1;2;0;1AiR7
178;École doctorale Sciences fondamentales;;2;Physique;2023;2022-23;2022;2022;3;0;3;23;7;16;13;4;9;8;5;0;0;1AiR7
178;École doctorale Sciences fondamentales;;4;Chimie;2023;2022-23;2022;2022;8;4;4;52;23;29;10;5;5;5;4;1;0;1AiR7
182;École doctorale Physique et chimie-physique;;4;Chimie;2023;2022-23;2022;2022;18;6;12;58;29;29;23;12;11;19;4;0;0;3My6I
184;École doctorale Mathématiques et informatique de Marseille;;5;Biologie, médecine et santé;2023;2022-23;2022;2022;2;0;2;4;1;3;0;0;0;0;0;0;0;DDObG
206;École doctorale Chimie : chimie, procédés, environnement;;5;Biologie, médecine et santé;2023;2022-23;2022;2022;0;0;0;2;1;1;1;0;1;0;1;0;0;m0UhD
209;École doctorale Sciences physiques et de L'ingénieur;SPI;9;Sciences et technologies de l'information et de la communication;2023;2022-23;2022;2022;40;12;28;161;38;123;41;11;30;15;24;2;0;tZcIZ
211;École doctorale Sciences exactes et leurs applications;ED SEA;3;Sciences de la terre et de l'univers, espace;2023;2022-23;2022;2022;1;0;1;21;10;11;8;2;6;5;2;1;0;1G1iC
211;École doctorale Sciences exactes et leurs applications;ED SEA;5;Biologie, médecine et santé;2023;2022-23;2022;2022;0;0;0;2;1;1;0;0;0;0;0;0;0;1G1iC
216;École doctorale Ingénierie pour la santé, la cognition, l'environnement;EDISCE;6;Sciences humaines et humanités;2023;2022-23;2022;2022;2;2;0;8;8;0;2;2;0;1;1;0;0;fPs1t
218;École doctorale Chimie et sciences du vivant;EDCSV;4;Chimie;2023;2022-23;2022;2022;20;9;11;81;33;48;25;7;18;10;15;0;0;8bcJh
220;École doctorale Électronique, électrotechnique, automatique, traitement du signal;EEATS;8;Sciences pour l'ingénieur;2023;2022-23;2022;2022;23;5;18;92;17;75;29;1;28;14;10;4;1;IxEaw
220;École doctorale Électronique, électrotechnique, automatique, traitement du signal;EEATS;9;Sciences et technologies de l'information et de la communication;2023;2022-23;2022;2022;69;13;56;303;70;233;86;20;66;35;43;7;1;IxEaw
222;École doctorale Sciences chimiques;EDSC;10;Sciences agronomiques et écologiques;2023;2022-23;2022;2022;0;0;0;1;1;0;0;0;0;0;0;0;0;AdU8Q
227;École doctorale Sciences de la nature et de l'homme;;6;Sciences humaines et humanités;2023;2022-23;2022;2022;17;12;5;41;30;11;6;3;3;1;5;0;0;xiDA5
227;École doctorale Sciences de la nature et de l'homme;;10;Sciences agronomiques et écologiques;2023;2022-23;2022;2022;15;7;8;54;26;28;14;8;6;6;8;0;0;xiDA5
245;École doctorale Sciences économiques, juridiques, politiques et de gestion;;7;Sciences de la société;2023;2022-23;2022;2022;30;18;12;155;69;86;27;10;17;6;8;7;6;ShLUg
250;École doctorale Sciences chimiques;;4;Chimie;2023;2022-23;2022;2022;27;10;17;111;46;65;46;21;25;26;20;0;0;O0Fav
251;École doctorale Sciences de l'environnement;;8;Sciences pour l'ingénieur;2023;2022-23;2022;2022;4;3;1;15;10;5;4;2;2;1;1;2;0;VR28y
261;École doctorale Cognition, comportements, conduites humaines;3CH;6;Sciences humaines et humanités;2023;2022-23;2022;2022;41;31;10;164;117;47;33;21;12;1;26;4;2;KOLCy
266;École doctorale Biologie, santé, environnement;BIOSE;5;Biologie, médecine et santé;2023;2022-23;2022;2022;38;22;16;150;82;68;38;17;21;17;17;3;1;386V9
267;École doctorale Arts et médias;;7;Sciences de la société;2023;2022-23;2022;2022;5;1;4;8;2;6;3;2;1;2;0;1;0;eCF5C
267;École doctorale Arts et médias;;9;Sciences et technologies de l'information et de la communication;2023;2022-23;2022;2022;2;1;1;27;16;11;5;2;3;0;1;1;3;eCF5C
269;École doctorale Mathématiques, sciences de l'information et de l'ingénieur;MSII;5;Biologie, médecine et santé;2023;2022-23;2022;2022;0;0;0;2;2;0;3;1;2;1;0;1;1;5E625
269;École doctorale Mathématiques, sciences de l'information et de l'ingénieur;MSII;8;Sciences pour l'ingénieur;2023;2022-23;2022;2022;55;13;42;219;54;165;45;16;29;20;17;7;1;5E625
269;École doctorale Mathématiques, sciences de l'information et de l'ingénieur;MSII;9;Sciences et technologies de l'information et de la communication;2023;2022-23;2022;2022;10;2;8;63;18;45;18;7;11;7;9;2;0;5E625
304;École doctorale Sciences et environnements;;3;Sciences de la terre et de l'univers, espace;2023;2022-23;2022;2022;6;3;3;23;12;11;5;2;3;2;3;0;0;2ywZn
305;École doctorale Énergie et environnement;E2;1;Mathématiques et leurs interactions;2023;2022-23;2022;2022;1;1;0;3;2;1;1;0;1;1;0;0;0;Kbt8I
323;École doctorale Génie électrique, électronique et télécommunications;GEET;9;Sciences et technologies de l'information et de la communication;2023;2022-23;2022;2022;4;3;1;23;10;13;11;2;9;2;8;1;0;arcz6
326;École doctorale Comportement, langage, éducation, socialisation, cognition;CLESCO;5;Biologie, médecine et santé;2023;2022-23;2022;2022;11;7;4;32;22;10;7;2;5;3;4;0;0;nWIlG
327;École doctorale Temps, espaces, sociétés, cultures;TESC;5;Biologie, médecine et santé;2023;2022-23;2022;2022;2;2;0;4;3;1;1;0;1;0;0;1;0;IjgiJ
327;École doctorale Temps, espaces, sociétés, cultures;TESC;8;Sciences pour l'ingénieur;2023;2022-23;2022;2022;1;0;1;3;2;1;0;0;0;0;0;0;0;IjgiJ
328;École doctorale Arts, lettres, langues, philosophie et communication;ALLPH@;7;Sciences de la société;2023;2022-23;2022;2022;3;1;2;10;7;3;3;3;0;0;1;2;0;xLxMh
341;École doctorale Évolution, écosystèmes, microbiologie, modélisation;E2M2;5;Biologie, médecine et santé;2023;2022-23;2022;2022;22;12;10;121;61;60;30;13;17;12;15;3;0;J83I0
354;École doctorale Langues, lettres et arts;LLA;7;Sciences de la société;2023;2022-23;2022;2022;0;0;0;0;0;0;1;1;0;0;0;1;0;RwcSv
354;École doctorale Langues, lettres et arts;LLA;9;Sciences et technologies de l'information et de la communication;2023;2022-23;2022;2022;0;0;0;0;0;0;1;1;0;0;0;0;1;RwcSv
361;École doctorale Sciences et Technologies;ED ST;10;Sciences agronomiques et écologiques;2023;2022-23;2022;2022;0;0;0;14;10;4;4;3;1;1;2;0;1;cOUmL
364;École doctorale Sciences fondamentales et appliquées;EDSFA;1;Mathématiques et leurs interactions;2023;2022-23;2022;2022;23;4;19;77;13;64;16;6;10;5;7;4;0;E483q
364;École doctorale Sciences fondamentales et appliquées;EDSFA;8;Sciences pour l'ingénieur;2023;2022-23;2022;2022;5;1;4;61;16;45;24;6;18;6;12;6;0;E483q
370;École doctorale Lettres, sciences humaines et sociales;LSHS;6;Sciences humaines et humanités;2023;2022-23;2022;2022;35;16;19;189;108;81;27;13;14;5;8;8;6;xAXXx
377;École doctorale Environnement et société;;9;Sciences et technologies de l'information et de la communication;2023;2022-23;2022;2022;1;0;1;7;1;6;1;0;1;0;0;1;0;ZMG5u
388;École doctorale Chimie physique et chimie analytique de Paris centre;CPCA;4;Chimie;2023;2022-23;2022;2022;84;41;43;318;145;173;82;41;41;49;30;3;0;M0Hnd
393;École doctorale Pierre Louis de Santé Publique : Épidémiologie et Sciences de l'information biomédicale;PLSP;5;Biologie, médecine et santé;2023;2022-23;2022;2022;65;31;34;232;118;114;55;32;23;26;17;11;1;69445
396;École doctorale Économie, organisations, société;EOS;6;Sciences humaines et humanités;2023;2022-23;2022;2022;0;0;0;5;2;3;0;0;0;0;0;0;0;Es5e7
396;École doctorale Économie, organisations, société;EOS;7;Sciences de la société;2023;2022-23;2022;2022;47;17;30;154;70;84;26;9;17;7;8;7;4;Es5e7
402;École doctorale Sciences de la vie et de la santé;SVS;5;Biologie, médecine et santé;2023;2022-23;2022;2022;32;21;11;140;88;52;31;20;11;6;19;5;1;YKgsU
402;École doctorale Sciences de la vie et de la santé;SVS;8;Sciences pour l'ingénieur;2023;2022-23;2022;2022;0;0;0;3;1;2;0;0;0;0;0;0;0;YKgsU
405;École doctorale Économie, management,mathématiques et physique de Cergy;EM2C;1;Mathématiques et leurs interactions;2023;2022-23;2022;2022;3;1;2;18;4;14;3;2;1;1;2;0;0;QbwSB
405;École doctorale Économie, management,mathématiques et physique de Cergy;EM2C;2;Physique;2023;2022-23;2022;2022;7;2;5;16;5;11;3;0;3;1;2;0;0;QbwSB
406;École doctorale Chimie moléculaire de Paris centre;;4;Chimie;2023;2022-23;2022;2022;41;20;21;147;73;74;23;8;15;14;8;1;0;a5dKy
411;École doctorale Humanités nouvelles : Fernand Braudel;;6;Sciences humaines et humanités;2023;2022-23;2022;2022;41;21;20;224;113;111;46;18;28;1;12;16;17;l2rFh
413;École doctorale Sciences de la terre et de l'environnement;STE;3;Sciences de la terre et de l'univers, espace;2023;2022-23;2022;2022;19;7;12;55;19;36;16;8;8;6;9;1;0;u9BA9
414;École doctorale Sciences de la vie et de la santé;;10;Sciences agronomiques et écologiques;2023;2022-23;2022;2022;2;2;0;4;4;0;0;0;0;0;0;0;0;YI4xS
417;École doctorale Sciences et Ingénierie;S&I;2;Physique;2023;2022-23;2022;2022;1;1;0;5;3;2;1;1;0;1;0;0;0;SSBvE
417;École doctorale Sciences et Ingénierie;S&I;4;Chimie;2023;2022-23;2022;2022;9;4;5;32;10;22;9;5;4;3;6;0;0;SSBvE
432;École doctorale Sciences des métiers de l'ingénieur;SMI;2;Physique;2023;2022-23;2022;2022;0;0;0;1;0;1;1;1;0;0;1;0;0;nSsHB
432;École doctorale Sciences des métiers de l'ingénieur;SMI;7;Sciences de la société;2023;2022-23;2022;2022;0;0;0;1;1;0;0;0;0;0;0;0;0;nSsHB
432;École doctorale Sciences des métiers de l'ingénieur;SMI;9;Sciences et technologies de l'information et de la communication;2023;2022-23;2022;2022;8;3;5;25;11;14;6;0;6;1;3;2;0;nSsHB
433;École doctorale Concepts et langages;;7;Sciences de la société;2023;2022-23;2022;2022;2;0;2;96;62;34;1;0;1;0;1;0;0;v8q34
433;École doctorale Concepts et langages;;9;Sciences et technologies de l'information et de la communication;2023;2022-23;2022;2022;5;4;1;86;50;36;2;2;0;0;1;1;0;v8q34
450;École doctorale Recherches en psychanalyse et psychopathologie;PSY²;6;Sciences humaines et humanités;2023;2022-23;2022;2022;13;10;3;120;84;36;23;10;13;3;5;14;1;8jI3f
460;École doctorale Sciences juridiques;SJ;6;Sciences humaines et humanités;2023;2022-23;2022;2022;2;1;1;2;1;1;0;0;0;0;0;0;0;ZB5I5
467;École doctorale Aéronautique, astronautique;AA;5;Biologie, médecine et santé;2023;2022-23;2022;2022;0;0;0;3;0;3;0;0;0;0;0;0;0;U7l45
469;École doctorale du Pacifique;EDP;1;Mathématiques et leurs interactions;2023;2022-23;2022;2022;1;0;1;3;1;2;0;0;0;0;0;0;0;t9Z2n
469;École doctorale du Pacifique;EDP;4;Chimie;2023;2022-23;2022;2022;0;0;0;5;3;2;2;2;0;0;2;0;0;t9Z2n
469;École doctorale du Pacifique;EDP;5;Biologie, médecine et santé;2023;2022-23;2022;2022;2;0;2;12;9;3;1;0;1;0;1;0;0;t9Z2n
472;École doctorale de l'EPHE;;1;Mathématiques et leurs interactions;2023;2022-23;2022;2022;1;1;0;3;1;2;0;0;0;0;0;0;0;27zK4
472;École doctorale de l'EPHE;;3;Sciences de la terre et de l'univers, espace;2023;2022-23;2022;2022;1;1;0;7;7;0;2;1;1;0;2;0;0;27zK4
474;École doctorale Interdisciplinaire européenne frontières du vivant;FDV;6;Sciences humaines et humanités;2023;2022-23;2022;2022;6;3;3;8;5;3;1;1;0;0;1;0;0;E727j
478;École doctorale Sciences de Gestion;;7;Sciences de la société;2023;2022-23;2022;2022;16;7;9;65;34;31;7;6;1;0;0;5;2;q34kB
485;École doctorale Éducation, Psychologie, Information et Communication;EPIC;6;Sciences humaines et humanités;2023;2022-23;2022;2022;55;41;14;249;162;87;30;22;8;4;5;11;10;O82eL
487;École doctorale Philosophie;PHCR;6;Sciences humaines et humanités;2023;2022-23;2022;2022;21;10;11;137;61;76;13;7;6;3;3;2;5;3BRzJ
488;École doctorale Sciences, ingénierie, santé;SIS;3;Sciences de la terre et de l'univers, espace;2023;2022-23;2022;2022;2;0;2;8;5;3;1;1;0;0;1;0;0;Fy2lK
508;École doctorale Normande de chimie;EDNC;4;Chimie;2023;2022-23;2022;2022;38;16;22;152;67;85;35;13;22;21;12;2;0;E52OO
528;École doctorale Ville, transports et territoires;VTT;10;Sciences agronomiques et écologiques;2023;2022-23;2022;2022;1;1;0;1;1;0;0;0;0;0;0;0;0;68zCc
530;École doctorale Organisations, marchés, institutions;OMI;10;Sciences agronomiques et écologiques;2023;2022-23;2022;2022;0;0;0;1;0;1;0;0;0;0;0;0;0;4htv7
532;École doctorale Mathématiques et sciences et technologies de l'information et de la communication;MSTIC;1;Mathématiques et leurs interactions;2023;2022-23;2022;2022;28;4;24;82;16;66;29;8;21;15;14;0;0;t43KM
532;École doctorale Mathématiques et sciences et technologies de l'information et de la communication;MSTIC;9;Sciences et technologies de l'information et de la communication;2023;2022-23;2022;2022;36;9;27;153;38;115;38;10;28;15;20;3;0;t43KM
540;"École doctorale École transdisciplinaire ""lettres/sciences""";;2;Physique;2023;2022-23;2022;2022;0;0;0;1;1;0;1;0;1;0;0;1;0;tWWw7
540;"École doctorale École transdisciplinaire ""lettres/sciences""";;3;Sciences de la terre et de l'univers, espace;2023;2022-23;2022;2022;1;0;1;2;1;1;0;0;0;0;0;0;0;tWWw7
540;"École doctorale École transdisciplinaire ""lettres/sciences""";;9;Sciences et technologies de l'information et de la communication;2023;2022-23;2022;2022;2;2;0;8;4;4;1;0;1;1;0;0;0;tWWw7
541;École doctorale de sciences humaines et sociales de La Réunion;SHS;3;Sciences de la terre et de l'univers, espace;2023;2022-23;2022;2022;0;0;0;1;1;0;1;0;1;0;0;1;0;21SpE
542;École doctorale de sciences de La Réunion;STS;3;Sciences de la terre et de l'univers, espace;2023;2022-23;2022;2022;0;0;0;4;2;2;2;2;0;1;0;1;0;2pAql
542;École doctorale de sciences de La Réunion;STS;5;Biologie, médecine et santé;2023;2022-23;2022;2022;16;11;5;69;39;30;12;8;4;7;5;0;0;2pAql
542;École doctorale de sciences de La Réunion;STS;8;Sciences pour l'ingénieur;2023;2022-23;2022;2022;1;0;1;12;3;9;3;1;2;2;0;1;0;2pAql
542;École doctorale de sciences de La Réunion;STS;10;Sciences agronomiques et écologiques;2023;2022-23;2022;2022;3;1;2;14;10;4;5;2;3;3;2;0;0;2pAql
544;École doctorale Inter-Med : Espaces, temps, cultures;INTER-MED;7;Sciences de la société;2023;2022-23;2022;2022;23;13;10;118;53;65;10;4;6;0;3;2;5;7VjtD
545;École doctorale Sociétés, politique et santé publique;SP2;6;Sciences humaines et humanités;2023;2022-23;2022;2022;28;19;9;158;95;63;25;12;13;3;11;7;4;IAKR4
546;École doctorale Abbé Grégoire;;6;Sciences humaines et humanités;2023;2022-23;2022;2022;40;20;20;266;152;114;20;12;8;2;5;7;6;ZSn7q
548;École doctorale Mer et Sciences;;4;Chimie;2023;2022-23;2022;2022;4;2;2;13;7;6;3;1;2;0;2;1;0;QX0fS
548;École doctorale Mer et Sciences;;6;Sciences humaines et humanités;2023;2022-23;2022;2022;7;3;4;12;4;8;3;1;2;2;1;0;0;QX0fS
552;École doctorale Énergie - Matériaux - Sciences de la Terre et de l'Univers;EMTSU;2;Physique;2023;2022-23;2022;2022;13;2;11;58;20;38;14;6;8;3;10;1;0;NTZhw
552;École doctorale Énergie - Matériaux - Sciences de la Terre et de l'Univers;EMTSU;3;Sciences de la terre et de l'univers, espace;2023;2022-23;2022;2022;18;7;11;60;23;37;13;5;8;5;6;2;0;NTZhw
552;École doctorale Énergie - Matériaux - Sciences de la Terre et de l'Univers;EMTSU;4;Chimie;2023;2022-23;2022;2022;7;3;4;31;19;12;11;8;3;5;6;0;0;NTZhw
553;École doctorale Carnot - Pasteur;;4;Chimie;2023;2022-23;2022;2022;18;11;7;69;33;36;23;8;15;5;16;2;0;6h4Z7
554;École doctorale Environnements - Santé;E-S;10;Sciences agronomiques et écologiques;2023;2022-23;2022;2022;18;12;6;93;60;33;26;15;11;7;16;3;0;ElyFU
555;École doctorale Sciences de l'Homme et de la Société;SHS;5;Biologie, médecine et santé;2023;2022-23;2022;2022;0;0;0;0;0;0;2;1;1;0;0;2;0;44G6m
555;École doctorale Sciences de l'Homme et de la Société;SHS;6;Sciences humaines et humanités;2023;2022-23;2022;2022;15;10;5;88;53;35;14;5;9;3;3;4;4;44G6m
556;École doctorale Homme, Sociétés, Risques, Territoire;HSRT;5;Biologie, médecine et santé;2023;2022-23;2022;2022;5;4;1;18;15;3;1;0;1;0;0;1;0;5QEaX
561;École doctorale Hématologie, Oncogenèse et Biothérapies;HOB;5;Biologie, médecine et santé;2023;2022-23;2022;2022;50;31;19;195;123;72;53;28;25;51;2;0;0;7Klb2
566;École doctorale Sciences du Sport, de la Motricité et du Mouvement Humain;SMMH;6;Sciences humaines et humanités;2023;2022-23;2022;2022;10;4;6;43;23;20;5;3;2;0;3;1;1;3iv8y
566;École doctorale Sciences du Sport, de la Motricité et du Mouvement Humain;SMMH;8;Sciences pour l'ingénieur;2023;2022-23;2022;2022;1;0;1;5;1;4;0;0;0;0;0;0;0;3iv8y
571;École doctorale Sciences Chimiques : Molécules, Matériaux, Instrumentation et Biosystemes;2MIB;4;Chimie;2023;2022-23;2022;2022;92;47;45;308;150;158;90;45;45;35;52;2;1;zbi37
573;École doctorale Interfaces : Approches Interdisciplinaires, Fondements, Applications et Innovation;ED INTERFACES;2;Physique;2023;2022-23;2022;2022;3;3;0;14;7;7;4;1;3;0;4;0;0;gG820
573;École doctorale Interfaces : Approches Interdisciplinaires, Fondements, Applications et Innovation;ED INTERFACES;8;Sciences pour l'ingénieur;2023;2022-23;2022;2022;13;2;11;54;16;38;10;5;5;6;4;0;0;gG820
573;École doctorale Interfaces : Approches Interdisciplinaires, Fondements, Applications et Innovation;ED INTERFACES;9;Sciences et technologies de l'information et de la communication;2023;2022-23;2022;2022;4;0;4;12;1;11;3;0;3;2;1;0;0;gG820
575;École doctorale Electrical, Optical, Bio : Physics and Engineering;EOBE;3;Sciences de la terre et de l'univers, espace;2023;2022-23;2022;2022;0;0;0;1;0;1;0;0;0;0;0;0;0;dfhyn
575;École doctorale Electrical, Optical, Bio : Physics and Engineering;EOBE;5;Biologie, médecine et santé;2023;2022-23;2022;2022;0;0;0;12;7;5;6;4;2;4;2;0;0;dfhyn
576;École doctorale Particules, Hadrons, Énergie, Noyau, Instrumentation, Imagerie, Cosmos et Simulation;PHENIICS;2;Physique;2023;2022-23;2022;2022;57;18;39;206;63;143;50;14;36;38;10;2;0;qC4rf
579;École doctorale Sciences mécaniques et energétiques, matériaux et géosciences;SMEMaG;3;Sciences de la terre et de l'univers, espace;2023;2022-23;2022;2022;9;2;7;39;13;26;14;9;5;4;8;2;0;atMj7
579;École doctorale Sciences mécaniques et energétiques, matériaux et géosciences;SMEMaG;5;Biologie, médecine et santé;2023;2022-23;2022;2022;1;1;0;6;1;5;0;0;0;0;0;0;0;atMj7
580;École doctorale Sciences et technologies de l'information et de la communication;STIC;9;Sciences et technologies de l'information et de la communication;2023;2022-23;2022;2022;132;33;99;549;138;411;118;26;92;42;67;9;0;AzCC0
581;École doctorale Agriculture, alimentation, biologie, environnement, santé;ABIES;4;Chimie;2023;2022-23;2022;2022;2;2;0;25;14;11;4;3;1;1;3;0;0;c1x56
581;École doctorale Agriculture, alimentation, biologie, environnement, santé;ABIES;5;Biologie, médecine et santé;2023;2022-23;2022;2022;18;10;8;70;42;28;17;14;3;7;10;0;0;c1x56
582;École doctorale Cancérologie, Biologie, Médecine, Santé;CBMS;1;Mathématiques et leurs interactions;2023;2022-23;2022;2022;1;1;0;2;1;1;0;0;0;0;0;0;0;75bj4
584;École doctorale Biodiversité, Agriculture, Alimentation, Environnement, Terre, Eau;GAIA;10;Sciences agronomiques et écologiques;2023;2022-23;2022;2022;90;47;43;367;201;166;105;61;44;41;60;4;0;F1h5f
586;École doctorale Sciences Humaines et Sociales;EDSHS;6;Sciences humaines et humanités;2023;2022-23;2022;2022;48;30;18;323;182;141;35;22;13;4;10;8;13;0RKVX
586;École doctorale Sciences Humaines et Sociales;EDSHS;7;Sciences de la société;2023;2022-23;2022;2022;29;9;20;144;72;72;16;3;13;1;4;3;8;0RKVX
587;École doctorale Diversites, santé et développement en Amazonie;;3;Sciences de la terre et de l'univers, espace;2023;2022-23;2022;2022;0;0;0;2;1;1;0;0;0;0;0;0;0;V14tj
587;École doctorale Diversites, santé et développement en Amazonie;;7;Sciences de la société;2023;2022-23;2022;2022;2;1;1;11;5;6;3;2;1;0;1;1;1;V14tj
587;École doctorale Diversites, santé et développement en Amazonie;;10;Sciences agronomiques et écologiques;2023;2022-23;2022;2022;1;0;1;11;3;8;0;0;0;0;0;0;0;V14tj
589;École doctorale Milieu insulaire tropical à risques : protection, valorisation , santé et développement;;9;Sciences et technologies de l'information et de la communication;2023;2022-23;2022;2022;0;0;0;0;0;0;1;0;1;0;1;0;0;2cqi3
589;École doctorale Milieu insulaire tropical à risques : protection, valorisation , santé et développement;;10;Sciences agronomiques et écologiques;2023;2022-23;2022;2022;0;0;0;0;0;0;2;1;1;0;2;0;0;2cqi3
590;École doctorale Mathematiques, Information, Ingenierie des Systemes;MIIS;9;Sciences et technologies de l'information et de la communication;2023;2022-23;2022;2022;37;4;33;152;32;120;28;7;21;15;11;2;0;L20t5
592;École doctorale Lettres, Communication, Langues, Arts;LECLA;6;Sciences humaines et humanités;2023;2022-23;2022;2022;32;20;12;175;114;61;40;24;16;6;7;12;15;sY7f3
594;École doctorale Sociétés, Espaces, Pratiques, Temps;ED SEPT;7;Sciences de la société;2023;2022-23;2022;2022;5;2;3;35;17;18;11;9;2;0;0;5;6;N85H3
595;École doctorale Arts, Lettres, Langues;ED ALL;6;Sciences humaines et humanités;2023;2022-23;2022;2022;52;34;18;240;153;87;29;20;9;4;3;8;14;a8f9b
596;École doctorale Matière, Molécules et Matériaux;ED 3M;4;Chimie;2023;2022-23;2022;2022;41;23;18;117;61;56;33;17;16;21;11;1;0;77947
598;École doctorale Sciences de La Mer et du Littoral;SML;5;Biologie, médecine et santé;2023;2022-23;2022;2022;10;7;3;29;24;5;6;5;1;1;4;1;0;Smen6
602;École doctorale Sciences pour l'Ingénieur;SPI;6;Sciences humaines et humanités;2023;2022-23;2022;2022;2;0;2;12;4;8;0;0;0;0;0;0;0;8yWbu
604;École doctorale Sociétés, Temps, Territoires;STT;6;Sciences humaines et humanités;2023;2022-23;2022;2022;15;6;9;100;54;46;15;8;7;1;5;8;1;SZI5T
606;École doctorale Chimie - Mécanique - Matériaux - Physique;C2MP;4;Chimie;2023;2022-23;2022;2022;12;5;7;43;17;26;20;10;10;14;5;1;0;UkNR2
607;École doctorale Sciences et Ingénierie des Ressources Naturelles;SIReNA;8;Sciences pour l'ingénieur;2023;2022-23;2022;2022;3;1;2;9;1;8;0;0;0;0;0;0;0;vi9w2
610;École doctorale Sciences et Ingénierie des Systèmes, Mathématiques, Informatique;SISMI;8;Sciences pour l'ingénieur;2023;2022-23;2022;2022;0;0;0;0;0;0;10;3;7;6;3;1;0;dBCUB
612;École doctorale Humanités;;6;Sciences humaines et humanités;2023;2022-23;2022;2022;26;12;14;182;91;91;26;14;12;1;6;10;9;v30I8
614;École doctorale Chimie, Écologie, Géosciences, Agrosciences - Théodore Monod;CEGA;4;Chimie;2023;2022-23;2022;2022;0;0;0;0;0;0;16;6;10;12;4;0;0;uc10I
614;École doctorale Chimie, Écologie, Géosciences, Agrosciences - Théodore Monod;CEGA;5;Biologie, médecine et santé;2023;2022-23;2022;2022;0;0;0;0;0;0;2;0;2;1;1;0;0;uc10I
616;École doctorale Humanités et Langues;H&L;6;Sciences humaines et humanités;2023;2022-23;2022;2022;51;32;19;255;132;123;29;18;11;1;5;12;11;FYOlf
617;École doctorale Sciences de la Société : Territoires, Economie et Droit;SSTED;9;Sciences et technologies de l'information et de la communication;2023;2022-23;2022;2022;1;0;1;6;0;6;0;0;0;0;0;0;0;Kl9ZX
618;École doctorale EUCLIDE;;1;Mathématiques et leurs interactions;2023;2022-23;2022;2022;3;2;1;12;4;8;2;0;2;2;0;0;0;qveTN
618;École doctorale EUCLIDE;;4;Chimie;2023;2022-23;2022;2022;5;1;4;22;10;12;4;1;3;2;1;1;0;qveTN
618;École doctorale EUCLIDE;;5;Biologie, médecine et santé;2023;2022-23;2022;2022;3;3;0;9;5;4;3;0;3;2;1;0;0;qveTN
618;École doctorale EUCLIDE;;7;Sciences de la société;2023;2022-23;2022;2022;5;1;4;32;10;22;6;3;3;1;4;1;0;qveTN
619;École doctorale Sciences Fondamentales et Santé;SFS;1;Mathématiques et leurs interactions;2023;2022-23;2022;2022;2;0;2;5;1;4;1;0;1;1;0;0;0;JiZVW
620;École doctorale Sciences du Numérique et de l'Ingénieur;SNI;7;Sciences de la société;2023;2022-23;2022;2022;1;1;0;1;1;0;0;0;0;0;0;0;0;Dr40w
623;École doctorale Savoir, Sciences, Éducation;SSE;1;Mathématiques et leurs interactions;2023;2022-23;2022;2022;0;0;0;11;7;4;1;1;0;0;0;0;1;98lMD
626;École doctorale de l’Institut Polytechnique de Paris;;5;Biologie, médecine et santé;2023;2022-23;2022;2022;10;5;5;27;13;14;9;6;3;5;4;0;0;DL5fO
633;École doctorale Cultures, Sociétés, Territoires;CST;7;Sciences de la société;2023;2022-23;2022;2022;13;6;7;47;29;18;5;1;4;3;1;0;1;54818
634;École doctorale Sciences, Ingénierie, Environnement;SIE;5;Biologie, médecine et santé;2023;2022-23;2022;2022;3;1;2;8;2;6;1;1;0;1;0;0;0;TOc8f
634;École doctorale Sciences, Ingénierie, Environnement;SIE;8;Sciences pour l'ingénieur;2023;2022-23;2022;2022;12;7;5;54;22;32;14;8;6;3;10;0;1;TOc8f
635;École doctorale Polytechnique Hauts-de-France;PHF;4;Chimie;2023;2022-23;2022;2022;2;2;0;5;3;2;3;1;2;2;1;0;0;p2m23
635;École doctorale Polytechnique Hauts-de-France;PHF;5;Biologie, médecine et santé;2023;2022-23;2022;2022;0;0;0;3;0;3;0;0;0;0;0;0;0;p2m23
635;École doctorale Polytechnique Hauts-de-France;PHF;8;Sciences pour l'ingénieur;2023;2022-23;2022;2022;12;3;9;49;13;36;8;0;8;3;5;0;0;p2m23
636;;;6;Sciences humaines et humanités;2023;2022-23;2022;2022;15;7;8;78;49;29;7;6;1;0;1;4;2;
641;École doctorale Mathématiques et Sciences et Technologies du numérique, de l’Information et de la Communication;MaSTIC;9;Sciences et technologies de l'information et de la communication;2023;2022-23;2022;2022;35;11;24;137;35;102;60;18;42;37;23;0;0;4kq8w
642;École doctorale Végétal, Animal, Aliment, Mer, Environnement;VAAME;10;Sciences agronomiques et écologiques;2023;2022-23;2022;2022;14;12;2;63;38;25;26;14;12;10;14;2;0;jcs9y
643;École doctorale Arts, Lettres, Langues;;6;Sciences humaines et humanités;2023;2022-23;2022;2022;24;15;9;109;77;32;19;15;4;1;1;13;4;fjau4
647;École doctorale Sciences pour l’Ingénieur;;8;Sciences pour l'ingénieur;2023;2022-23;2022;2022;26;9;17;98;31;67;29;8;21;14;12;3;0;pg354
648;;;9;Sciences et technologies de l'information et de la communication;2023;2022-23;2022;2022;49;9;40;192;37;155;34;9;25;18;13;3;0;
649;;;4;Chimie;2023;2022-23;2022;2022;20;5;15;52;21;31;0;0;0;0;0;0;0;
651;;;1;Mathématiques et leurs interactions;2023;2022-23;2022;2022;5;2;3;23;10;13;0;0;0;0;0;0;0;
651;;;2;Physique;2023;2022-23;2022;2022;6;2;4;21;4;17;0;0;0;0;0;0;0;
19;École doctorale Littératures françaises et comparée;;6;Sciences humaines et humanités;2021;2020-21;2020;2020;61;33;28;255;158;97;17;10;7;2;1;9;5;13M43
31;École doctorale Pratiques et théories du sens;;7;Sciences de la société;2021;2020-21;2020;2020;20;11;9;122;76;46;5;5;0;2;0;1;2;1S466
37;École doctorale Sciences physiques pour l'ingénieur et microtechniques;SPIM;2;Physique;2021;2020-21;2020;2020;0;0;0;1;1;0;0;0;0;0;0;0;0;F7G1B
37;École doctorale Sciences physiques pour l'ingénieur et microtechniques;SPIM;8;Sciences pour l'ingénieur;2021;2020-21;2020;2020;41;13;28;171;46;125;45;12;33;19;22;4;0;F7G1B
47;École doctorale Physique;;4;Chimie;2021;2020-21;2020;2020;0;0;0;2;1;1;1;0;1;0;1;0;0;8kNpd
50;École doctorale Langues, littératures et sciences humaines;LLSH;9;Sciences et technologies de l'information et de la communication;2021;2020-21;2020;2020;6;5;1;45;21;24;4;4;0;0;1;1;2;8THzQ
60;École doctorale Territoires, temps, sociétés et développement;TTSD;6;Sciences humaines et humanités;2021;2020-21;2020;2020;41;26;15;198;123;75;21;15;6;3;11;4;3;fkIh6
65;École doctorale Sciences de la Vie, Santé, Agronomie, Environnement;;5;Biologie, médecine et santé;2021;2020-21;2020;2020;62;39;23;214;133;81;30;16;14;16;12;1;1;MAOG4
65;École doctorale Sciences de la Vie, Santé, Agronomie, Environnement;;10;Sciences agronomiques et écologiques;2021;2020-21;2020;2020;0;0;0;4;3;1;10;4;6;3;5;1;1;MAOG4
67;École doctorale Sciences juridiques et politiques;;7;Sciences de la société;2021;2020-21;2020;2020;70;38;32;444;221;223;35;16;19;4;1;13;17;qrOj1
71;École doctorale Sciences pour l'ingénieur;;7;Sciences de la société;2021;2020-21;2020;2020;0;0;0;4;2;2;1;1;0;0;1;0;0;H6UYp
71;École doctorale Sciences pour l'ingénieur;;8;Sciences pour l'ingénieur;2021;2020-21;2020;2020;43;14;29;190;57;133;34;14;20;16;15;3;0;H6UYp
71;École doctorale Sciences pour l'ingénieur;;9;Sciences et technologies de l'information et de la communication;2021;2020-21;2020;2020;3;1;2;12;4;8;3;1;2;0;2;1;0;H6UYp
72;École doctorale Sciences pour l'ingénieur;SPI;9;Sciences et technologies de l'information et de la communication;2021;2020-21;2020;2020;95;27;68;350;89;261;91;27;64;48;39;4;0;47QPx
77;École doctorale Informatique, automatique, électronique, électrotechnique, mathématiques;IAEM;1;Mathématiques et leurs interactions;2021;2020-21;2020;2020;7;1;6;48;7;41;12;4;8;7;4;1;0;TCHTA
77;École doctorale Informatique, automatique, électronique, électrotechnique, mathématiques;IAEM;8;Sciences pour l'ingénieur;2021;2020-21;2020;2020;4;2;2;20;3;17;9;0;9;3;5;1;0;TCHTA
84;École doctorale Sciences et technologies de l'information et de la communication;STIC;5;Biologie, médecine et santé;2021;2020-21;2020;2020;2;1;1;2;1;1;0;0;0;0;0;0;0;9wS2W
104;École doctorale Sciences de la matière, du rayonnement et de l'environnement;SMRE;3;Sciences de la terre et de l'univers, espace;2021;2020-21;2020;2020;11;5;6;38;20;18;10;5;5;5;4;1;0;Q5iFz
119;École doctorale Science politique;;7;Sciences de la société;2021;2020-21;2020;2020;11;7;4;90;50;40;9;3;6;0;1;2;6;eyibb
129;École doctorale Sciences de l'environnement d'Ile de France;SEIF;1;Mathématiques et leurs interactions;2021;2020-21;2020;2020;2;1;1;4;2;2;0;0;0;0;0;0;0;TnAPh
138;École doctorale Lettres, langues, spectacles;LLS;9;Sciences et technologies de l'information et de la communication;2021;2020-21;2020;2020;0;0;0;1;1;0;0;0;0;0;0;0;0;y9O3k
141;École doctorale Droit et science politique;DSP;7;Sciences de la société;2021;2020-21;2020;2020;50;25;25;298;145;153;24;12;12;3;5;9;7;CyNBf
146;École doctorale Galilée;GALILEE;4;Chimie;2021;2020-21;2020;2020;1;1;0;8;6;2;1;0;1;0;1;0;0;71hqm
146;École doctorale Galilée;GALILEE;8;Sciences pour l'ingénieur;2021;2020-21;2020;2020;11;3;8;56;15;41;6;2;4;2;4;0;0;71hqm
162;École doctorale Mécanique, énergétique, génie civil, acoustique;MEGA;8;Sciences pour l'ingénieur;2021;2020-21;2020;2020;71;15;56;373;106;267;106;20;86;47;44;15;0;7wCke
166;École doctorale Information, structures et systèmes;I2S;8;Sciences pour l'ingénieur;2021;2020-21;2020;2020;37;11;26;139;30;109;31;5;26;15;13;3;0;2uO68
178;École doctorale Sciences fondamentales;;3;Sciences de la terre et de l'univers, espace;2021;2020-21;2020;2020;8;1;7;30;10;20;5;2;3;4;1;0;0;1AiR7
182;École doctorale Physique et chimie-physique;;2;Physique;2021;2020-21;2020;2020;26;9;17;112;34;78;28;8;20;23;4;0;1;3My6I
184;École doctorale Mathématiques et informatique de Marseille;;5;Biologie, médecine et santé;2021;2020-21;2020;2020;2;1;1;3;1;2;0;0;0;0;0;0;0;DDObG
216;École doctorale Ingénierie pour la santé, la cognition, l'environnement;EDISCE;5;Biologie, médecine et santé;2021;2020-21;2020;2020;33;17;16;126;59;67;21;10;11;11;5;4;1;fPs1t
216;École doctorale Ingénierie pour la santé, la cognition, l'environnement;EDISCE;8;Sciences pour l'ingénieur;2021;2020-21;2020;2020;2;0;2;16;9;7;0;0;0;0;0;0;0;fPs1t
217;École doctorale Mathématiques, sciences et technologies de l'information, informatique;MSTII;5;Biologie, médecine et santé;2021;2020-21;2020;2020;1;1;0;7;1;6;2;0;2;1;1;0;0;Ehx7v
218;École doctorale Chimie et sciences du vivant;EDCSV;5;Biologie, médecine et santé;2021;2020-21;2020;2020;62;35;27;217;127;90;41;24;17;17;21;3;0;8bcJh
222;École doctorale Sciences chimiques;EDSC;4;Chimie;2021;2020-21;2020;2020;85;33;52;268;112;156;66;26;40;47;18;1;0;AdU8Q
227;École doctorale Sciences de la nature et de l'homme;;4;Chimie;2021;2020-21;2020;2020;7;4;3;11;6;5;0;0;0;0;0;0;0;xiDA5
227;École doctorale Sciences de la nature et de l'homme;;5;Biologie, médecine et santé;2021;2020-21;2020;2020;36;19;17;114;59;55;25;12;13;17;8;0;0;xiDA5
227;École doctorale Sciences de la nature et de l'homme;;6;Sciences humaines et humanités;2021;2020-21;2020;2020;6;6;0;31;24;7;7;2;5;5;2;0;0;xiDA5
242;École doctorale Économie - Gestion - Normandie;;7;Sciences de la société;2021;2020-21;2020;2020;19;4;15;68;27;41;17;8;9;2;4;10;1;z35ku
267;École doctorale Arts et médias;;6;Sciences humaines et humanités;2021;2020-21;2020;2020;23;12;11;154;93;61;16;12;4;2;2;7;5;eCF5C
269;École doctorale Mathématiques, sciences de l'information et de l'ingénieur;MSII;1;Mathématiques et leurs interactions;2021;2020-21;2020;2020;10;1;9;42;7;35;11;4;7;6;4;1;0;5E625
275;École doctorale Sciences de gestion;EDSG;7;Sciences de la société;2021;2020-21;2020;2020;14;7;7;54;27;27;12;7;5;4;5;3;0;6QC4I
280;École doctorale Philosophie;;7;Sciences de la société;2021;2020-21;2020;2020;44;16;28;251;100;151;26;7;19;5;5;6;10;kJxnm
284;École doctorale Droit et Science Politique;DSP;6;Sciences humaines et humanités;2021;2020-21;2020;2020;5;4;1;42;26;16;20;15;5;4;7;6;3;ahH92
286;École doctorale de l'Ehess;;7;Sciences de la société;2021;2020-21;2020;2020;146;63;83;907;489;418;109;61;48;6;9;33;61;2S146
300;École doctorale Sciences Économiques;ED SE;1;Mathématiques et leurs interactions;2021;2020-21;2020;2020;1;1;0;1;1;0;0;0;0;0;0;0;0;5x3fM
300;École doctorale Sciences Économiques;ED SE;7;Sciences de la société;2021;2020-21;2020;2020;9;2;7;28;11;17;8;2;6;0;5;3;0;5x3fM
304;École doctorale Sciences et environnements;;7;Sciences de la société;2021;2020-21;2020;2020;4;2;2;9;7;2;2;2;0;0;2;0;0;2ywZn
305;École doctorale Énergie et environnement;E2;9;Sciences et technologies de l'information et de la communication;2021;2020-21;2020;2020;0;0;0;4;2;2;0;0;0;0;0;0;0;Kbt8I
323;École doctorale Génie électrique, électronique et télécommunications;GEET;8;Sciences pour l'ingénieur;2021;2020-21;2020;2020;42;6;36;152;31;121;45;12;33;22;15;7;1;arcz6
323;École doctorale Génie électrique, électronique et télécommunications;GEET;9;Sciences et technologies de l'information et de la communication;2021;2020-21;2020;2020;4;2;2;39;9;30;13;1;12;3;9;1;0;arcz6
326;École doctorale Comportement, langage, éducation, socialisation, cognition;CLESCO;6;Sciences humaines et humanités;2021;2020-21;2020;2020;37;25;12;255;169;86;39;21;18;11;15;12;1;nWIlG
326;École doctorale Comportement, langage, éducation, socialisation, cognition;CLESCO;9;Sciences et technologies de l'information et de la communication;2021;2020-21;2020;2020;0;0;0;2;1;1;0;0;0;0;0;0;0;nWIlG
327;École doctorale Temps, espaces, sociétés, cultures;TESC;5;Biologie, médecine et santé;2021;2020-21;2020;2020;0;0;0;5;3;2;2;1;1;0;1;1;0;IjgiJ
340;École doctorale Biologie moléculaire, intégrative et cellulaire;BMIC;5;Biologie, médecine et santé;2021;2020-21;2020;2020;86;60;26;296;182;114;70;42;28;20;46;4;0;db7xq
341;École doctorale Évolution, écosystèmes, microbiologie, modélisation;E2M2;3;Sciences de la terre et de l'univers, espace;2021;2020-21;2020;2020;0;0;0;3;2;1;3;1;2;1;2;0;0;J83I0
352;École doctorale Physique et sciences de la matière;;2;Physique;2021;2020-21;2020;2020;73;24;49;254;82;172;61;21;40;43;14;4;0;fb5YC
354;École doctorale Langues, lettres et arts;LLA;6;Sciences humaines et humanités;2021;2020-21;2020;2020;47;31;16;233;156;77;28;17;11;1;4;13;10;RwcSv
355;École doctorale Espaces, cultures, sociétés;;7;Sciences de la société;2021;2020-21;2020;2020;12;6;6;73;43;30;6;3;3;0;1;3;2;2kMf5
364;École doctorale Sciences fondamentales et appliquées;EDSFA;1;Mathématiques et leurs interactions;2021;2020-21;2020;2020;25;7;18;74;19;55;21;3;18;15;6;0;0;E483q
377;École doctorale Environnement et société;;3;Sciences de la terre et de l'univers, espace;2021;2020-21;2020;2020;1;1;0;2;2;0;1;1;0;1;0;0;0;ZMG5u
377;École doctorale Environnement et société;;9;Sciences et technologies de l'information et de la communication;2021;2020-21;2020;2020;4;1;3;10;1;9;2;0;2;0;1;1;0;ZMG5u
386;École doctorale Sciences mathématiques de Paris centre;SMPC;1;Mathématiques et leurs interactions;2021;2020-21;2020;2020;144;27;117;489;101;388;92;13;79;47;38;7;0;wMj98
388;École doctorale Chimie physique et chimie analytique de Paris centre;CPCA;4;Chimie;2021;2020-21;2020;2020;86;40;46;333;150;183;59;23;36;52;6;0;1;M0Hnd
394;École doctorale Physiologie et physiopathologie;p2t;5;Biologie, médecine et santé;2021;2020-21;2020;2020;68;35;33;217;128;89;54;33;21;27;20;5;2;VMYmT
396;École doctorale Économie, organisations, société;EOS;6;Sciences humaines et humanités;2021;2020-21;2020;2020;5;2;3;11;4;7;0;0;0;0;0;0;0;Es5e7
396;École doctorale Économie, organisations, société;EOS;7;Sciences de la société;2021;2020-21;2020;2020;32;12;20;135;61;74;21;9;12;6;8;1;6;Es5e7
401;École doctorale Sciences sociales;;9;Sciences et technologies de l'information et de la communication;2021;2020-21;2020;2020;0;0;0;0;0;0;1;0;1;0;0;0;1;raQ7K
402;École doctorale Sciences de la vie et de la santé;SVS;5;Biologie, médecine et santé;2021;2020-21;2020;2020;34;25;9;134;85;49;18;10;8;6;10;2;0;YKgsU
405;École doctorale Économie, management,mathématiques et physique de Cergy;EM2C;9;Sciences et technologies de l'information et de la communication;2021;2020-21;2020;2020;12;1;11;45;9;36;5;2;3;2;3;0;0;QbwSB
413;École doctorale Sciences de la terre et de l'environnement;STE;6;Sciences humaines et humanités;2021;2020-21;2020;2020;2;0;2;15;6;9;4;2;2;1;1;2;0;u9BA9
417;École doctorale Sciences et Ingénierie;S&I;2;Physique;2021;2020-21;2020;2020;1;0;1;9;4;5;6;1;5;4;1;1;0;SSBvE
417;École doctorale Sciences et Ingénierie;S&I;5;Biologie, médecine et santé;2021;2020-21;2020;2020;2;1;1;14;9;5;1;1;0;0;1;0;0;SSBvE
433;École doctorale Concepts et langages;;7;Sciences de la société;2021;2020-21;2020;2020;6;6;0;22;11;11;6;3;3;0;1;4;1;v8q34
446;École doctorale Biologie - Santé;EDBSL;1;Mathématiques et leurs interactions;2021;2020-21;2020;2020;0;0;0;2;1;1;0;0;0;0;0;0;0;4iEUF
454;École doctorale Sciences de l'homme, du politique et du territoire;SHPT;6;Sciences humaines et humanités;2021;2020-21;2020;2020;29;14;15;180;96;84;20;7;13;1;2;9;8;Opv31
463;École doctorale Sciences du mouvement humain;SMH;7;Sciences de la société;2021;2020-21;2020;2020;0;0;0;0;0;0;1;0;1;0;1;0;0;UbtlY
469;École doctorale du Pacifique;EDP;2;Physique;2021;2020-21;2020;2020;1;0;1;2;0;2;1;1;0;1;0;0;0;t9Z2n
469;École doctorale du Pacifique;EDP;5;Biologie, médecine et santé;2021;2020-21;2020;2020;3;3;0;10;6;4;1;0;1;0;1;0;0;t9Z2n
472;École doctorale de l'EPHE;;4;Chimie;2021;2020-21;2020;2020;0;0;0;1;1;0;0;0;0;0;0;0;0;27zK4
472;École doctorale de l'EPHE;;6;Sciences humaines et humanités;2021;2020-21;2020;2020;67;31;36;480;254;226;44;27;17;6;8;15;15;27zK4
472;École doctorale de l'EPHE;;7;Sciences de la société;2021;2020-21;2020;2020;4;3;1;34;20;14;0;0;0;0;0;0;0;27zK4
472;École doctorale de l'EPHE;;9;Sciences et technologies de l'information et de la communication;2021;2020-21;2020;2020;1;0;1;4;2;2;3;1;2;2;1;0;0;27zK4
474;École doctorale Interdisciplinaire européenne frontières du vivant;FDV;3;Sciences de la terre et de l'univers, espace;2021;2020-21;2020;2020;0;0;0;1;0;1;3;1;2;1;2;0;0;E727j
474;École doctorale Interdisciplinaire européenne frontières du vivant;FDV;5;Biologie, médecine et santé;2021;2020-21;2020;2020;25;20;5;77;46;31;16;10;6;9;7;0;0;E727j
474;École doctorale Interdisciplinaire européenne frontières du vivant;FDV;6;Sciences humaines et humanités;2021;2020-21;2020;2020;3;2;1;16;7;9;5;3;2;2;3;0;0;E727j
475;École doctorale Mathématiques, informatique, télécommunications de Toulouse;MITT;9;Sciences et technologies de l'information et de la communication;2021;2020-21;2020;2020;76;16;60;275;65;210;55;12;43;19;29;5;2;xcp2r
476;École doctorale Neurosciences et cognition;NSCO;5;Biologie, médecine et santé;2021;2020-21;2020;2020;29;15;14;139;81;58;28;14;14;12;13;2;1;B1H0x
479;École doctorale Sciences juridiques et politiques;;7;Sciences de la société;2021;2020-21;2020;2020;42;24;18;265;135;130;27;15;12;2;3;8;14;34mid
480;École doctorale Montaigne-humanités;;2;Physique;2021;2020-21;2020;2020;0;0;0;6;5;1;0;0;0;0;0;0;0;f3SeZ
482;École doctorale Sciences de la matière;SDM;4;Chimie;2021;2020-21;2020;2020;42;17;25;163;75;88;50;25;25;35;14;1;0;kmeZ4
482;École doctorale Sciences de la matière;SDM;5;Biologie, médecine et santé;2021;2020-21;2020;2020;2;1;1;6;2;4;3;2;1;3;0;0;0;kmeZ4
482;École doctorale Sciences de la matière;SDM;8;Sciences pour l'ingénieur;2021;2020-21;2020;2020;11;7;4;40;13;27;14;3;11;7;6;1;0;kmeZ4
488;École doctorale Sciences, ingénierie, santé;SIS;4;Chimie;2021;2020-21;2020;2020;3;0;3;15;6;9;0;0;0;0;0;0;0;Fy2lK
488;École doctorale Sciences, ingénierie, santé;SIS;10;Sciences agronomiques et écologiques;2021;2020-21;2020;2020;2;1;1;4;2;2;1;1;0;1;0;0;0;Fy2lK
489;École doctorale Sciences et ingénierie des systèmes, de l'environnement et des organisations;SISEO;2;Physique;2021;2020-21;2020;2020;0;0;0;2;0;2;0;0;0;0;0;0;0;6pT77
489;École doctorale Sciences et ingénierie des systèmes, de l'environnement et des organisations;SISEO;6;Sciences humaines et humanités;2021;2020-21;2020;2020;21;8;13;52;25;27;4;2;2;0;0;3;1;6pT77
489;École doctorale Sciences et ingénierie des systèmes, de l'environnement et des organisations;SISEO;10;Sciences agronomiques et écologiques;2021;2020-21;2020;2020;0;0;0;7;4;3;1;0;1;0;0;1;0;6pT77
497;École doctorale Normande de Biologie Intégrative, Santé, Environnement;Ed NBISE;9;Sciences et technologies de l'information et de la communication;2021;2020-21;2020;2020;0;0;0;2;0;2;0;0;0;0;0;0;0;0D9Je
530;École doctorale Organisations, marchés, institutions;OMI;9;Sciences et technologies de l'information et de la communication;2021;2020-21;2020;2020;3;2;1;7;6;1;0;0;0;0;0;0;0;4htv7
531;École doctorale Sciences, ingénierie et environnement;SIE;8;Sciences pour l'ingénieur;2021;2020-21;2020;2020;72;26;46;236;95;141;57;19;38;33;17;7;0;b5BYq
532;École doctorale Mathématiques et sciences et technologies de l'information et de la communication;MSTIC;1;Mathématiques et leurs interactions;2021;2020-21;2020;2020;22;5;17;83;16;67;15;2;13;12;2;0;1;t43KM
536;École doctorale Sciences et agrosciences;;5;Biologie, médecine et santé;2021;2020-21;2020;2020;1;0;1;7;5;2;1;0;1;1;0;0;0;pHfqe
540;"École doctorale École transdisciplinaire ""lettres/sciences""";;2;Physique;2021;2020-21;2020;2020;0;0;0;2;1;1;0;0;0;0;0;0;0;tWWw7
540;"École doctorale École transdisciplinaire ""lettres/sciences""";;3;Sciences de la terre et de l'univers, espace;2021;2020-21;2020;2020;1;1;0;1;1;0;0;0;0;0;0;0;0;tWWw7
540;"École doctorale École transdisciplinaire ""lettres/sciences""";;5;Biologie, médecine et santé;2021;2020-21;2020;2020;1;0;1;2;0;2;0;0;0;0;0;0;0;tWWw7
541;École doctorale de sciences humaines et sociales de La Réunion;SHS;6;Sciences humaines et humanités;2021;2020-21;2020;2020;15;10;5;89;64;25;7;6;1;3;1;0;3;21SpE
541;École doctorale de sciences humaines et sociales de La Réunion;SHS;9;Sciences et technologies de l'information et de la communication;2021;2020-21;2020;2020;0;0;0;4;3;1;0;0;0;0;0;0;0;21SpE
542;École doctorale de sciences de La Réunion;STS;8;Sciences pour l'ingénieur;2021;2020-21;2020;2020;0;0;0;11;3;8;2;0;2;0;0;2;0;2pAql
543;École doctorale de Dauphine;;7;Sciences de la société;2021;2020-21;2020;2020;52;19;33;265;122;143;48;22;26;5;25;16;2;u8w6A
545;École doctorale Sociétés, politique et santé publique;SP2;7;Sciences de la société;2021;2020-21;2020;2020;30;16;14;122;62;60;9;4;5;0;2;6;1;IAKR4
546;École doctorale Abbé Grégoire;;7;Sciences de la société;2021;2020-21;2020;2020;0;0;0;59;36;23;13;4;9;0;5;1;7;ZSn7q
546;École doctorale Abbé Grégoire;;9;Sciences et technologies de l'information et de la communication;2021;2020-21;2020;2020;0;0;0;4;2;2;0;0;0;0;0;0;0;ZSn7q
548;École doctorale Mer et Sciences;;1;Mathématiques et leurs interactions;2021;2020-21;2020;2020;2;1;1;14;7;7;4;0;4;2;1;1;0;QX0fS
551;École doctorale Mathématiques, Informatique, Physique Théorique et Ingénierie des Systèmes;MIPTIS;2;Physique;2021;2020-21;2020;2020;2;0;2;8;0;8;1;0;1;0;1;0;0;Mpudz
552;École doctorale Énergie - Matériaux - Sciences de la Terre et de l'Univers;EMTSU;2;Physique;2021;2020-21;2020;2020;18;5;13;49;18;31;11;5;6;5;5;1;0;NTZhw
554;École doctorale Environnements - Santé;E-S;4;Chimie;2021;2020-21;2020;2020;0;0;0;0;0;0;3;2;1;1;2;0;0;ElyFU
554;École doctorale Environnements - Santé;E-S;8;Sciences pour l'ingénieur;2021;2020-21;2020;2020;1;1;0;4;4;0;1;0;1;0;1;0;0;ElyFU
556;École doctorale Homme, Sociétés, Risques, Territoire;HSRT;5;Biologie, médecine et santé;2021;2020-21;2020;2020;2;2;0;15;10;5;4;3;1;1;3;0;0;5QEaX
558;École doctorale Histoire, Mémoire, Patrimoine, Langage;HMPL;6;Sciences humaines et humanités;2021;2020-21;2020;2020;58;27;31;318;158;160;34;14;20;7;4;15;8;uX3jT
559;École doctorale Management Panthéon-Sorbonne;;1;Mathématiques et leurs interactions;2021;2020-21;2020;2020;2;1;1;17;9;8;1;1;0;0;0;1;0;4SP7k
560;École doctorale Sciences de la terre et de l'environnement et Physique de l'univers, Paris;STEP'UP;3;Sciences de la terre et de l'univers, espace;2021;2020-21;2020;2020;32;15;17;116;56;60;27;9;18;12;12;2;1;Z2VI9
563;École doctorale Médicament - Toxicologie - Chimie - Imageries;MTCI;5;Biologie, médecine et santé;2021;2020-21;2020;2020;25;3;22;169;93;76;23;12;11;10;13;0;0;j8uk1
564;École doctorale Physique en Ile de France;PIF;2;Physique;2021;2020-21;2020;2020;195;45;150;666;147;519;131;24;107;95;33;2;1;39AcN
565;École doctorale Droit de la Sorbonne;DS;7;Sciences de la société;2021;2020-21;2020;2020;95;52;43;601;316;285;42;25;17;5;2;13;22;aXJ7L
570;École doctorale Santé Publique;EDSP;7;Sciences de la société;2021;2020-21;2020;2020;0;0;0;2;1;1;0;0;0;0;0;0;0;9lgE4
573;École doctorale Interfaces : Approches Interdisciplinaires, Fondements, Applications et Innovation;ED INTERFACES;4;Chimie;2021;2020-21;2020;2020;4;3;1;16;10;6;3;2;1;1;2;0;0;gG820
573;École doctorale Interfaces : Approches Interdisciplinaires, Fondements, Applications et Innovation;ED INTERFACES;5;Biologie, médecine et santé;2021;2020-21;2020;2020;2;1;1;6;2;4;3;2;1;1;1;1;0;gG820
573;École doctorale Interfaces : Approches Interdisciplinaires, Fondements, Applications et Innovation;ED INTERFACES;9;Sciences et technologies de l'information et de la communication;2021;2020-21;2020;2020;2;0;2;11;0;11;3;1;2;1;2;0;0;gG820
575;École doctorale Electrical, Optical, Bio : Physics and Engineering;EOBE;8;Sciences pour l'ingénieur;2021;2020-21;2020;2020;42;14;28;135;34;101;25;8;17;14;9;2;0;dfhyn
576;École doctorale Particules, Hadrons, Énergie, Noyau, Instrumentation, Imagerie, Cosmos et Simulation;PHENIICS;2;Physique;2021;2020-21;2020;2020;66;18;48;168;51;117;47;13;34;36;9;2;0;qC4rf
576;École doctorale Particules, Hadrons, Énergie, Noyau, Instrumentation, Imagerie, Cosmos et Simulation;PHENIICS;5;Biologie, médecine et santé;2021;2020-21;2020;2020;1;0;1;1;0;1;1;0;1;1;0;0;0;qC4rf
576;École doctorale Particules, Hadrons, Énergie, Noyau, Instrumentation, Imagerie, Cosmos et Simulation;PHENIICS;8;Sciences pour l'ingénieur;2021;2020-21;2020;2020;1;1;0;8;1;7;0;0;0;0;0;0;0;qC4rf
579;École doctorale Sciences mécaniques et energétiques, matériaux et géosciences;SMEMaG;3;Sciences de la terre et de l'univers, espace;2021;2020-21;2020;2020;9;4;5;50;24;26;12;5;7;6;6;0;0;atMj7
581;École doctorale Agriculture, alimentation, biologie, environnement, santé;ABIES;3;Sciences de la terre et de l'univers, espace;2021;2020-21;2020;2020;1;0;1;3;1;2;1;1;0;0;1;0;0;c1x56
581;École doctorale Agriculture, alimentation, biologie, environnement, santé;ABIES;7;Sciences de la société;2021;2020-21;2020;2020;12;12;0;59;39;20;11;7;4;2;5;3;1;c1x56
583;École doctorale Risques et Société;;8;Sciences pour l'ingénieur;2021;2020-21;2020;2020;0;0;0;3;0;3;1;1;0;0;1;0;0;wUBi9
584;École doctorale Biodiversité, Agriculture, Alimentation, Environnement, Terre, Eau;GAIA;8;Sciences pour l'ingénieur;2021;2020-21;2020;2020;1;1;0;8;6;2;5;3;2;3;2;0;0;F1h5f
585;École doctorale Sciences, Technologie,  Sante;EDSTS;1;Mathématiques et leurs interactions;2021;2020-21;2020;2020;7;2;5;35;16;19;5;3;2;5;0;0;0;NM3Dl
585;École doctorale Sciences, Technologie,  Sante;EDSTS;8;Sciences pour l'ingénieur;2021;2020-21;2020;2020;11;5;6;57;24;33;5;1;4;4;1;0;0;NM3Dl
587;École doctorale Diversites, santé et développement en Amazonie;;5;Biologie, médecine et santé;2021;2020-21;2020;2020;5;2;3;24;16;8;5;4;1;2;1;1;1;V14tj
587;École doctorale Diversites, santé et développement en Amazonie;;10;Sciences agronomiques et écologiques;2021;2020-21;2020;2020;2;1;1;2;1;1;2;1;1;2;0;0;0;V14tj
589;École doctorale Milieu insulaire tropical à risques : protection, valorisation , santé et développement;;5;Biologie, médecine et santé;2021;2020-21;2020;2020;8;5;3;36;24;12;3;2;1;0;2;1;0;2cqi3
589;École doctorale Milieu insulaire tropical à risques : protection, valorisation , santé et développement;;9;Sciences et technologies de l'information et de la communication;2021;2020-21;2020;2020;0;0;0;3;1;2;1;0;1;0;1;0;0;2cqi3
594;École doctorale Sociétés, Espaces, Pratiques, Temps;ED SEPT;6;Sciences humaines et humanités;2021;2020-21;2020;2020;57;33;24;283;137;146;31;11;20;6;4;9;12;N85H3
598;École doctorale Sciences de La Mer et du Littoral;SML;10;Sciences agronomiques et écologiques;2021;2020-21;2020;2020;17;10;7;57;35;22;18;10;8;8;10;0;0;Smen6
599;École doctorale Droit et Science Politique;DSP;7;Sciences de la société;2021;2020-21;2020;2020;65;30;35;354;167;187;45;19;26;2;4;17;22;6rwtT
601;École doctorale Mathématiques et Sciences et Technologies de l'information et de la Communication;MathSTIC;8;Sciences pour l'ingénieur;2021;2020-21;2020;2020;6;1;5;20;4;16;7;3;4;2;4;1;0;3Ue20
602;École doctorale Sciences pour l'Ingénieur;SPI;8;Sciences pour l'ingénieur;2021;2020-21;2020;2020;112;31;81;517;164;353;111;30;81;65;40;6;0;8yWbu
603;École doctorale Éducation, Langages, Interactions, Cognition, Clinique, Expertise - ED 603;ELICCE;6;Sciences humaines et humanités;2021;2020-21;2020;2020;65;42;23;345;200;145;63;38;25;9;22;18;14;1Mzw7
605;École doctorale Biologie Santé;ED BS;4;Chimie;2021;2020-21;2020;2020;1;1;0;1;1;0;0;0;0;0;0;0;0;w8CxU
607;École doctorale Sciences et Ingénierie des Ressources Naturelles;SIReNA;3;Sciences de la terre et de l'univers, espace;2021;2020-21;2020;2020;14;4;10;73;29;44;14;5;9;10;3;1;0;vi9w2
607;École doctorale Sciences et Ingénierie des Ressources Naturelles;SIReNA;8;Sciences pour l'ingénieur;2021;2020-21;2020;2020;1;0;1;8;3;5;4;1;3;1;3;0;0;vi9w2
608;École doctorale Sciences et Ingénierie des Molécules, des Produits, des Procédés et de l'Énergie;SIMPPÉ;10;Sciences agronomiques et écologiques;2021;2020-21;2020;2020;3;2;1;9;6;3;3;1;2;1;1;1;0;TyNjM
610;École doctorale Sciences et Ingénierie des Systèmes, Mathématiques, Informatique;SISMI;8;Sciences pour l'ingénieur;2021;2020-21;2020;2020;15;4;11;55;19;36;12;3;9;5;5;2;0;dBCUB
616;École doctorale Humanités et Langues;H&L;5;Biologie, médecine et santé;2021;2020-21;2020;2020;1;0;1;6;2;4;2;1;1;0;0;2;0;FYOlf
617;École doctorale Sciences de la Société : Territoires, Economie et Droit;SSTED;10;Sciences agronomiques et écologiques;2021;2020-21;2020;2020;0;0;0;1;0;1;0;0;0;0;0;0;0;Kl9ZX
618;École doctorale EUCLIDE;;6;Sciences humaines et humanités;2021;2020-21;2020;2020;4;2;2;23;13;10;1;0;1;1;0;0;0;qveTN
619;École doctorale Sciences Fondamentales et Santé;SFS;1;Mathématiques et leurs interactions;2021;2020-21;2020;2020;1;0;1;4;1;3;0;0;0;0;0;0;0;JiZVW
619;École doctorale Sciences Fondamentales et Santé;SFS;5;Biologie, médecine et santé;2021;2020-21;2020;2020;25;12;13;79;41;38;13;8;5;4;5;2;2;JiZVW
620;École doctorale Sciences du Numérique et de l'Ingénieur;SNI;5;Biologie, médecine et santé;2021;2020-21;2020;2020;0;0;0;2;2;0;0;0;0;0;0;0;0;Dr40w
620;École doctorale Sciences du Numérique et de l'Ingénieur;SNI;8;Sciences pour l'ingénieur;2021;2020-21;2020;2020;8;2;6;58;21;37;11;2;9;3;4;4;0;Dr40w
621;École doctorale Ingénierie des Systèmes, Matériaux, Mécanique, Énergétique;ISMME;8;Sciences pour l'ingénieur;2021;2020-21;2020;2020;49;12;37;212;52;160;58;14;44;33;17;7;1;B2549
623;École doctorale Savoir, Sciences, Éducation;SSE;1;Mathématiques et leurs interactions;2021;2020-21;2020;2020;1;1;0;16;8;8;2;2;0;1;0;1;0;98lMD
623;École doctorale Savoir, Sciences, Éducation;SSE;6;Sciences humaines et humanités;2021;2020-21;2020;2020;7;1;6;60;36;24;7;4;3;0;2;4;1;98lMD
624;École doctorale Sciences des Sociétés;SDS;7;Sciences de la société;2021;2020-21;2020;2020;31;23;8;189;116;73;18;11;7;1;2;10;5;cGIjW
626;École doctorale de l’Institut Polytechnique de Paris;;7;Sciences de la société;2021;2020-21;2020;2020;21;9;12;110;44;66;33;13;20;4;18;9;2;DL5fO
626;École doctorale de l’Institut Polytechnique de Paris;;8;Sciences pour l'ingénieur;2021;2020-21;2020;2020;44;11;33;109;34;75;13;3;10;9;2;2;0;DL5fO
626;École doctorale de l’Institut Polytechnique de Paris;;9;Sciences et technologies de l'information et de la communication;2021;2020-21;2020;2020;83;27;56;326;91;235;81;18;63;44;35;2;0;DL5fO
630;École doctorale Droit, Economie et Management;DEM;9;Sciences et technologies de l'information et de la communication;2021;2020-21;2020;2020;0;0;0;1;1;0;0;0;0;0;0;0;0;78n8c
31;École doctorale Pratiques et théories du sens;;6;Sciences humaines et humanités;2022;2021-22;2021;2021;58;25;33;344;188;156;72;37;35;4;10;18;40;1S466
39;École doctorale Mathématiques et Informatique;EDMIB;1;Mathématiques et leurs interactions;2022;2021-22;2021;2021;29;8;21;110;36;74;23;5;18;17;6;0;0;TBj2X
39;École doctorale Mathématiques et Informatique;EDMIB;9;Sciences et technologies de l'information et de la communication;2022;2021-22;2021;2021;28;8;20;117;30;87;28;6;22;11;12;5;0;TBj2X
40;École doctorale Sciences chimiques;EDSC;5;Biologie, médecine et santé;2022;2021-22;2021;2021;0;0;0;6;5;1;1;1;0;0;1;0;0;wde3D
47;École doctorale Physique;;1;Mathématiques et leurs interactions;2022;2021-22;2021;2021;0;0;0;1;0;1;0;0;0;0;0;0;0;8kNpd
47;École doctorale Physique;;2;Physique;2022;2021-22;2021;2021;112;24;88;359;83;276;89;14;75;48;39;2;0;8kNpd
47;École doctorale Physique;;3;Sciences de la terre et de l'univers, espace;2022;2021-22;2021;2021;5;1;4;12;2;10;2;1;1;0;2;0;0;8kNpd
58;École doctorale Langues, littératures, cultures, civilisations;LLCC;6;Sciences humaines et humanités;2022;2021-22;2021;2021;105;61;44;484;290;194;62;27;35;3;14;18;27;I9ATR
60;École doctorale Territoires, temps, sociétés et développement;TTSD;6;Sciences humaines et humanités;2022;2021-22;2021;2021;28;21;7;175;113;62;36;20;16;4;13;9;10;fkIh6
71;École doctorale Sciences pour l'ingénieur;;4;Chimie;2022;2021-22;2021;2021;2;2;0;5;2;3;1;1;0;1;0;0;0;H6UYp
71;École doctorale Sciences pour l'ingénieur;;9;Sciences et technologies de l'information et de la communication;2022;2021-22;2021;2021;11;0;11;50;5;45;12;2;10;4;7;1;0;H6UYp
72;École doctorale Sciences pour l'ingénieur;SPI;8;Sciences pour l'ingénieur;2022;2021-22;2021;2021;0;0;0;0;0;0;26;7;19;11;15;0;0;47QPx
72;École doctorale Sciences pour l'ingénieur;SPI;9;Sciences et technologies de l'information et de la communication;2022;2021-22;2021;2021;0;0;0;0;0;0;43;10;33;10;26;7;0;47QPx
77;École doctorale Informatique, automatique, électronique, électrotechnique, mathématiques;IAEM;8;Sciences pour l'ingénieur;2022;2021-22;2021;2021;5;1;4;30;6;24;7;1;6;1;5;1;0;TCHTA
119;École doctorale Science politique;;7;Sciences de la société;2022;2021-22;2021;2021;11;4;7;83;43;40;7;4;3;0;0;0;7;eyibb
122;École doctorale Europe latine - Amérique latine;;7;Sciences de la société;2022;2021-22;2021;2021;6;3;3;42;25;17;4;3;1;0;1;1;2;z9lZY
129;École doctorale Sciences de l'environnement d'Ile de France;SEIF;1;Mathématiques et leurs interactions;2022;2021-22;2021;2021;0;0;0;4;2;2;0;0;0;0;0;0;0;TnAPh
129;École doctorale Sciences de l'environnement d'Ile de France;SEIF;8;Sciences pour l'ingénieur;2022;2021-22;2021;2021;0;0;0;2;1;1;1;0;1;0;1;0;0;TnAPh
130;École doctorale Informatique, télécommunications et électronique de Paris;EDITE;8;Sciences pour l'ingénieur;2022;2021-22;2021;2021;8;2;6;41;22;19;6;1;5;4;1;1;0;O5ysj
131;École doctorale Langue, littérature, image, civilisations et sciences humaines (domaines francophone et anglophone);LLI;6;Sciences humaines et humanités;2022;2021-22;2021;2021;30;23;7;160;111;49;18;10;8;0;0;9;9;a47aW
138;École doctorale Lettres, langues, spectacles;LLS;6;Sciences humaines et humanités;2022;2021-22;2021;2021;39;29;10;231;153;78;22;14;8;1;2;12;7;y9O3k
139;École doctorale Connaissance, langage, modélisation;CLM;6;Sciences humaines et humanités;2022;2021-22;2021;2021;48;24;24;268;158;110;35;16;19;6;13;8;8;1lxGH
139;École doctorale Connaissance, langage, modélisation;CLM;8;Sciences pour l'ingénieur;2022;2021-22;2021;2021;4;1;3;12;2;10;6;2;4;2;2;1;1;1lxGH
141;École doctorale Droit et science politique;DSP;7;Sciences de la société;2022;2021-22;2021;2021;34;14;20;290;142;148;40;17;23;6;2;6;26;CyNBf
146;École doctorale Galilée;GALILEE;5;Biologie, médecine et santé;2022;2021-22;2021;2021;16;8;8;57;42;15;16;11;5;5;9;2;0;71hqm
158;École doctorale Cerveau, cognition, comportement;3C;5;Biologie, médecine et santé;2022;2021-22;2021;2021;120;67;53;411;221;190;95;56;39;0;75;20;0;Il62F
162;École doctorale Mécanique, énergétique, génie civil, acoustique;MEGA;2;Physique;2022;2021-22;2021;2021;0;0;0;3;0;3;0;0;0;0;0;0;0;7wCke
162;École doctorale Mécanique, énergétique, génie civil, acoustique;MEGA;8;Sciences pour l'ingénieur;2022;2021-22;2021;2021;80;24;56;371;104;267;80;28;52;34;42;4;0;7wCke
166;École doctorale Information, structures et systèmes;I2S;3;Sciences de la terre et de l'univers, espace;2022;2021-22;2021;2021;1;0;1;1;0;1;2;0;2;0;2;0;0;2uO68
166;École doctorale Information, structures et systèmes;I2S;5;Biologie, médecine et santé;2022;2021-22;2021;2021;1;0;1;10;4;6;1;0;1;0;1;0;0;2uO68
173;École doctorale Sciences de l'univers, de l'environnement et de l'espace;SDU2E;1;Mathématiques et leurs interactions;2022;2021-22;2021;2021;1;0;1;2;0;2;0;0;0;0;0;0;0;R0Z9c
182;École doctorale Physique et chimie-physique;;3;Sciences de la terre et de l'univers, espace;2022;2021-22;2021;2021;3;0;3;5;2;3;2;0;2;2;0;0;0;3My6I
184;École doctorale Mathématiques et informatique de Marseille;;9;Sciences et technologies de l'information et de la communication;2022;2021-22;2021;2021;11;5;6;42;14;28;11;1;10;5;5;1;0;DDObG
209;École doctorale Sciences physiques et de L'ingénieur;SPI;8;Sciences pour l'ingénieur;2022;2021-22;2021;2021;21;4;17;84;22;62;20;9;11;7;11;2;0;tZcIZ
211;École doctorale Sciences exactes et leurs applications;ED SEA;3;Sciences de la terre et de l'univers, espace;2022;2021-22;2021;2021;8;3;5;28;12;16;2;0;2;1;1;0;0;1G1iC
218;École doctorale Chimie et sciences du vivant;EDCSV;1;Mathématiques et leurs interactions;2022;2021-22;2021;2021;1;1;0;1;1;0;0;0;0;0;0;0;0;8bcJh
218;École doctorale Chimie et sciences du vivant;EDCSV;10;Sciences agronomiques et écologiques;2022;2021-22;2021;2021;10;3;7;25;11;14;6;3;3;2;4;0;0;8bcJh
220;École doctorale Électronique, électrotechnique, automatique, traitement du signal;EEATS;6;Sciences humaines et humanités;2022;2021-22;2021;2021;0;0;0;1;1;0;0;0;0;0;0;0;0;IxEaw
222;École doctorale Sciences chimiques;EDSC;4;Chimie;2022;2021-22;2021;2021;86;37;49;299;129;170;66;25;41;42;24;0;0;AdU8Q
250;École doctorale Sciences chimiques;;4;Chimie;2022;2021-22;2021;2021;38;19;19;133;60;73;30;14;16;21;9;0;0;O0Fav
251;École doctorale Sciences de l'environnement;;4;Chimie;2022;2021-22;2021;2021;7;2;5;18;7;11;10;5;5;2;6;2;0;VR28y
262;École doctorale Sciences juridiques, politiques, économiques et de gestion;DEG;7;Sciences de la société;2022;2021-22;2021;2021;24;9;15;146;66;80;29;12;17;3;3;12;11;H7GyL
265;École doctorale Langues, littératures et sociétés du monde;;6;Sciences humaines et humanités;2022;2021-22;2021;2021;50;24;26;284;158;126;34;23;11;3;4;9;18;4YWGW
266;École doctorale Biologie, santé, environnement;BIOSE;5;Biologie, médecine et santé;2022;2021-22;2021;2021;48;23;25;153;79;74;39;22;17;11;17;9;2;386V9
269;École doctorale Mathématiques, sciences de l'information et de l'ingénieur;MSII;5;Biologie, médecine et santé;2022;2021-22;2021;2021;0;0;0;6;3;3;1;0;1;0;1;0;0;5E625
269;École doctorale Mathématiques, sciences de l'information et de l'ingénieur;MSII;8;Sciences pour l'ingénieur;2022;2021-22;2021;2021;61;16;45;243;69;174;48;16;32;23;19;5;1;5E625
305;École doctorale Énergie et environnement;E2;2;Physique;2022;2021-22;2021;2021;1;0;1;7;0;7;1;0;1;0;1;0;0;Kbt8I
305;École doctorale Énergie et environnement;E2;5;Biologie, médecine et santé;2022;2021-22;2021;2021;7;2;5;28;10;18;3;3;0;0;2;1;0;Kbt8I
305;École doctorale Énergie et environnement;E2;8;Sciences pour l'ingénieur;2022;2021-22;2021;2021;11;1;10;36;6;30;11;5;6;6;4;1;0;Kbt8I
309;École doctorale Systèmes;EDSYS;8;Sciences pour l'ingénieur;2022;2021-22;2021;2021;21;5;16;62;14;48;21;6;15;13;7;1;0;8TT4b
326;École doctorale Comportement, langage, éducation, socialisation, cognition;CLESCO;9;Sciences et technologies de l'information et de la communication;2022;2021-22;2021;2021;0;0;0;2;1;1;1;0;1;1;0;0;0;nWIlG
327;École doctorale Temps, espaces, sociétés, cultures;TESC;5;Biologie, médecine et santé;2022;2021-22;2021;2021;0;0;0;4;2;2;1;1;0;0;1;0;0;IjgiJ
327;École doctorale Temps, espaces, sociétés, cultures;TESC;10;Sciences agronomiques et écologiques;2022;2021-22;2021;2021;2;1;1;8;6;2;2;1;1;0;0;1;1;IjgiJ
328;École doctorale Arts, lettres, langues, philosophie et communication;ALLPH@;6;Sciences humaines et humanités;2022;2021-22;2021;2021;49;31;18;322;205;117;31;16;15;3;4;11;13;xLxMh
356;École doctorale Cognition, langage, éducation;;6;Sciences humaines et humanités;2022;2021-22;2021;2021;50;34;16;253;153;100;39;18;21;5;13;18;3;55Cpz
364;École doctorale Sciences fondamentales et appliquées;EDSFA;1;Mathématiques et leurs interactions;2022;2021-22;2021;2021;15;1;14;74;15;59;15;4;11;7;5;3;0;E483q
377;École doctorale Environnement et société;;4;Chimie;2022;2021-22;2021;2021;2;1;1;9;2;7;1;0;1;1;0;0;0;ZMG5u
386;École doctorale Sciences mathématiques de Paris centre;SMPC;1;Mathématiques et leurs interactions;2022;2021-22;2021;2021;129;27;102;493;105;388;111;18;93;49;49;12;1;wMj98
396;École doctorale Économie, organisations, société;EOS;6;Sciences humaines et humanités;2022;2021-22;2021;2021;1;0;1;9;4;5;3;0;3;0;1;0;2;Es5e7
396;École doctorale Économie, organisations, société;EOS;7;Sciences de la société;2022;2021-22;2021;2021;40;19;21;145;67;78;19;8;11;6;8;2;3;Es5e7
397;École doctorale Physique et chimie des matériaux;;2;Physique;2022;2021-22;2021;2021;10;3;7;76;26;50;28;7;21;21;7;0;0;WxSt9
398;École doctorale Géosciences, ressources naturelles et environnement;GRNE;3;Sciences de la terre et de l'univers, espace;2022;2021-22;2021;2021;22;13;9;97;39;58;20;9;11;10;9;0;1;Zi4Zf
401;École doctorale Sciences sociales;;6;Sciences humaines et humanités;2022;2021-22;2021;2021;26;13;13;144;71;73;20;9;11;1;2;3;14;raQ7K
402;École doctorale Sciences de la vie et de la santé;SVS;8;Sciences pour l'ingénieur;2022;2021-22;2021;2021;1;0;1;3;1;2;0;0;0;0;0;0;0;YKgsU
405;École doctorale Économie, management,mathématiques et physique de Cergy;EM2C;1;Mathématiques et leurs interactions;2022;2021-22;2021;2021;5;0;5;15;4;11;3;0;3;1;1;1;0;QbwSB
405;École doctorale Économie, management,mathématiques et physique de Cergy;EM2C;2;Physique;2022;2021-22;2021;2021;5;2;3;12;3;9;1;0;1;0;1;0;0;QbwSB
413;École doctorale Sciences de la terre et de l'environnement;STE;7;Sciences de la société;2022;2021-22;2021;2021;3;1;2;14;5;9;3;2;1;1;0;1;1;u9BA9
417;École doctorale Sciences et Ingénierie;S&I;5;Biologie, médecine et santé;2022;2021-22;2021;2021;2;1;1;10;6;4;5;4;1;2;3;0;0;SSBvE
432;École doctorale Sciences des métiers de l'ingénieur;SMI;1;Mathématiques et leurs interactions;2022;2021-22;2021;2021;0;0;0;2;1;1;7;2;5;6;1;0;0;nSsHB
433;École doctorale Concepts et langages;;6;Sciences humaines et humanités;2022;2021-22;2021;2021;64;39;25;290;159;131;38;25;13;9;12;6;11;v8q34
441;École doctorale Histoire de l'art;;6;Sciences humaines et humanités;2022;2021-22;2021;2021;22;16;6;157;119;38;24;16;8;1;4;10;9;d5W3U
454;École doctorale Sciences de l'homme, du politique et du territoire;SHPT;7;Sciences de la société;2022;2021-22;2021;2021;17;9;8;85;49;36;6;2;4;1;0;3;2;Opv31
459;École doctorale Sciences chimiques Balard;;4;Chimie;2022;2021-22;2021;2021;73;29;44;245;120;125;69;31;38;45;24;0;0;YFs2W
465;École doctorale Économie Panthéon Sorbonne;EPS;7;Sciences de la société;2022;2021-22;2021;2021;63;31;32;274;123;151;53;23;30;2;26;23;2;MV68S
467;École doctorale Aéronautique, astronautique;AA;4;Chimie;2022;2021-22;2021;2021;1;0;1;1;0;1;3;0;3;1;1;1;0;U7l45
467;École doctorale Aéronautique, astronautique;AA;7;Sciences de la société;2022;2021-22;2021;2021;1;0;1;5;2;3;2;2;0;1;1;0;0;U7l45
469;École doctorale du Pacifique;EDP;3;Sciences de la terre et de l'univers, espace;2022;2021-22;2021;2021;0;0;0;2;2;0;1;1;0;1;0;0;0;t9Z2n
469;École doctorale du Pacifique;EDP;4;Chimie;2022;2021-22;2021;2021;1;1;0;7;5;2;1;1;0;0;1;0;0;t9Z2n
472;École doctorale de l'EPHE;;3;Sciences de la terre et de l'univers, espace;2022;2021-22;2021;2021;4;4;0;9;8;1;3;1;2;0;1;2;0;27zK4
480;École doctorale Montaigne-humanités;;2;Physique;2022;2021-22;2021;2021;2;1;1;9;5;4;2;2;0;0;1;1;0;f3SeZ
481;École doctorale Sciences sociales et humanités;SSH;7;Sciences de la société;2022;2021-22;2021;2021;24;11;13;146;65;81;22;11;11;1;8;6;7;E3z5j
483;École doctorale Histoire, géographie, aménagement, urbanisme, archéologie, science politique, sociologie, anthropologie;SCSO;7;Sciences de la société;2022;2021-22;2021;2021;28;12;16;225;126;99;20;7;13;0;4;5;11;hc6u4
485;École doctorale Éducation, Psychologie, Information et Communication;EPIC;6;Sciences humaines et humanités;2022;2021-22;2021;2021;46;30;16;214;136;78;23;13;10;2;7;11;3;O82eL
485;École doctorale Éducation, Psychologie, Information et Communication;EPIC;7;Sciences de la société;2022;2021-22;2021;2021;2;0;2;5;1;4;0;0;0;0;0;0;0;O82eL
487;École doctorale Philosophie;PHCR;6;Sciences humaines et humanités;2022;2021-22;2021;2021;24;11;13;143;64;79;14;8;6;0;0;8;6;3BRzJ
488;École doctorale Sciences, ingénierie, santé;SIS;4;Chimie;2022;2021-22;2021;2021;4;2;2;15;6;9;3;1;2;1;2;0;0;Fy2lK
488;École doctorale Sciences, ingénierie, santé;SIS;9;Sciences et technologies de l'information et de la communication;2022;2021-22;2021;2021;27;3;24;159;39;120;32;6;26;10;20;2;0;Fy2lK
489;École doctorale Sciences et ingénierie des systèmes, de l'environnement et des organisations;SISEO;3;Sciences de la terre et de l'univers, espace;2022;2021-22;2021;2021;0;0;0;0;0;0;2;1;1;0;1;0;1;6pT77
492;École doctorale Droit;;7;Sciences de la société;2022;2021-22;2021;2021;49;26;23;256;131;125;38;22;16;2;2;13;21;kOQsX
497;École doctorale Normande de Biologie Intégrative, Santé, Environnement;Ed NBISE;5;Biologie, médecine et santé;2022;2021-22;2021;2021;67;39;28;288;170;118;63;38;25;28;31;4;0;0D9Je
497;École doctorale Normande de Biologie Intégrative, Santé, Environnement;Ed NBISE;9;Sciences et technologies de l'information et de la communication;2022;2021-22;2021;2021;0;0;0;2;0;2;1;0;1;1;0;0;0;0D9Je
510;École doctorale Ingénierie - Matériaux, mécanique, environnement, énergétique, procédés, production;IMEP2;8;Sciences pour l'ingénieur;2022;2021-22;2021;2021;106;33;73;422;135;287;114;39;75;50;57;7;0;Ce7NF
519;École doctorale Sciences humaines et sociales - Perspectives européennes;SHS-PE;6;Sciences humaines et humanités;2022;2021-22;2021;2021;62;33;29;262;142;120;44;29;15;3;9;17;15;2f5qs
531;École doctorale Sciences, ingénierie et environnement;SIE;4;Chimie;2022;2021-22;2021;2021;12;6;6;50;31;19;16;11;5;7;9;0;0;b5BYq
536;École doctorale Sciences et agrosciences;;5;Biologie, médecine et santé;2022;2021-22;2021;2021;4;3;1;16;7;9;8;7;1;4;4;0;0;pHfqe
537;École doctorale Culture et patrimoine;C&P;7;Sciences de la société;2022;2021-22;2021;2021;7;5;2;16;10;6;3;2;1;0;0;2;1;GxI4a
540;"École doctorale École transdisciplinaire ""lettres/sciences""";;1;Mathématiques et leurs interactions;2022;2021-22;2021;2021;0;0;0;1;0;1;0;0;0;0;0;0;0;tWWw7
540;"École doctorale École transdisciplinaire ""lettres/sciences""";;5;Biologie, médecine et santé;2022;2021-22;2021;2021;2;2;0;4;2;2;0;0;0;0;0;0;0;tWWw7
540;"École doctorale École transdisciplinaire ""lettres/sciences""";;9;Sciences et technologies de l'information et de la communication;2022;2021-22;2021;2021;0;0;0;7;2;5;0;0;0;0;0;0;0;tWWw7
541;École doctorale de sciences humaines et sociales de La Réunion;SHS;9;Sciences et technologies de l'information et de la communication;2022;2021-22;2021;2021;0;0;0;3;2;1;1;1;0;0;0;1;0;21SpE
542;École doctorale de sciences de La Réunion;STS;2;Physique;2022;2021-22;2021;2021;5;2;3;18;8;10;4;0;4;1;1;2;0;2pAql
542;École doctorale de sciences de La Réunion;STS;4;Chimie;2022;2021-22;2021;2021;2;1;1;5;2;3;1;1;0;0;1;0;0;2pAql
542;École doctorale de sciences de La Réunion;STS;5;Biologie, médecine et santé;2022;2021-22;2021;2021;13;9;4;59;33;26;7;4;3;2;5;0;0;2pAql
542;École doctorale de sciences de La Réunion;STS;6;Sciences humaines et humanités;2022;2021-22;2021;2021;1;0;1;4;2;2;0;0;0;0;0;0;0;2pAql
542;École doctorale de sciences de La Réunion;STS;7;Sciences de la société;2022;2021-22;2021;2021;0;0;0;1;1;0;0;0;0;0;0;0;0;2pAql
542;École doctorale de sciences de La Réunion;STS;9;Sciences et technologies de l'information et de la communication;2022;2021-22;2021;2021;1;0;1;3;0;3;0;0;0;0;0;0;0;2pAql
545;École doctorale Sociétés, politique et santé publique;SP2;6;Sciences humaines et humanités;2022;2021-22;2021;2021;31;20;11;158;89;69;25;10;15;5;9;7;4;IAKR4
548;École doctorale Mer et Sciences;;4;Chimie;2022;2021-22;2021;2021;6;3;3;16;6;10;8;6;2;2;5;1;0;QX0fS
551;École doctorale Mathématiques, Informatique, Physique Théorique et Ingénierie des Systèmes;MIPTIS;2;Physique;2022;2021-22;2021;2021;2;1;1;9;1;8;1;0;1;0;1;0;0;Mpudz
553;École doctorale Carnot - Pasteur;;4;Chimie;2022;2021-22;2021;2021;18;9;9;71;28;43;20;10;10;5;12;3;0;6h4Z7
554;École doctorale Environnements - Santé;E-S;3;Sciences de la terre et de l'univers, espace;2022;2021-22;2021;2021;8;1;7;27;15;12;6;2;4;1;2;3;0;ElyFU
555;École doctorale Sciences de l'Homme et de la Société;SHS;6;Sciences humaines et humanités;2022;2021-22;2021;2021;26;12;14;92;49;43;21;10;11;3;3;10;5;44G6m
555;École doctorale Sciences de l'Homme et de la Société;SHS;7;Sciences de la société;2022;2021-22;2021;2021;18;8;10;127;49;78;21;8;13;3;2;7;9;44G6m
563;École doctorale Médicament - Toxicologie - Chimie - Imageries;MTCI;5;Biologie, médecine et santé;2022;2021-22;2021;2021;52;30;22;175;100;75;46;21;25;19;22;5;0;j8uk1
566;École doctorale Sciences du Sport, de la Motricité et du Mouvement Humain;SMMH;5;Biologie, médecine et santé;2022;2021-22;2021;2021;17;7;10;65;25;40;15;7;8;4;5;6;0;3iv8y
573;École doctorale Interfaces : Approches Interdisciplinaires, Fondements, Applications et Innovation;ED INTERFACES;1;Mathématiques et leurs interactions;2022;2021-22;2021;2021;6;2;4;22;5;17;4;1;3;0;3;1;0;gG820
573;École doctorale Interfaces : Approches Interdisciplinaires, Fondements, Applications et Innovation;ED INTERFACES;2;Physique;2022;2021-22;2021;2021;1;1;0;14;5;9;5;1;4;1;3;1;0;gG820
573;École doctorale Interfaces : Approches Interdisciplinaires, Fondements, Applications et Innovation;ED INTERFACES;10;Sciences agronomiques et écologiques;2022;2021-22;2021;2021;0;0;0;1;1;0;0;0;0;0;0;0;0;gG820
575;École doctorale Electrical, Optical, Bio : Physics and Engineering;EOBE;2;Physique;2022;2021-22;2021;2021;25;13;12;91;40;51;20;10;10;8;10;2;0;dfhyn
575;École doctorale Electrical, Optical, Bio : Physics and Engineering;EOBE;5;Biologie, médecine et santé;2022;2021-22;2021;2021;6;3;3;17;10;7;5;2;3;2;2;1;0;dfhyn
579;École doctorale Sciences mécaniques et energétiques, matériaux et géosciences;SMEMaG;1;Mathématiques et leurs interactions;2022;2021-22;2021;2021;2;1;1;2;1;1;0;0;0;0;0;0;0;atMj7
579;École doctorale Sciences mécaniques et energétiques, matériaux et géosciences;SMEMaG;2;Physique;2022;2021-22;2021;2021;8;1;7;33;5;28;7;1;6;2;5;0;0;atMj7
579;École doctorale Sciences mécaniques et energétiques, matériaux et géosciences;SMEMaG;3;Sciences de la terre et de l'univers, espace;2022;2021-22;2021;2021;10;3;7;46;21;25;12;4;8;5;6;1;0;atMj7
579;École doctorale Sciences mécaniques et energétiques, matériaux et géosciences;SMEMaG;4;Chimie;2022;2021-22;2021;2021;3;2;1;3;2;1;0;0;0;0;0;0;0;atMj7
581;École doctorale Agriculture, alimentation, biologie, environnement, santé;ABIES;1;Mathématiques et leurs interactions;2022;2021-22;2021;2021;1;0;1;6;3;3;0;0;0;0;0;0;0;c1x56
581;École doctorale Agriculture, alimentation, biologie, environnement, santé;ABIES;3;Sciences de la terre et de l'univers, espace;2022;2021-22;2021;2021;1;1;0;5;3;2;1;1;0;1;0;0;0;c1x56
581;École doctorale Agriculture, alimentation, biologie, environnement, santé;ABIES;8;Sciences pour l'ingénieur;2022;2021-22;2021;2021;10;6;4;33;15;18;11;6;5;7;4;0;0;c1x56
584;École doctorale Biodiversité, Agriculture, Alimentation, Environnement, Terre, Eau;GAIA;8;Sciences pour l'ingénieur;2022;2021-22;2021;2021;0;0;0;7;5;2;1;1;0;0;0;1;0;F1h5f
584;École doctorale Biodiversité, Agriculture, Alimentation, Environnement, Terre, Eau;GAIA;10;Sciences agronomiques et écologiques;2022;2021-22;2021;2021;93;47;46;401;224;177;121;59;62;63;50;8;0;F1h5f
585;École doctorale Sciences, Technologie,  Sante;EDSTS;4;Chimie;2022;2021-22;2021;2021;26;14;12;76;38;38;22;11;11;14;7;1;0;NM3Dl
585;École doctorale Sciences, Technologie,  Sante;EDSTS;5;Biologie, médecine et santé;2022;2021-22;2021;2021;27;17;10;100;61;39;26;15;11;11;10;4;1;NM3Dl
585;École doctorale Sciences, Technologie,  Sante;EDSTS;10;Sciences agronomiques et écologiques;2022;2021-22;2021;2021;18;10;8;54;28;26;12;7;5;3;8;1;0;NM3Dl
587;École doctorale Diversites, santé et développement en Amazonie;;4;Chimie;2022;2021-22;2021;2021;1;1;0;3;2;1;0;0;0;0;0;0;0;V14tj
589;École doctorale Milieu insulaire tropical à risques : protection, valorisation , santé et développement;;8;Sciences pour l'ingénieur;2022;2021-22;2021;2021;2;0;2;2;0;2;1;1;0;0;0;1;0;2cqi3
589;École doctorale Milieu insulaire tropical à risques : protection, valorisation , santé et développement;;10;Sciences agronomiques et écologiques;2022;2021-22;2021;2021;3;0;3;13;7;6;1;1;0;0;1;0;0;2cqi3
598;École doctorale Sciences de La Mer et du Littoral;SML;6;Sciences humaines et humanités;2022;2021-22;2021;2021;9;7;2;22;14;8;7;1;6;1;2;3;1;Smen6
601;École doctorale Mathématiques et Sciences et Technologies de l'information et de la Communication;MathSTIC;8;Sciences pour l'ingénieur;2022;2021-22;2021;2021;0;0;0;0;0;0;7;0;7;2;5;0;0;3Ue20
601;École doctorale Mathématiques et Sciences et Technologies de l'information et de la Communication;MathSTIC;9;Sciences et technologies de l'information et de la communication;2022;2021-22;2021;2021;246;62;184;935;243;692;226;58;168;125;88;12;1;3Ue20
602;École doctorale Sciences pour l'Ingénieur;SPI;6;Sciences humaines et humanités;2022;2021-22;2021;2021;2;1;1;12;6;6;6;3;3;0;4;2;0;8yWbu
603;École doctorale Éducation, Langages, Interactions, Cognition, Clinique, Expertise - ED 603;ELICCE;6;Sciences humaines et humanités;2022;2021-22;2021;2021;66;38;28;343;193;150;48;33;15;7;18;11;12;1Mzw7
604;École doctorale Sociétés, Temps, Territoires;STT;7;Sciences de la société;2022;2021-22;2021;2021;12;2;10;89;44;45;10;4;6;0;0;5;5;SZI5T
609;École doctorale Sciences et Ingénierie des Matériaux, Mécanique, Énergétique -;SIMME;2;Physique;2022;2021-22;2021;2021;9;3;6;26;5;21;7;1;6;3;4;0;0;N4Rjy
609;École doctorale Sciences et Ingénierie des Matériaux, Mécanique, Énergétique -;SIMME;8;Sciences pour l'ingénieur;2022;2021-22;2021;2021;70;12;58;177;38;139;45;14;31;22;19;4;0;N4Rjy
614;École doctorale Chimie, Écologie, Géosciences, Agrosciences - Théodore Monod;CEGA;3;Sciences de la terre et de l'univers, espace;2022;2021-22;2021;2021;3;1;2;17;8;9;5;2;3;2;3;0;0;uc10I
614;École doctorale Chimie, Écologie, Géosciences, Agrosciences - Théodore Monod;CEGA;10;Sciences agronomiques et écologiques;2022;2021-22;2021;2021;1;0;1;9;3;6;4;1;3;2;2;0;0;uc10I
617;École doctorale Sciences de la Société : Territoires, Economie et Droit;SSTED;8;Sciences pour l'ingénieur;2022;2021-22;2021;2021;0;0;0;1;0;1;1;1;0;0;0;1;0;Kl9ZX
617;École doctorale Sciences de la Société : Territoires, Economie et Droit;SSTED;9;Sciences et technologies de l'information et de la communication;2022;2021-22;2021;2021;0;0;0;6;0;6;1;0;1;0;0;1;0;Kl9ZX
618;École doctorale EUCLIDE;;3;Sciences de la terre et de l'univers, espace;2022;2021-22;2021;2021;2;0;2;12;3;9;2;1;1;1;1;0;0;qveTN
618;École doctorale EUCLIDE;;6;Sciences humaines et humanités;2022;2021-22;2021;2021;3;3;0;21;11;10;3;3;0;2;1;0;0;qveTN
618;École doctorale EUCLIDE;;9;Sciences et technologies de l'information et de la communication;2022;2021-22;2021;2021;4;3;1;39;10;29;7;3;4;4;0;3;0;qveTN
618;École doctorale EUCLIDE;;10;Sciences agronomiques et écologiques;2022;2021-22;2021;2021;5;3;2;43;29;14;9;3;6;6;2;1;0;qveTN
619;École doctorale Sciences Fondamentales et Santé;SFS;2;Physique;2022;2021-22;2021;2021;3;1;2;7;4;3;1;0;1;1;0;0;0;JiZVW
620;École doctorale Sciences du Numérique et de l'Ingénieur;SNI;8;Sciences pour l'ingénieur;2022;2021-22;2021;2021;10;2;8;53;18;35;15;4;11;8;3;4;0;Dr40w
620;École doctorale Sciences du Numérique et de l'Ingénieur;SNI;10;Sciences agronomiques et écologiques;2022;2021-22;2021;2021;0;0;0;1;1;0;0;0;0;0;0;0;0;Dr40w
626;École doctorale de l’Institut Polytechnique de Paris;;2;Physique;2022;2021-22;2021;2021;56;23;33;170;48;122;45;10;35;32;12;1;0;DL5fO
629;École doctorale Sciences sociales et Humanités;SSH;7;Sciences de la société;2022;2021-22;2021;2021;10;4;6;66;30;36;11;4;7;0;0;1;10;nnSns
631;École doctorale Mathématiques, sciences du numérique et de leurs interactions;MADIS;1;Mathématiques et leurs interactions;2022;2021-22;2021;2021;9;1;8;41;10;31;8;3;5;6;2;0;0;OImap
632;École doctorale Science de l’ingénierie et des systèmes;ENGSYS;9;Sciences et technologies de l'information et de la communication;2022;2021-22;2021;2021;28;6;22;124;27;97;19;11;8;13;6;0;0;1jT2e
633;École doctorale Cultures, Sociétés, Territoires;CST;3;Sciences de la terre et de l'univers, espace;2022;2021-22;2021;2021;2;1;1;2;1;1;0;0;0;0;0;0;0;54818
633;École doctorale Cultures, Sociétés, Territoires;CST;7;Sciences de la société;2022;2021-22;2021;2021;11;8;3;48;27;21;4;1;3;1;2;0;1;54818
633;École doctorale Cultures, Sociétés, Territoires;CST;8;Sciences pour l'ingénieur;2022;2021-22;2021;2021;0;0;0;1;0;1;0;0;0;0;0;0;0;54818
635;École doctorale Polytechnique Hauts-de-France;PHF;1;Mathématiques et leurs interactions;2022;2021-22;2021;2021;0;0;0;4;2;2;0;0;0;0;0;0;0;p2m23
31;École doctorale Pratiques et théories du sens;;7;Sciences de la société;2020;2019-20;2019;2019;19;13;6;72;51;21;5;3;2;;;;;1S466
37;École doctorale Sciences physiques pour l'ingénieur et microtechniques;SPIM;9;Sciences et technologies de l'information et de la communication;2020;2019-20;2019;2019;56;16;40;214;64;150;46;12;34;;;;;F7G1B
40;École doctorale Sciences chimiques;EDSC;2;Physique;2020;2019-20;2019;2019;0;0;0;2;1;1;0;0;0;;;;;wde3D
40;École doctorale Sciences chimiques;EDSC;4;Chimie;2020;2019-20;2019;2019;70;33;37;241;105;136;88;39;49;;;;;wde3D
47;École doctorale Physique;;2;Physique;2020;2019-20;2019;2019;93;24;69;325;74;251;85;21;64;;;;;8kNpd
47;École doctorale Physique;;9;Sciences et technologies de l'information et de la communication;2020;2019-20;2019;2019;1;1;0;2;1;1;1;1;0;;;;;8kNpd
52;École doctorale Physique et astrophysique de Lyon;PHAST;2;Physique;2020;2019-20;2019;2019;58;21;37;177;53;124;37;9;28;;;;;61XPb
52;École doctorale Physique et astrophysique de Lyon;PHAST;3;Sciences de la terre et de l'univers, espace;2020;2019-20;2019;2019;4;1;3;25;9;16;7;3;4;;;;;61XPb
58;École doctorale Langues, littératures, cultures, civilisations;LLCC;6;Sciences humaines et humanités;2020;2019-20;2019;2019;108;55;53;465;267;198;81;54;27;;;;;I9ATR
62;École doctorale Sciences de la vie et de la santé;;3;Sciences de la terre et de l'univers, espace;2020;2019-20;2019;2019;0;0;0;2;2;0;0;0;0;;;;;vZzE7
62;École doctorale Sciences de la vie et de la santé;;4;Chimie;2020;2019-20;2019;2019;0;0;0;1;1;0;0;0;0;;;;;vZzE7
62;École doctorale Sciences de la vie et de la santé;;8;Sciences pour l'ingénieur;2020;2019-20;2019;2019;0;0;0;2;0;2;0;0;0;;;;;vZzE7
62;École doctorale Sciences de la vie et de la santé;;9;Sciences et technologies de l'information et de la communication;2020;2019-20;2019;2019;0;0;0;2;0;2;0;0;0;;;;;vZzE7
65;École doctorale Sciences de la Vie, Santé, Agronomie, Environnement;;5;Biologie, médecine et santé;2020;2019-20;2019;2019;63;37;26;185;112;73;46;31;15;;;;;MAOG4
72;École doctorale Sciences pour l'ingénieur;SPI;9;Sciences et technologies de l'information et de la communication;2020;2019-20;2019;2019;112;31;81;392;103;289;102;30;72;;;;;47QPx
73;École doctorale Sciences économiques, sociales, de l'aménagement et du management;SESAM;6;Sciences humaines et humanités;2020;2019-20;2019;2019;14;2;12;73;30;43;7;2;5;;;;;IQ0Hk
84;École doctorale Sciences et technologies de l'information et de la communication;STIC;9;Sciences et technologies de l'information et de la communication;2020;2019-20;2019;2019;53;15;38;243;72;171;45;15;30;;;;;9wS2W
88;École doctorale Droit et science politique;DSP;7;Sciences de la société;2020;2019-20;2019;2019;35;10;25;232;101;131;29;13;16;;;;;elnAJ
104;École doctorale Sciences de la matière, du rayonnement et de l'environnement;SMRE;10;Sciences agronomiques et écologiques;2020;2019-20;2019;2019;31;19;12;83;54;29;26;17;9;;;;;Q5iFz
130;École doctorale Informatique, télécommunications et électronique de Paris;EDITE;9;Sciences et technologies de l'information et de la communication;2020;2019-20;2019;2019;102;17;85;424;92;332;124;27;97;;;;;O5ysj
139;École doctorale Connaissance, langage, modélisation;CLM;6;Sciences humaines et humanités;2020;2019-20;2019;2019;75;45;30;268;165;103;46;27;19;;;;;1lxGH
146;École doctorale Galilée;GALILEE;1;Mathématiques et leurs interactions;2020;2019-20;2019;2019;13;4;9;38;9;29;11;1;10;;;;;71hqm
154;École doctorale Sciences de la vie et de la santé;SVS;5;Biologie, médecine et santé;2020;2019-20;2019;2019;106;56;50;338;201;137;89;53;36;;;;;hLn36
158;École doctorale Cerveau, cognition, comportement;3C;1;Mathématiques et leurs interactions;2020;2019-20;2019;2019;0;0;0;0;0;0;2;1;1;;;;;Il62F
160;École doctorale Électronique, électrotechnique, automatique;EEA;8;Sciences pour l'ingénieur;2020;2019-20;2019;2019;10;2;8;72;17;55;19;3;16;;;;;EgfMQ
162;École doctorale Mécanique, énergétique, génie civil, acoustique;MEGA;1;Mathématiques et leurs interactions;2020;2019-20;2019;2019;0;0;0;1;1;0;0;0;0;;;;;7wCke
166;École doctorale Information, structures et systèmes;I2S;3;Sciences de la terre et de l'univers, espace;2020;2019-20;2019;2019;0;0;0;2;0;2;2;1;1;;;;;2uO68
166;École doctorale Information, structures et systèmes;I2S;4;Chimie;2020;2019-20;2019;2019;2;1;1;4;3;1;0;0;0;;;;;2uO68
166;École doctorale Information, structures et systèmes;I2S;8;Sciences pour l'ingénieur;2020;2019-20;2019;2019;35;6;29;134;24;110;26;5;21;;;;;2uO68
166;École doctorale Information, structures et systèmes;I2S;10;Sciences agronomiques et écologiques;2020;2019-20;2019;2019;1;0;1;2;0;2;2;1;1;;;;;2uO68
173;École doctorale Sciences de l'univers, de l'environnement et de l'espace;SDU2E;3;Sciences de la terre et de l'univers, espace;2020;2019-20;2019;2019;80;30;50;288;100;188;78;32;46;;;;;R0Z9c
178;École doctorale Sciences fondamentales;;1;Mathématiques et leurs interactions;2020;2019-20;2019;2019;0;0;0;7;1;6;6;2;4;;;;;1AiR7
178;École doctorale Sciences fondamentales;;4;Chimie;2020;2019-20;2019;2019;15;8;7;52;26;26;6;1;5;;;;;1AiR7
178;École doctorale Sciences fondamentales;;9;Sciences et technologies de l'information et de la communication;2020;2019-20;2019;2019;5;1;4;11;2;9;0;0;0;;;;;1AiR7
182;École doctorale Physique et chimie-physique;;2;Physique;2020;2019-20;2019;2019;31;7;24;104;30;74;31;7;24;;;;;3My6I
182;École doctorale Physique et chimie-physique;;3;Sciences de la terre et de l'univers, espace;2020;2019-20;2019;2019;0;0;0;3;0;3;3;0;3;;;;;3My6I
184;École doctorale Mathématiques et informatique de Marseille;;8;Sciences pour l'ingénieur;2020;2019-20;2019;2019;2;1;1;8;1;7;6;0;6;;;;;DDObG
209;École doctorale Sciences physiques et de L'ingénieur;SPI;3;Sciences de la terre et de l'univers, espace;2020;2019-20;2019;2019;2;0;2;10;1;9;2;1;1;;;;;tZcIZ
209;École doctorale Sciences physiques et de L'ingénieur;SPI;8;Sciences pour l'ingénieur;2020;2019-20;2019;2019;17;6;11;82;26;56;14;10;4;;;;;tZcIZ
209;École doctorale Sciences physiques et de L'ingénieur;SPI;9;Sciences et technologies de l'information et de la communication;2020;2019-20;2019;2019;36;8;28;136;29;107;34;8;26;;;;;tZcIZ
211;École doctorale Sciences exactes et leurs applications;ED SEA;4;Chimie;2020;2019-20;2019;2019;28;10;18;95;38;57;16;10;6;;;;;1G1iC
211;École doctorale Sciences exactes et leurs applications;ED SEA;10;Sciences agronomiques et écologiques;2020;2019-20;2019;2019;1;0;1;4;1;3;2;1;1;;;;;1G1iC
216;École doctorale Ingénierie pour la santé, la cognition, l'environnement;EDISCE;8;Sciences pour l'ingénieur;2020;2019-20;2019;2019;7;6;1;18;11;7;1;0;1;;;;;fPs1t
216;École doctorale Ingénierie pour la santé, la cognition, l'environnement;EDISCE;9;Sciences et technologies de l'information et de la communication;2020;2019-20;2019;2019;3;2;1;10;6;4;3;2;1;;;;;fPs1t
218;École doctorale Chimie et sciences du vivant;EDCSV;10;Sciences agronomiques et écologiques;2020;2019-20;2019;2019;6;4;2;19;11;8;5;1;4;;;;;8bcJh
220;École doctorale Électronique, électrotechnique, automatique, traitement du signal;EEATS;2;Physique;2020;2019-20;2019;2019;11;2;9;65;20;45;12;5;7;;;;;IxEaw
220;École doctorale Électronique, électrotechnique, automatique, traitement du signal;EEATS;5;Biologie, médecine et santé;2020;2019-20;2019;2019;3;2;1;4;3;1;0;0;0;;;;;IxEaw
222;École doctorale Sciences chimiques;EDSC;2;Physique;2020;2019-20;2019;2019;0;0;0;7;2;5;3;0;3;;;;;AdU8Q
227;École doctorale Sciences de la nature et de l'homme;;3;Sciences de la terre et de l'univers, espace;2020;2019-20;2019;2019;6;2;4;11;4;7;2;0;2;;;;;xiDA5
227;École doctorale Sciences de la nature et de l'homme;;5;Biologie, médecine et santé;2020;2019-20;2019;2019;8;4;4;25;14;11;6;4;2;;;;;xiDA5
227;École doctorale Sciences de la nature et de l'homme;;8;Sciences pour l'ingénieur;2020;2019-20;2019;2019;0;0;0;2;2;0;0;0;0;;;;;xiDA5
245;École doctorale Sciences économiques, juridiques, politiques et de gestion;;6;Sciences humaines et humanités;2020;2019-20;2019;2019;0;0;0;0;0;0;1;0;1;;;;;ShLUg
251;École doctorale Sciences de l'environnement;;4;Chimie;2020;2019-20;2019;2019;6;3;3;24;12;12;2;2;0;;;;;VR28y
286;École doctorale de l'Ehess;;6;Sciences humaines et humanités;2020;2019-20;2019;2019;103;57;46;522;258;264;58;24;34;;;;;2S146
304;École doctorale Sciences et environnements;;3;Sciences de la terre et de l'univers, espace;2020;2019-20;2019;2019;5;3;2;19;9;10;6;4;2;;;;;2ywZn
304;École doctorale Sciences et environnements;;6;Sciences humaines et humanités;2020;2019-20;2019;2019;4;2;2;12;8;4;3;2;1;;;;;2ywZn
305;École doctorale Énergie et environnement;E2;1;Mathématiques et leurs interactions;2020;2019-20;2019;2019;3;2;1;10;4;6;2;2;0;;;;;Kbt8I
305;École doctorale Énergie et environnement;E2;8;Sciences pour l'ingénieur;2020;2019-20;2019;2019;9;2;7;37;11;26;6;1;5;;;;;Kbt8I
305;École doctorale Énergie et environnement;E2;2;Physique;2020;2019-20;2019;2019;5;0;5;8;0;8;2;0;2;;;;;Kbt8I
309;École doctorale Systèmes;EDSYS;8;Sciences pour l'ingénieur;2020;2019-20;2019;2019;11;1;10;69;25;44;19;7;12;;;;;8TT4b
326;École doctorale Comportement, langage, éducation, socialisation, cognition;CLESCO;6;Sciences humaines et humanités;2020;2019-20;2019;2019;48;33;15;274;177;97;49;34;15;;;;;nWIlG
328;École doctorale Arts, lettres, langues, philosophie et communication;ALLPH@;7;Sciences de la société;2020;2019-20;2019;2019;4;3;1;12;10;2;3;2;1;;;;;xLxMh
341;École doctorale Évolution, écosystèmes, microbiologie, modélisation;E2M2;5;Biologie, médecine et santé;2020;2019-20;2019;2019;30;16;14;106;56;50;26;13;13;;;;;J83I0
341;École doctorale Évolution, écosystèmes, microbiologie, modélisation;E2M2;10;Sciences agronomiques et écologiques;2020;2019-20;2019;2019;20;13;7;72;43;29;13;9;4;;;;;J83I0
353;École doctorale Sciences pour l'ingénieur : mécanique, physique, micro et nanoélectronique;;8;Sciences pour l'ingénieur;2020;2019-20;2019;2019;52;10;42;171;41;130;46;5;41;;;;;vk5Kp
353;École doctorale Sciences pour l'ingénieur : mécanique, physique, micro et nanoélectronique;;1;Mathématiques et leurs interactions;2020;2019-20;2019;2019;0;0;0;0;0;0;1;0;1;;;;;vk5Kp
354;École doctorale Langues, lettres et arts;LLA;6;Sciences humaines et humanités;2020;2019-20;2019;2019;37;26;11;231;152;79;23;16;7;;;;;RwcSv
361;École doctorale Sciences et Technologies;ED ST;6;Sciences humaines et humanités;2020;2019-20;2019;2019;6;3;3;19;8;11;4;2;2;;;;;cOUmL
377;École doctorale Environnement et société;;3;Sciences de la terre et de l'univers, espace;2020;2019-20;2019;2019;0;0;0;2;2;0;1;0;1;;;;;ZMG5u
377;École doctorale Environnement et société;;5;Biologie, médecine et santé;2020;2019-20;2019;2019;2;0;2;4;2;2;1;0;1;;;;;ZMG5u
377;École doctorale Environnement et société;;6;Sciences humaines et humanités;2020;2019-20;2019;2019;13;8;5;56;31;25;9;5;4;;;;;ZMG5u
395;École doctorale Milieux, cultures et sociétés du passé et du présent;MCSPP;6;Sciences humaines et humanités;2020;2019-20;2019;2019;44;22;22;296;194;102;41;28;13;;;;;2quEb
397;École doctorale Physique et chimie des matériaux;;4;Chimie;2020;2019-20;2019;2019;40;23;17;147;73;74;44;24;20;;;;;WxSt9
401;École doctorale Sciences sociales;;6;Sciences humaines et humanités;2020;2019-20;2019;2019;23;11;12;153;74;79;14;8;6;;;;;raQ7K
402;École doctorale Sciences de la vie et de la santé;SVS;5;Biologie, médecine et santé;2020;2019-20;2019;2019;35;18;17;122;73;49;27;15;12;;;;;YKgsU
405;École doctorale Économie, management,mathématiques et physique de Cergy;EM2C;2;Physique;2020;2019-20;2019;2019;4;1;3;11;2;9;3;1;2;;;;;QbwSB
414;École doctorale Sciences de la vie et de la santé;;2;Physique;2020;2019-20;2019;2019;2;1;1;3;2;1;0;0;0;;;;;YI4xS
414;École doctorale Sciences de la vie et de la santé;;6;Sciences humaines et humanités;2020;2019-20;2019;2019;5;2;3;5;2;3;0;0;0;;;;;YI4xS
417;École doctorale Sciences et Ingénierie;S&I;4;Chimie;2020;2019-20;2019;2019;8;3;5;27;12;15;7;2;5;;;;;SSBvE
433;École doctorale Concepts et langages;;7;Sciences de la société;2020;2019-20;2019;2019;17;12;5;111;101;10;11;6;5;;;;;v8q34
446;École doctorale Biologie - Santé;EDBSL;1;Mathématiques et leurs interactions;2020;2019-20;2019;2019;1;0;1;2;1;1;0;0;0;;;;;4iEUF
446;École doctorale Biologie - Santé;EDBSL;4;Chimie;2020;2019-20;2019;2019;4;1;3;9;5;4;3;2;1;;;;;4iEUF
455;École doctorale Économie, Gestion, Information et Communication;EGIC;9;Sciences et technologies de l'information et de la communication;2020;2019-20;2019;2019;1;0;1;3;0;3;1;0;1;;;;;qCOg3
465;École doctorale Économie Panthéon Sorbonne;EPS;1;Mathématiques et leurs interactions;2020;2019-20;2019;2019;3;0;3;19;5;14;5;1;4;;;;;MV68S
467;École doctorale Aéronautique, astronautique;AA;3;Sciences de la terre et de l'univers, espace;2020;2019-20;2019;2019;0;0;0;6;2;4;0;0;0;;;;;U7l45
467;École doctorale Aéronautique, astronautique;AA;8;Sciences pour l'ingénieur;2020;2019-20;2019;2019;6;2;4;24;8;16;2;0;2;;;;;U7l45
469;École doctorale du Pacifique;EDP;2;Physique;2020;2019-20;2019;2019;1;0;1;2;1;1;0;0;0;;;;;t9Z2n
469;École doctorale du Pacifique;EDP;6;Sciences humaines et humanités;2020;2019-20;2019;2019;5;1;4;30;16;14;2;0;2;;;;;t9Z2n
472;École doctorale de l'EPHE;;7;Sciences de la société;2020;2019-20;2019;2019;9;6;3;29;17;12;3;0;3;;;;;27zK4
474;École doctorale Interdisciplinaire européenne frontières du vivant;FDV;5;Biologie, médecine et santé;2020;2019-20;2019;2019;32;15;17;127;59;68;29;13;16;;;;;E727j
480;École doctorale Montaigne-humanités;;3;Sciences de la terre et de l'univers, espace;2020;2019-20;2019;2019;4;2;2;19;9;10;5;1;4;;;;;f3SeZ
481;École doctorale Sciences sociales et humanités;SSH;6;Sciences humaines et humanités;2020;2019-20;2019;2019;26;16;10;120;68;52;21;12;9;;;;;E3z5j
482;École doctorale Sciences de la matière;SDM;8;Sciences pour l'ingénieur;2020;2019-20;2019;2019;5;1;4;48;13;35;11;7;4;;;;;kmeZ4
484;École doctorale Lettres, langues, linguistique, arts;3LA;6;Sciences humaines et humanités;2020;2019-20;2019;2019;85;47;38;427;264;163;50;28;22;;;;;BlCQD
485;École doctorale Éducation, Psychologie, Information et Communication;EPIC;6;Sciences humaines et humanités;2020;2019-20;2019;2019;46;32;14;224;152;72;36;26;10;;;;;O82eL
487;École doctorale Philosophie;PHCR;6;Sciences humaines et humanités;2020;2019-20;2019;2019;31;11;20;139;64;75;15;8;7;;;;;3BRzJ
489;École doctorale Sciences et ingénierie des systèmes, de l'environnement et des organisations;SISEO;5;Biologie, médecine et santé;2020;2019-20;2019;2019;3;1;2;9;1;8;1;0;1;;;;;6pT77
497;École doctorale Normande de Biologie Intégrative, Santé, Environnement;Ed NBISE;9;Sciences et technologies de l'information et de la communication;2020;2019-20;2019;2019;1;0;1;3;0;3;2;1;1;;;;;0D9Je
497;École doctorale Normande de Biologie Intégrative, Santé, Environnement;Ed NBISE;10;Sciences agronomiques et écologiques;2020;2019-20;2019;2019;4;2;2;32;16;16;7;2;5;;;;;0D9Je
508;École doctorale Normande de chimie;EDNC;4;Chimie;2020;2019-20;2019;2019;32;12;20;119;48;71;38;13;25;;;;;E52OO
510;École doctorale Ingénierie - Matériaux, mécanique, environnement, énergétique, procédés, production;IMEP2;4;Chimie;2020;2019-20;2019;2019;0;0;0;2;1;1;12;4;8;;;;;Ce7NF
512;École doctorale Informatique et mathématiques;InfoMaths;8;Sciences pour l'ingénieur;2020;2019-20;2019;2019;1;0;1;8;2;6;4;0;4;;;;;t86bi
519;École doctorale Sciences humaines et sociales - Perspectives européennes;SHS-PE;7;Sciences de la société;2020;2019-20;2019;2019;18;10;8;113;63;50;20;17;3;;;;;2f5qs
531;École doctorale Sciences, ingénierie et environnement;SIE;10;Sciences agronomiques et écologiques;2020;2019-20;2019;2019;2;1;1;2;1;1;0;0;0;;;;;b5BYq
540;"École doctorale École transdisciplinaire ""lettres/sciences""";;7;Sciences de la société;2020;2019-20;2019;2019;3;0;3;12;5;7;0;0;0;;;;;tWWw7
542;École doctorale de sciences de La Réunion;STS;4;Chimie;2020;2019-20;2019;2019;1;0;1;9;4;5;0;0;0;;;;;2pAql
542;École doctorale de sciences de La Réunion;STS;5;Biologie, médecine et santé;2020;2019-20;2019;2019;14;9;5;45;24;21;9;6;3;;;;;2pAql
542;École doctorale de sciences de La Réunion;STS;9;Sciences et technologies de l'information et de la communication;2020;2019-20;2019;2019;0;0;0;5;1;4;0;0;0;;;;;2pAql
543;École doctorale de Dauphine;;9;Sciences et technologies de l'information et de la communication;2020;2019-20;2019;2019;9;1;8;40;9;31;12;4;8;;;;;u8w6A
544;École doctorale Inter-Med : Espaces, temps, cultures;INTER-MED;6;Sciences humaines et humanités;2020;2019-20;2019;2019;18;7;11;84;46;38;5;4;1;;;;;7VjtD
545;École doctorale Sociétés, politique et santé publique;SP2;5;Biologie, médecine et santé;2020;2019-20;2019;2019;20;10;10;76;39;37;26;13;13;;;;;IAKR4
545;École doctorale Sociétés, politique et santé publique;SP2;6;Sciences humaines et humanités;2020;2019-20;2019;2019;45;27;18;166;90;76;23;12;11;;;;;IAKR4
548;École doctorale Mer et Sciences;;2;Physique;2020;2019-20;2019;2019;1;0;1;4;1;3;1;0;1;;;;;QX0fS
548;École doctorale Mer et Sciences;;6;Sciences humaines et humanités;2020;2019-20;2019;2019;3;1;2;8;2;6;0;0;0;;;;;QX0fS
554;École doctorale Environnements - Santé;E-S;4;Chimie;2020;2019-20;2019;2019;0;0;0;2;2;0;1;0;1;;;;;ElyFU
554;École doctorale Environnements - Santé;E-S;5;Biologie, médecine et santé;2020;2019-20;2019;2019;78;42;36;252;128;124;59;34;25;;;;;ElyFU
554;École doctorale Environnements - Santé;E-S;6;Sciences humaines et humanités;2020;2019-20;2019;2019;3;1;2;11;5;6;4;1;3;;;;;ElyFU
554;École doctorale Environnements - Santé;E-S;1;Mathématiques et leurs interactions;2020;2019-20;2019;2019;0;0;0;0;0;0;1;0;1;;;;;ElyFU
556;École doctorale Homme, Sociétés, Risques, Territoire;HSRT;7;Sciences de la société;2020;2019-20;2019;2019;7;5;2;50;25;25;8;4;4;;;;;5QEaX
558;École doctorale Histoire, Mémoire, Patrimoine, Langage;HMPL;6;Sciences humaines et humanités;2020;2019-20;2019;2019;69;35;34;319;165;154;29;16;13;;;;;uX3jT
559;École doctorale Management Panthéon-Sorbonne;;7;Sciences de la société;2020;2019-20;2019;2019;36;17;19;180;92;88;42;20;22;;;;;4SP7k
566;École doctorale Sciences du Sport, de la Motricité et du Mouvement Humain;SMMH;8;Sciences pour l'ingénieur;2020;2019-20;2019;2019;0;0;0;1;1;0;0;0;0;;;;;3iv8y
571;École doctorale Sciences Chimiques : Molécules, Matériaux, Instrumentation et Biosystemes;2MIB;4;Chimie;2020;2019-20;2019;2019;82;53;29;254;129;125;82;39;43;;;;;zbi37
572;École doctorale Ondes et matière;EDOM;2;Physique;2020;2019-20;2019;2019;47;15;32;163;48;115;65;15;50;;;;;etSIi
575;École doctorale Electrical, Optical, Bio : Physics and Engineering;EOBE;2;Physique;2020;2019-20;2019;2019;27;10;17;97;42;55;27;12;15;;;;;dfhyn
575;École doctorale Electrical, Optical, Bio : Physics and Engineering;EOBE;9;Sciences et technologies de l'information et de la communication;2020;2019-20;2019;2019;4;2;2;21;9;12;11;2;9;;;;;dfhyn
575;École doctorale Electrical, Optical, Bio : Physics and Engineering;EOBE;1;Mathématiques et leurs interactions;2020;2019-20;2019;2019;1;0;1;1;0;1;0;0;0;;;;;dfhyn
576;École doctorale Particules, Hadrons, Énergie, Noyau, Instrumentation, Imagerie, Cosmos et Simulation;PHENIICS;1;Mathématiques et leurs interactions;2020;2019-20;2019;2019;1;1;0;2;1;1;0;0;0;;;;;qC4rf
577;École doctorale Structure et dynamique des systèmes vivants;SDSV;10;Sciences agronomiques et écologiques;2020;2019-20;2019;2019;1;1;0;4;3;1;0;0;0;;;;;4bsxJ
581;École doctorale Agriculture, alimentation, biologie, environnement, santé;ABIES;6;Sciences humaines et humanités;2020;2019-20;2019;2019;6;4;2;20;15;5;5;4;1;;;;;c1x56
581;École doctorale Agriculture, alimentation, biologie, environnement, santé;ABIES;9;Sciences et technologies de l'information et de la communication;2020;2019-20;2019;2019;4;2;2;6;4;2;0;0;0;;;;;c1x56
582;École doctorale Cancérologie, Biologie, Médecine, Santé;CBMS;5;Biologie, médecine et santé;2020;2019-20;2019;2019;60;41;19;218;125;93;56;38;18;;;;;75bj4
583;École doctorale Risques et Société;;4;Chimie;2020;2019-20;2019;2019;1;1;0;5;3;2;2;2;0;;;;;wUBi9
583;École doctorale Risques et Société;;6;Sciences humaines et humanités;2020;2019-20;2019;2019;3;1;2;9;4;5;0;0;0;;;;;wUBi9
583;École doctorale Risques et Société;;8;Sciences pour l'ingénieur;2020;2019-20;2019;2019;1;0;1;6;1;5;1;0;1;;;;;wUBi9
584;École doctorale Biodiversité, Agriculture, Alimentation, Environnement, Terre, Eau;GAIA;3;Sciences de la terre et de l'univers, espace;2020;2019-20;2019;2019;16;10;6;66;24;42;19;10;9;;;;;F1h5f
584;École doctorale Biodiversité, Agriculture, Alimentation, Environnement, Terre, Eau;GAIA;5;Biologie, médecine et santé;2020;2019-20;2019;2019;18;13;5;55;31;24;27;12;15;;;;;F1h5f
585;École doctorale Sciences, Technologie,  Sante;EDSTS;10;Sciences agronomiques et écologiques;2020;2019-20;2019;2019;11;6;5;27;13;14;5;3;2;;;;;NM3Dl
586;École doctorale Sciences Humaines et Sociales;EDSHS;6;Sciences humaines et humanités;2020;2019-20;2019;2019;59;33;26;248;133;115;20;10;10;;;;;0RKVX
586;École doctorale Sciences Humaines et Sociales;EDSHS;7;Sciences de la société;2020;2019-20;2019;2019;10;7;3;33;14;19;7;6;1;;;;;0RKVX
587;École doctorale Diversites, santé et développement en Amazonie;;5;Biologie, médecine et santé;2020;2019-20;2019;2019;5;2;3;24;16;8;5;4;1;;;;;V14tj
587;École doctorale Diversites, santé et développement en Amazonie;;6;Sciences humaines et humanités;2020;2019-20;2019;2019;4;2;2;17;10;7;0;0;0;;;;;V14tj
587;École doctorale Diversites, santé et développement en Amazonie;;9;Sciences et technologies de l'information et de la communication;2020;2019-20;2019;2019;0;0;0;3;1;2;0;0;0;;;;;V14tj
589;École doctorale Milieu insulaire tropical à risques : protection, valorisation , santé et développement;;5;Biologie, médecine et santé;2020;2019-20;2019;2019;13;9;4;44;27;17;9;5;4;;;;;2cqi3
589;École doctorale Milieu insulaire tropical à risques : protection, valorisation , santé et développement;;9;Sciences et technologies de l'information et de la communication;2020;2019-20;2019;2019;2;0;2;6;0;6;1;0;1;;;;;2cqi3
591;École doctorale Physique, Sciences de l'Ingenieur, Materiaux, Énergie;PSIME;2;Physique;2020;2019-20;2019;2019;30;12;18;90;33;57;27;6;21;;;;;Hn5Om
595;École doctorale Arts, Lettres, Langues;ED ALL;6;Sciences humaines et humanités;2020;2019-20;2019;2019;74;54;20;410;271;139;44;31;13;;;;;a8f9b
596;École doctorale Matière, Molécules et Matériaux;ED 3M;9;Sciences et technologies de l'information et de la communication;2020;2019-20;2019;2019;7;1;6;37;8;29;8;4;4;;;;;77947
598;École doctorale Sciences de La Mer et du Littoral;SML;3;Sciences de la terre et de l'univers, espace;2020;2019-20;2019;2019;22;18;4;71;35;36;17;11;6;;;;;Smen6
598;École doctorale Sciences de La Mer et du Littoral;SML;8;Sciences pour l'ingénieur;2020;2019-20;2019;2019;5;4;1;23;10;13;7;3;4;;;;;Smen6
600;École doctorale Écologie, Géosciences, Agronomie et Alimentation;EGAAL;5;Biologie, médecine et santé;2020;2019-20;2019;2019;11;7;4;35;18;17;8;5;3;;;;;urS33
601;École doctorale Mathématiques et Sciences et Technologies de l'information et de la Communication;MathSTIC;8;Sciences pour l'ingénieur;2020;2019-20;2019;2019;8;2;6;25;3;22;12;3;9;;;;;3Ue20
603;École doctorale Éducation, Langages, Interactions, Cognition, Clinique, Expertise - ED 603;ELICCE;9;Sciences et technologies de l'information et de la communication;2020;2019-20;2019;2019;1;1;0;1;1;0;0;0;0;;;;;1Mzw7
605;École doctorale Biologie Santé;ED BS;4;Chimie;2020;2019-20;2019;2019;0;0;0;3;1;2;1;0;1;;;;;w8CxU
606;École doctorale Chimie - Mécanique - Matériaux - Physique;C2MP;8;Sciences pour l'ingénieur;2020;2019-20;2019;2019;22;1;21;91;21;70;34;6;28;;;;;UkNR2
609;École doctorale Sciences et Ingénierie des Matériaux, Mécanique, Énergétique -;SIMME;2;Physique;2020;2019-20;2019;2019;9;2;7;27;5;22;7;1;6;;;;;N4Rjy
609;École doctorale Sciences et Ingénierie des Matériaux, Mécanique, Énergétique -;SIMME;5;Biologie, médecine et santé;2020;2019-20;2019;2019;1;0;1;1;0;1;0;0;0;;;;;N4Rjy
610;École doctorale Sciences et Ingénierie des Systèmes, Mathématiques, Informatique;SISMI;9;Sciences et technologies de l'information et de la communication;2020;2019-20;2019;2019;32;6;26;114;27;87;38;11;27;;;;;dBCUB
611;École doctorale Sciences du Langage, Psychologie, Cognition, Education;SLPCE;6;Sciences humaines et humanités;2020;2019-20;2019;2019;20;14;6;84;47;37;11;8;3;;;;;z8agK
613;École doctorale Sciences de la Société, Territoires, Sciences Economiques et de Gestion;SSTSEG;6;Sciences humaines et humanités;2020;2019-20;2019;2019;6;5;1;49;21;28;7;3;4;;;;;6eLRF
614;École doctorale Chimie, Écologie, Géosciences, Agrosciences - Théodore Monod;CEGA;3;Sciences de la terre et de l'univers, espace;2020;2019-20;2019;2019;4;3;1;20;11;9;5;2;3;;;;;uc10I
614;École doctorale Chimie, Écologie, Géosciences, Agrosciences - Théodore Monod;CEGA;5;Biologie, médecine et santé;2020;2019-20;2019;2019;4;3;1;10;6;4;3;1;2;;;;;uc10I
616;École doctorale Humanités et Langues;H&L;6;Sciences humaines et humanités;2020;2019-20;2019;2019;52;28;24;259;138;121;42;24;18;;;;;FYOlf
617;École doctorale Sciences de la Société : Territoires, Economie et Droit;SSTED;7;Sciences de la société;2020;2019-20;2019;2019;37;16;21;163;77;86;30;13;17;;;;;Kl9ZX
617;École doctorale Sciences de la Société : Territoires, Economie et Droit;SSTED;8;Sciences pour l'ingénieur;2020;2019-20;2019;2019;0;0;0;2;1;1;0;0;0;;;;;Kl9ZX
617;École doctorale Sciences de la Société : Territoires, Economie et Droit;SSTED;9;Sciences et technologies de l'information et de la communication;2020;2019-20;2019;2019;2;0;2;5;1;4;0;0;0;;;;;Kl9ZX
618;École doctorale EUCLIDE;;6;Sciences humaines et humanités;2020;2019-20;2019;2019;5;3;2;26;15;11;6;5;1;;;;;qveTN
618;École doctorale EUCLIDE;;9;Sciences et technologies de l'information et de la communication;2020;2019-20;2019;2019;9;3;6;38;10;28;9;3;6;;;;;qveTN
619;École doctorale Sciences Fondamentales et Santé;SFS;3;Sciences de la terre et de l'univers, espace;2020;2019-20;2019;2019;0;0;0;3;1;2;0;0;0;;;;;JiZVW
620;École doctorale Sciences du Numérique et de l'Ingénieur;SNI;2;Physique;2020;2019-20;2019;2019;4;3;1;14;9;5;2;1;1;;;;;Dr40w
622;École doctorale Sciences du langage;SDL;7;Sciences de la société;2020;2019-20;2019;2019;0;0;0;3;1;2;0;0;0;;;;;9DsG2
624;École doctorale Sciences des Sociétés;SDS;7;Sciences de la société;2020;2019-20;2019;2019;29;19;10;189;111;78;15;8;7;;;;;cGIjW
625;École doctorale Mondes Anglophones, Germanophones, Iraniens, Indiens, et Études Européennes;MAGIIE;6;Sciences humaines et humanités;2020;2019-20;2019;2019;24;20;4;133;99;34;24;22;2;;;;;JiOMD
626;École doctorale de l’Institut Polytechnique de Paris;;1;Mathématiques et leurs interactions;2020;2019-20;2019;2019;12;0;12;20;3;17;0;0;0;;;;;DL5fO
626;École doctorale de l’Institut Polytechnique de Paris;;9;Sciences et technologies de l'information et de la communication;2020;2019-20;2019;2019;87;24;63;335;86;249;14;4;10;;;;;DL5fO
7;École doctorale Georges Vedel - Droit public interne, science administrative et science politique;;7;Sciences de la société;2016;2015-16;2015;2015;38;13;25;174;65;109;16;5;11;;;;;Dw881
9;École doctorale Droit international, droit européen, relations internationales et droit comparé;;7;Sciences de la société;2016;2015-16;2015;2015;44;22;22;228;133;95;25;11;14;;;;;v1emR
19;École doctorale Littératures françaises et comparée;;6;Sciences humaines et humanités;2016;2015-16;2015;2015;62;40;22;288;191;97;37;22;15;;;;;13M43
20;École doctorale Civilisations, cultures, littératures et sociétés;;6;Sciences humaines et humanités;2016;2015-16;2015;2015;55;39;16;217;146;71;31;21;10;;;;;agjNi
22;École doctorale Mondes anciens et médiévaux;;6;Sciences humaines et humanités;2016;2015-16;2015;2015;31;16;15;182;105;77;31;17;14;;;;;fqCbl
31;École doctorale Pratiques et théories du sens;;7;Sciences de la société;2016;2015-16;2015;2015;8;1;7;20;11;9;1;1;0;;;;;1S466
34;École doctorale Matériaux;;1;Mathématiques et leurs interactions;2016;2015-16;2015;2015;0;0;0;5;2;3;0;0;0;;;;;1Iufh
34;École doctorale Matériaux;;2;Physique;2016;2015-16;2015;2015;18;8;10;63;29;34;14;6;8;;;;;1Iufh
34;École doctorale Matériaux;;4;Chimie;2016;2015-16;2015;2015;11;4;7;55;22;33;13;6;7;;;;;1Iufh
34;École doctorale Matériaux;;8;Sciences pour l'ingénieur;2016;2015-16;2015;2015;21;9;12;110;45;65;25;10;15;;;;;1Iufh
38;École doctorale Langages, espaces, temps, sociétés;;7;Sciences de la société;2016;2015-16;2015;2015;15;6;9;46;23;23;4;2;2;;;;;pGgDX
42;École doctorale Entreprise, économie, société;EES;7;Sciences de la société;2016;2015-16;2015;2015;29;10;19;117;45;72;32;15;17;;;;;uO01d
58;École doctorale Langues, littératures, cultures, civilisations;LLCC;6;Sciences humaines et humanités;2016;2015-16;2015;2015;87;54;33;411;257;154;48;24;24;;;;;I9ATR
60;École doctorale Territoires, temps, sociétés et développement;TTSD;7;Sciences de la société;2016;2015-16;2015;2015;6;2;4;25;10;15;9;5;4;;;;;fkIh6
71;École doctorale Sciences pour l'ingénieur;;7;Sciences de la société;2016;2015-16;2015;2015;4;0;4;26;12;14;3;2;1;;;;;H6UYp
73;École doctorale Sciences économiques, sociales, de l'aménagement et du management;SESAM;7;Sciences de la société;2016;2015-16;2015;2015;52;24;28;216;108;108;26;10;16;;;;;IQ0Hk
74;École doctorale Sciences juridiques, politique et de gestion;SJPG;7;Sciences de la société;2016;2015-16;2015;2015;51;26;25;266;130;136;27;11;16;;;;;3A2RY
77;École doctorale Informatique, automatique, électronique, électrotechnique, mathématiques;IAEM;1;Mathématiques et leurs interactions;2016;2015-16;2015;2015;8;2;6;37;7;30;7;2;5;;;;;TCHTA
79;École doctorale Sciences juridiques, politiques, économiques et de gestion;SJPEG;7;Sciences de la société;2016;2015-16;2015;2015;33;13;20;163;76;87;21;10;11;;;;;ea4x6
84;École doctorale Sciences et technologies de l'information et de la communication;STIC;1;Mathématiques et leurs interactions;2016;2015-16;2015;2015;1;1;0;4;2;2;0;0;0;;;;;9wS2W
86;École doctorale Sociétés, humanités, arts, lettres;LSHS;7;Sciences de la société;2016;2015-16;2015;2015;7;4;3;26;21;5;3;1;2;;;;;O8E6y
104;École doctorale Sciences de la matière, du rayonnement et de l'environnement;SMRE;4;Chimie;2016;2015-16;2015;2015;72;33;39;248;119;129;64;23;41;;;;;Q5iFz
119;École doctorale Science politique;;7;Sciences de la société;2016;2015-16;2015;2015;15;8;7;101;53;48;16;6;10;;;;;eyibb
122;École doctorale Europe latine - Amérique latine;;7;Sciences de la société;2016;2015-16;2015;2015;4;3;1;48;30;18;10;6;4;;;;;z9lZY
127;École doctorale Astronomie et astrophysique d'Ile de France;A&A;2;Physique;2016;2015-16;2015;2015;2;1;1;9;3;6;8;2;6;;;;;cPXrq
131;École doctorale Langue, littérature, image, civilisations et sciences humaines (domaines francophone et anglophone);LLI;6;Sciences humaines et humanités;2016;2015-16;2015;2015;35;25;10;210;140;70;21;15;6;;;;;a47aW
138;École doctorale Lettres, langues, spectacles;LLS;6;Sciences humaines et humanités;2016;2015-16;2015;2015;60;41;19;220;148;72;29;9;20;;;;;y9O3k
151;École doctorale Biologie, santé, biotechnologies;;5;Biologie, médecine et santé;2016;2015-16;2015;2015;87;50;37;379;226;153;89;54;35;;;;;yP8w4
154;École doctorale Sciences de la vie et de la santé;SVS;5;Biologie, médecine et santé;2016;2015-16;2015;2015;90;51;39;295;174;121;84;45;39;;;;;hLn36
156;École doctorale Sciences de la mer;;3;Sciences de la terre et de l'univers, espace;2016;2015-16;2015;2015;23;11;12;66;34;32;18;4;14;;;;;EGY9P
156;École doctorale Sciences de la mer;;5;Biologie, médecine et santé;2016;2015-16;2015;2015;24;14;10;80;51;29;13;7;6;;;;;EGY9P
159;École doctorale Esthétique, sciences et technologies des arts;EDESTA;6;Sciences humaines et humanités;2016;2015-16;2015;2015;44;21;23;250;149;101;31;17;14;;;;;zj1Vj
162;École doctorale Mécanique, énergétique, génie civil, acoustique;MEGA;2;Physique;2016;2015-16;2015;2015;2;0;2;6;1;5;4;1;3;;;;;7wCke
166;École doctorale Information, structures et systèmes;I2S;3;Sciences de la terre et de l'univers, espace;2016;2015-16;2015;2015;1;1;0;3;2;1;0;0;0;;;;;2uO68
166;École doctorale Information, structures et systèmes;I2S;5;Biologie, médecine et santé;2016;2015-16;2015;2015;2;0;2;12;5;7;1;1;0;;;;;2uO68
166;École doctorale Information, structures et systèmes;I2S;10;Sciences agronomiques et écologiques;2016;2015-16;2015;2015;0;0;0;2;0;2;1;0;1;;;;;2uO68
182;École doctorale Physique et chimie-physique;;3;Sciences de la terre et de l'univers, espace;2016;2015-16;2015;2015;2;0;2;11;1;10;4;1;3;;;;;3My6I
182;École doctorale Physique et chimie-physique;;8;Sciences pour l'ingénieur;2016;2015-16;2015;2015;3;2;1;4;2;2;4;1;3;;;;;3My6I
184;École doctorale Mathématiques et informatique de Marseille;;1;Mathématiques et leurs interactions;2016;2015-16;2015;2015;26;5;21;102;27;75;22;7;15;;;;;DDObG
205;École doctorale Interdisciplinaire Sciences-Santé;EDISS;4;Chimie;2016;2015-16;2015;2015;0;0;0;2;1;1;1;0;1;;;;;69W38
205;École doctorale Interdisciplinaire Sciences-Santé;EDISS;9;Sciences et technologies de l'information et de la communication;2016;2015-16;2015;2015;1;0;1;4;0;4;1;0;1;;;;;69W38
206;École doctorale Chimie : chimie, procédés, environnement;;5;Biologie, médecine et santé;2016;2015-16;2015;2015;1;1;0;10;7;3;2;1;1;;;;;m0UhD
211;École doctorale Sciences exactes et leurs applications;ED SEA;6;Sciences humaines et humanités;2016;2015-16;2015;2015;0;0;0;0;0;0;2;1;1;;;;;1G1iC
216;École doctorale Ingénierie pour la santé, la cognition, l'environnement;EDISCE;2;Physique;2016;2015-16;2015;2015;2;0;2;4;0;4;1;0;1;;;;;fPs1t
216;École doctorale Ingénierie pour la santé, la cognition, l'environnement;EDISCE;6;Sciences humaines et humanités;2016;2015-16;2015;2015;12;7;5;49;34;15;11;9;2;;;;;fPs1t
217;École doctorale Mathématiques, sciences et technologies de l'information, informatique;MSTII;1;Mathématiques et leurs interactions;2016;2015-16;2015;2015;21;2;19;92;18;74;20;7;13;;;;;Ehx7v
218;École doctorale Chimie et sciences du vivant;EDCSV;4;Chimie;2016;2015-16;2015;2015;34;14;20;103;48;55;17;10;7;;;;;8bcJh
220;École doctorale Électronique, électrotechnique, automatique, traitement du signal;EEATS;1;Mathématiques et leurs interactions;2016;2015-16;2015;2015;2;1;1;2;1;1;0;0;0;;;;;IxEaw
222;École doctorale Sciences chimiques;EDSC;2;Physique;2016;2015-16;2015;2015;4;2;2;8;2;6;1;0;1;;;;;AdU8Q
224;École doctorale Cognition, langage, interaction;;6;Sciences humaines et humanités;2016;2015-16;2015;2015;23;13;10;144;91;53;19;15;4;;;;;7v43e
227;École doctorale Sciences de la nature et de l'homme;;6;Sciences humaines et humanités;2016;2015-16;2015;2015;10;8;2;45;31;14;6;5;1;;;;;xiDA5
240;École doctorale Sciences de l'homme et de la société;SHS;5;Biologie, médecine et santé;2016;2015-16;2015;2015;1;0;1;6;1;5;0;0;0;;;;;j345k
240;École doctorale Sciences de l'homme et de la société;SHS;6;Sciences humaines et humanités;2016;2015-16;2015;2015;56;30;26;275;158;117;38;24;14;;;;;j345k
242;École doctorale Économie - Gestion - Normandie;;7;Sciences de la société;2016;2015-16;2015;2015;32;21;11;92;44;48;19;11;8;;;;;z35ku
260;École doctorale pluridisciplinaire;;1;Mathématiques et leurs interactions;2016;2015-16;2015;2015;0;0;0;0;0;0;2;1;1;;;;;sCk1f
265;École doctorale Langues, littératures et sociétés du monde;;7;Sciences de la société;2016;2015-16;2015;2015;11;8;3;41;24;17;1;1;0;;;;;4YWGW
266;École doctorale Biologie, santé, environnement;BIOSE;5;Biologie, médecine et santé;2016;2015-16;2015;2015;44;27;17;164;93;71;45;24;21;;;;;386V9
269;École doctorale Mathématiques, sciences de l'information et de l'ingénieur;MSII;4;Chimie;2016;2015-16;2015;2015;0;0;0;1;0;1;1;0;1;;;;;5E625
269;École doctorale Mathématiques, sciences de l'information et de l'ingénieur;MSII;8;Sciences pour l'ingénieur;2016;2015-16;2015;2015;38;9;29;171;48;123;31;7;24;;;;;5E625
270;École doctorale Théologie et sciences religieuses;;6;Sciences humaines et humanités;2016;2015-16;2015;2015;21;7;14;142;35;107;22;7;15;;;;;BRKC1
285;École doctorale Sciences pratiques;;5;Biologie, médecine et santé;2016;2015-16;2015;2015;0;0;0;0;0;0;2;2;0;;;;;Jd3t2
305;École doctorale Énergie et environnement;E2;1;Mathématiques et leurs interactions;2016;2015-16;2015;2015;3;3;0;5;3;2;2;0;2;;;;;Kbt8I
305;École doctorale Énergie et environnement;E2;2;Physique;2016;2015-16;2015;2015;2;0;2;15;3;12;0;0;0;;;;;Kbt8I
306;École doctorale Sciences des procédés, sciences des aliments;;4;Chimie;2016;2015-16;2015;2015;0;0;0;0;0;0;4;1;3;;;;;adF7W
306;École doctorale Sciences des procédés, sciences des aliments;;8;Sciences pour l'ingénieur;2016;2015-16;2015;2015;0;0;0;0;0;0;16;6;10;;;;;adF7W
306;École doctorale Sciences des procédés, sciences des aliments;;10;Sciences agronomiques et écologiques;2016;2015-16;2015;2015;0;0;0;0;0;0;4;3;1;;;;;adF7W
328;École doctorale Arts, lettres, langues, philosophie et communication;ALLPH@;6;Sciences humaines et humanités;2016;2015-16;2015;2015;81;55;26;316;192;124;45;27;18;;;;;xLxMh
341;École doctorale Évolution, écosystèmes, microbiologie, modélisation;E2M2;3;Sciences de la terre et de l'univers, espace;2016;2015-16;2015;2015;1;1;0;1;1;0;1;0;1;;;;;J83I0
341;École doctorale Évolution, écosystèmes, microbiologie, modélisation;E2M2;5;Biologie, médecine et santé;2016;2015-16;2015;2015;15;7;8;115;56;59;36;22;14;;;;;J83I0
351;École doctorale Sciences physiques, mathématiques et de l'information pour l'ingénieur;SPMII;2;Physique;2016;2015-16;2015;2015;14;3;11;45;9;36;12;4;8;;;;;rY4EP
351;École doctorale Sciences physiques, mathématiques et de l'information pour l'ingénieur;SPMII;3;Sciences de la terre et de l'univers, espace;2016;2015-16;2015;2015;1;0;1;2;1;1;0;0;0;;;;;rY4EP
351;École doctorale Sciences physiques, mathématiques et de l'information pour l'ingénieur;SPMII;8;Sciences pour l'ingénieur;2016;2015-16;2015;2015;33;9;24;154;35;119;33;10;23;;;;;rY4EP
353;École doctorale Sciences pour l'ingénieur : mécanique, physique, micro et nanoélectronique;;3;Sciences de la terre et de l'univers, espace;2016;2015-16;2015;2015;0;0;0;6;3;3;0;0;0;;;;;vk5Kp
355;École doctorale Espaces, cultures, sociétés;;7;Sciences de la société;2016;2015-16;2015;2015;11;7;4;11;7;4;4;4;0;;;;;2kMf5
361;École doctorale Sciences et Technologies;ED ST;6;Sciences humaines et humanités;2016;2015-16;2015;2015;4;1;3;16;8;8;3;2;1;;;;;cOUmL
361;École doctorale Sciences et Technologies;ED ST;9;Sciences et technologies de l'information et de la communication;2016;2015-16;2015;2015;25;5;20;113;43;70;24;10;14;;;;;cOUmL
373;École doctorale Santé, information/communications et mathématiques, matière;SICMA;1;Mathématiques et leurs interactions;2016;2015-16;2015;2015;8;3;5;25;10;15;4;2;2;;;;;hTJF5
377;École doctorale Environnement et société;;1;Mathématiques et leurs interactions;2016;2015-16;2015;2015;0;0;0;2;1;1;0;0;0;;;;;ZMG5u
377;École doctorale Environnement et société;;2;Physique;2016;2015-16;2015;2015;0;0;0;2;0;2;0;0;0;;;;;ZMG5u
377;École doctorale Environnement et société;;7;Sciences de la société;2016;2015-16;2015;2015;5;2;3;28;15;13;4;0;4;;;;;ZMG5u
388;École doctorale Chimie physique et chimie analytique de Paris centre;CPCA;4;Chimie;2016;2015-16;2015;2015;83;33;50;283;129;154;73;31;42;;;;;M0Hnd
394;École doctorale Physiologie et physiopathologie;p2t;5;Biologie, médecine et santé;2016;2015-16;2015;2015;59;39;20;228;139;89;64;40;24;;;;;VMYmT
396;École doctorale Économie, organisations, société;EOS;9;Sciences et technologies de l'information et de la communication;2016;2015-16;2015;2015;0;0;0;1;1;0;0;0;0;;;;;Es5e7
397;École doctorale Physique et chimie des matériaux;;2;Physique;2016;2015-16;2015;2015;34;11;23;102;37;65;26;6;20;;;;;WxSt9
401;École doctorale Sciences sociales;;9;Sciences et technologies de l'information et de la communication;2016;2015-16;2015;2015;7;4;3;31;11;20;2;1;1;;;;;raQ7K
406;École doctorale Chimie moléculaire de Paris centre;;4;Chimie;2016;2015-16;2015;2015;36;12;24;122;40;82;32;16;16;;;;;a5dKy
413;École doctorale Sciences de la terre et de l'environnement;STE;4;Chimie;2016;2015-16;2015;2015;3;2;1;15;9;6;3;1;2;;;;;u9BA9
417;École doctorale Sciences et Ingénierie;S&I;4;Chimie;2016;2015-16;2015;2015;8;3;5;25;12;13;7;3;4;;;;;SSBvE
419;École doctorale Signalisations et réseaux intégratifs en biologie;BIO-SIGNE;5;Biologie, médecine et santé;2016;2015-16;2015;2015;0;0;0;0;0;0;12;9;3;;;;;rDuFq
426;École doctorale Gènes, génomes, cellules;;5;Biologie, médecine et santé;2016;2015-16;2015;2015;0;0;0;0;0;0;16;11;5;;;;;XPaY8
433;École doctorale Concepts et langages;;6;Sciences humaines et humanités;2016;2015-16;2015;2015;96;50;46;435;244;191;66;35;31;;;;;v8q34
435;École doctorale Agriculture, alimentation, biologie, environnement et santé;;3;Sciences de la terre et de l'univers, espace;2016;2015-16;2015;2015;0;0;0;0;0;0;1;1;0;;;;;mC35U
435;École doctorale Agriculture, alimentation, biologie, environnement et santé;;4;Chimie;2016;2015-16;2015;2015;0;0;0;0;0;0;5;3;2;;;;;mC35U
435;École doctorale Agriculture, alimentation, biologie, environnement et santé;;6;Sciences humaines et humanités;2016;2015-16;2015;2015;0;0;0;0;0;0;1;1;0;;;;;mC35U
441;École doctorale Histoire de l'art;;6;Sciences humaines et humanités;2016;2015-16;2015;2015;37;26;11;200;139;61;20;14;6;;;;;d5W3U
446;École doctorale Biologie - Santé;EDBSL;5;Biologie, médecine et santé;2016;2015-16;2015;2015;90;50;40;325;176;149;82;44;38;;;;;4iEUF
447;École doctorale de l'école polytechnique;;3;Sciences de la terre et de l'univers, espace;2016;2015-16;2015;2015;0;0;0;0;0;0;4;3;1;;;;;zgCCh
454;École doctorale Sciences de l'homme, du politique et du territoire;SHPT;7;Sciences de la société;2016;2015-16;2015;2015;18;8;10;125;67;58;14;4;10;;;;;Opv31
459;École doctorale Sciences chimiques Balard;;4;Chimie;2016;2015-16;2015;2015;58;21;37;229;100;129;84;32;52;;;;;YFs2W
460;École doctorale Sciences juridiques;SJ;7;Sciences de la société;2016;2015-16;2015;2015;21;9;12;135;62;73;10;4;6;;;;;ZB5I5
461;École doctorale Droit et science politique;;7;Sciences de la société;2016;2015-16;2015;2015;70;35;35;277;157;120;57;37;20;;;;;QGArN
465;École doctorale Économie Panthéon Sorbonne;EPS;1;Mathématiques et leurs interactions;2016;2015-16;2015;2015;2;0;2;18;4;14;5;2;3;;;;;MV68S
467;École doctorale Aéronautique, astronautique;AA;2;Physique;2016;2015-16;2015;2015;2;1;1;6;1;5;0;0;0;;;;;U7l45
467;École doctorale Aéronautique, astronautique;AA;6;Sciences humaines et humanités;2016;2015-16;2015;2015;1;1;0;8;1;7;1;0;1;;;;;U7l45
467;École doctorale Aéronautique, astronautique;AA;7;Sciences de la société;2016;2015-16;2015;2015;0;0;0;4;1;3;0;0;0;;;;;U7l45
467;École doctorale Aéronautique, astronautique;AA;8;Sciences pour l'ingénieur;2016;2015-16;2015;2015;9;2;7;15;4;11;0;0;0;;;;;U7l45
469;École doctorale du Pacifique;EDP;2;Physique;2016;2015-16;2015;2015;2;0;2;3;0;3;0;0;0;;;;;t9Z2n
469;École doctorale du Pacifique;EDP;6;Sciences humaines et humanités;2016;2015-16;2015;2015;5;2;3;9;4;5;0;0;0;;;;;t9Z2n
470;École doctorale Chimie de Paris-Sud;;4;Chimie;2016;2015-16;2015;2015;0;0;0;0;0;0;29;16;13;;;;;aExpW
472;École doctorale de l'EPHE;;7;Sciences de la société;2016;2015-16;2015;2015;1;0;1;3;0;3;3;2;1;;;;;27zK4
474;École doctorale Interdisciplinaire européenne frontières du vivant;FDV;6;Sciences humaines et humanités;2016;2015-16;2015;2015;1;1;0;1;1;0;0;0;0;;;;;E727j
474;École doctorale Interdisciplinaire européenne frontières du vivant;FDV;7;Sciences de la société;2016;2015-16;2015;2015;1;1;0;1;1;0;0;0;0;;;;;E727j
475;École doctorale Mathématiques, informatique, télécommunications de Toulouse;MITT;1;Mathématiques et leurs interactions;2016;2015-16;2015;2015;38;12;26;141;47;94;30;13;17;;;;;xcp2r
475;École doctorale Mathématiques, informatique, télécommunications de Toulouse;MITT;9;Sciences et technologies de l'information et de la communication;2016;2015-16;2015;2015;81;20;61;323;88;235;81;19;62;;;;;xcp2r
482;École doctorale Sciences de la matière;SDM;2;Physique;2016;2015-16;2015;2015;24;4;20;105;34;71;27;9;18;;;;;kmeZ4
485;École doctorale Éducation, Psychologie, Information et Communication;EPIC;6;Sciences humaines et humanités;2016;2015-16;2015;2015;54;14;40;304;111;193;65;25;40;;;;;O82eL
485;École doctorale Éducation, Psychologie, Information et Communication;EPIC;9;Sciences et technologies de l'information et de la communication;2016;2015-16;2015;2015;4;1;3;20;11;9;4;3;1;;;;;O82eL
486;École doctorale Sciences économiques et de gestion;SEG;1;Mathématiques et leurs interactions;2016;2015-16;2015;2015;0;0;0;0;0;0;1;0;1;;;;;h1GZ3
488;École doctorale Sciences, ingénierie, santé;SIS;3;Sciences de la terre et de l'univers, espace;2016;2015-16;2015;2015;2;1;1;23;11;12;8;2;6;;;;;Fy2lK
488;École doctorale Sciences, ingénierie, santé;SIS;9;Sciences et technologies de l'information et de la communication;2016;2015-16;2015;2015;35;9;26;148;33;115;32;6;26;;;;;Fy2lK
489;École doctorale Sciences et ingénierie des systèmes, de l'environnement et des organisations;SISEO;3;Sciences de la terre et de l'univers, espace;2016;2015-16;2015;2015;4;3;1;14;10;4;7;4;3;;;;;6pT77
493;École doctorale Erasme;;7;Sciences de la société;2016;2015-16;2015;2015;42;19;23;208;90;118;40;19;21;;;;;FPW4T
498;École doctorale Sciences pour l'ingénieur, géosciences, architecture;SPIGA;9;Sciences et technologies de l'information et de la communication;2016;2015-16;2015;2015;3;0;3;15;1;14;0;0;0;;;;;0vlKH
500;École doctorale Matière, molécules, matériaux en Pays de Loire;3MPL;4;Chimie;2016;2015-16;2015;2015;31;14;17;116;47;69;32;9;23;;;;;822tM
501;École doctorale Droit, économie-gestion, sociétés, territoires;;6;Sciences humaines et humanités;2016;2015-16;2015;2015;31;14;17;101;42;59;16;7;9;;;;;wE7WM
503;École doctorale Sciences et technologies de l'information et de mathématiques;STIM;9;Sciences et technologies de l'information et de la communication;2016;2015-16;2015;2015;57;16;41;242;57;185;59;11;48;;;;;JQevP
510;École doctorale Ingénierie - Matériaux, mécanique, environnement, énergétique, procédés, production;IMEP2;8;Sciences pour l'ingénieur;2016;2015-16;2015;2015;97;27;70;401;111;290;103;32;71;;;;;Ce7NF
513;École doctorale Droit et sciences politiques, économiques et de gestion;DESPEG;7;Sciences de la société;2016;2015-16;2015;2015;57;26;31;318;155;163;50;28;22;;;;;aVHGU
521;École doctorale Sciences et ingénierie pour l'information, mathématiques;S2I;9;Sciences et technologies de l'information et de la communication;2016;2015-16;2015;2015;49;9;40;187;31;156;34;5;29;;;;;V6i83
524;École doctorale Biologie - santé;;5;Biologie, médecine et santé;2016;2015-16;2015;2015;31;19;12;126;79;47;31;17;14;;;;;S7Kk6
526;École doctorale Sociétés et organisations;SORG;7;Sciences de la société;2016;2015-16;2015;2015;23;11;12;101;49;52;16;5;11;;;;;5F3Fd
530;École doctorale Organisations, marchés, institutions;OMI;8;Sciences pour l'ingénieur;2016;2015-16;2015;2015;0;0;0;1;1;0;0;0;0;;;;;4htv7
531;École doctorale Sciences, ingénierie et environnement;SIE;6;Sciences humaines et humanités;2016;2015-16;2015;2015;1;0;1;1;0;1;0;0;0;;;;;b5BYq
531;École doctorale Sciences, ingénierie et environnement;SIE;8;Sciences pour l'ingénieur;2016;2015-16;2015;2015;59;19;40;194;62;132;58;17;41;;;;;b5BYq
531;École doctorale Sciences, ingénierie et environnement;SIE;10;Sciences agronomiques et écologiques;2016;2015-16;2015;2015;3;2;1;6;5;1;5;2;3;;;;;b5BYq
532;École doctorale Mathématiques et sciences et technologies de l'information et de la communication;MSTIC;1;Mathématiques et leurs interactions;2016;2015-16;2015;2015;23;7;16;73;21;52;26;8;18;;;;;t43KM
534;École doctorale Modélisation et instrumentation en physique, énergie, géosciences et environnement;MIPEGE;3;Sciences de la terre et de l'univers, espace;2016;2015-16;2015;2015;0;0;0;0;0;0;10;3;7;;;;;K93eR
538;École doctorale Culture, régulation, institutions et territoire;CRIT;7;Sciences de la société;2016;2015-16;2015;2015;0;0;0;0;0;0;16;8;8;;;;;8T505
542;École doctorale de sciences de La Réunion;STS;8;Sciences pour l'ingénieur;2016;2015-16;2015;2015;1;0;1;24;15;9;7;3;4;;;;;2pAql
546;École doctorale Abbé Grégoire;;8;Sciences pour l'ingénieur;2016;2015-16;2015;2015;0;0;0;1;0;1;0;0;0;;;;;ZSn7q
547;École doctorale Sciences, Technologie, Santé;EDSTS;9;Sciences et technologies de l'information et de la communication;2016;2015-16;2015;2015;13;2;11;47;8;39;10;5;5;;;;;wEdn2
549;École doctorale Santé, Sciences Biologiques et Chimie du Vivant;SSBCV;3;Sciences de la terre et de l'univers, espace;2016;2015-16;2015;2015;0;0;0;1;1;0;3;3;0;;;;;B9ggO
549;École doctorale Santé, Sciences Biologiques et Chimie du Vivant;SSBCV;9;Sciences et technologies de l'information et de la communication;2016;2015-16;2015;2015;0;0;0;4;1;3;1;0;1;;;;;B9ggO
551;École doctorale Mathématiques, Informatique, Physique Théorique et Ingénierie des Systèmes;MIPTIS;8;Sciences pour l'ingénieur;2016;2015-16;2015;2015;1;0;1;1;0;1;0;0;0;;;;;Mpudz
552;École doctorale Énergie - Matériaux - Sciences de la Terre et de l'Univers;EMTSU;1;Mathématiques et leurs interactions;2016;2015-16;2015;2015;0;0;0;1;0;1;1;1;0;;;;;NTZhw
552;École doctorale Énergie - Matériaux - Sciences de la Terre et de l'Univers;EMTSU;9;Sciences et technologies de l'information et de la communication;2016;2015-16;2015;2015;0;0;0;5;2;3;2;0;2;;;;;NTZhw
553;École doctorale Carnot - Pasteur;;1;Mathématiques et leurs interactions;2016;2015-16;2015;2015;13;3;10;49;15;34;10;1;9;;;;;6h4Z7
553;École doctorale Carnot - Pasteur;;4;Chimie;2016;2015-16;2015;2015;20;7;13;88;25;63;28;7;21;;;;;6h4Z7
554;École doctorale Environnements - Santé;E-S;5;Biologie, médecine et santé;2016;2015-16;2015;2015;64;37;27;215;127;88;57;33;24;;;;;ElyFU
554;École doctorale Environnements - Santé;E-S;9;Sciences et technologies de l'information et de la communication;2016;2015-16;2015;2015;0;0;0;0;0;0;2;1;1;;;;;ElyFU
554;École doctorale Environnements - Santé;E-S;10;Sciences agronomiques et écologiques;2016;2015-16;2015;2015;40;22;18;138;75;63;31;21;10;;;;;ElyFU
561;École doctorale Hématologie, Oncogenèse et Biothérapies;HOB;5;Biologie, médecine et santé;2016;2015-16;2015;2015;52;28;24;186;117;69;52;29;23;;;;;7Klb2
562;École doctorale Bio Sorbonne Paris Cité;BioSPC;5;Biologie, médecine et santé;2016;2015-16;2015;2015;153;101;52;493;309;184;120;74;46;;;;;4Yju6
567;École doctorale Sciences du Végétal : du gène à l'écosystème;;5;Biologie, médecine et santé;2016;2015-16;2015;2015;23;13;10;86;48;38;10;5;5;;;;;tuDkA
571;École doctorale Sciences Chimiques : Molécules, Matériaux, Instrumentation et Biosystemes;2MIB;2;Physique;2016;2015-16;2015;2015;1;1;0;7;3;4;0;0;0;;;;;zbi37
573;École doctorale Interfaces : Approches Interdisciplinaires, Fondements, Applications et Innovation;ED INTERFACES;5;Biologie, médecine et santé;2016;2015-16;2015;2015;4;2;2;19;10;9;0;0;0;;;;;gG820
576;École doctorale Particules, Hadrons, Énergie, Noyau, Instrumentation, Imagerie, Cosmos et Simulation;PHENIICS;1;Mathématiques et leurs interactions;2016;2015-16;2015;2015;1;0;1;1;0;1;0;0;0;;;;;qC4rf
579;École doctorale Sciences mécaniques et energétiques, matériaux et géosciences;SMEMaG;2;Physique;2016;2015-16;2015;2015;12;3;9;37;11;26;1;0;1;;;;;atMj7
579;École doctorale Sciences mécaniques et energétiques, matériaux et géosciences;SMEMaG;3;Sciences de la terre et de l'univers, espace;2016;2015-16;2015;2015;18;7;11;55;24;31;6;2;4;;;;;atMj7
579;École doctorale Sciences mécaniques et energétiques, matériaux et géosciences;SMEMaG;5;Biologie, médecine et santé;2016;2015-16;2015;2015;0;0;0;2;2;0;0;0;0;;;;;atMj7
580;École doctorale Sciences et technologies de l'information et de la communication;STIC;1;Mathématiques et leurs interactions;2016;2015-16;2015;2015;3;1;2;11;1;10;0;0;0;;;;;AzCC0
581;École doctorale Agriculture, alimentation, biologie, environnement, santé;ABIES;4;Chimie;2016;2015-16;2015;2015;3;1;2;16;7;9;0;0;0;;;;;c1x56
581;École doctorale Agriculture, alimentation, biologie, environnement, santé;ABIES;8;Sciences pour l'ingénieur;2016;2015-16;2015;2015;7;7;0;27;17;10;3;2;1;;;;;c1x56
583;École doctorale Risques et Société;;4;Chimie;2016;2015-16;2015;2015;1;1;0;2;1;1;0;0;0;;;;;wUBi9
585;École doctorale Sciences, Technologie,  Sante;EDSTS;1;Mathématiques et leurs interactions;2016;2015-16;2015;2015;5;3;2;13;6;7;3;0;3;;;;;NM3Dl
585;École doctorale Sciences, Technologie,  Sante;EDSTS;9;Sciences et technologies de l'information et de la communication;2016;2015-16;2015;2015;2;1;1;24;6;18;6;1;5;;;;;NM3Dl
587;École doctorale Diversites, santé et développement en Amazonie;;1;Mathématiques et leurs interactions;2016;2015-16;2015;2015;0;0;0;1;1;0;1;0;1;;;;;V14tj
587;École doctorale Diversites, santé et développement en Amazonie;;2;Physique;2016;2015-16;2015;2015;0;0;0;1;0;1;0;0;0;;;;;V14tj
587;École doctorale Diversites, santé et développement en Amazonie;;10;Sciences agronomiques et écologiques;2016;2015-16;2015;2015;3;3;0;5;5;0;1;0;1;;;;;V14tj
588;École doctorale Milieu insulaire tropical : dynamiques de développement, sociétés, patrimoine et culture dans l'espace Caraïbes-Amériques;;7;Sciences de la société;2016;2015-16;2015;2015;11;6;5;84;48;36;7;5;2;;;;;4W5IO
589;École doctorale Milieu insulaire tropical à risques : protection, valorisation , santé et développement;;2;Physique;2016;2015-16;2015;2015;1;0;1;6;2;4;1;1;0;;;;;2cqi3
589;École doctorale Milieu insulaire tropical à risques : protection, valorisation , santé et développement;;8;Sciences pour l'ingénieur;2016;2015-16;2015;2015;1;1;0;1;1;0;0;0;0;;;;;2cqi3
9;École doctorale Droit international, droit européen, relations internationales et droit comparé;;7;Sciences de la société;2017;2016-17;2016;2016;37;27;10;237;148;89;14;8;6;;;;;v1emR
19;École doctorale Littératures françaises et comparée;;6;Sciences humaines et humanités;2017;2016-17;2016;2016;69;42;27;295;193;102;42;25;17;;;;;13M43
37;École doctorale Sciences physiques pour l'ingénieur et microtechniques;SPIM;9;Sciences et technologies de l'information et de la communication;2017;2016-17;2016;2016;62;18;44;213;53;160;61;18;43;;;;;F7G1B
39;École doctorale Mathématiques et Informatique;EDMIB;1;Mathématiques et leurs interactions;2017;2016-17;2016;2016;20;5;15;85;20;65;28;6;22;;;;;TBj2X
41;École doctorale Droit;;7;Sciences de la société;2017;2016-17;2016;2016;62;26;36;345;157;188;36;17;19;;;;;KnOQK
50;École doctorale Langues, littératures et sciences humaines;LLSH;9;Sciences et technologies de l'information et de la communication;2017;2016-17;2016;2016;5;3;2;39;24;15;4;2;2;;;;;8THzQ
52;École doctorale Physique et astrophysique de Lyon;PHAST;2;Physique;2017;2016-17;2016;2016;38;10;28;158;36;122;43;10;33;;;;;61XPb
67;École doctorale Sciences juridiques et politiques;;1;Mathématiques et leurs interactions;2017;2016-17;2016;2016;0;0;0;2;2;0;0;0;0;;;;;qrOj1
71;École doctorale Sciences pour l'ingénieur;;7;Sciences de la société;2017;2016-17;2016;2016;1;1;0;24;12;12;3;2;1;;;;;H6UYp
72;École doctorale Sciences pour l'ingénieur;SPI;9;Sciences et technologies de l'information et de la communication;2017;2016-17;2016;2016;98;35;63;386;113;273;111;23;88;;;;;47QPx
120;École doctorale Littérature française et comparée;;6;Sciences humaines et humanités;2017;2016-17;2016;2016;38;26;12;244;169;75;36;27;9;;;;;3ULpe
138;École doctorale Lettres, langues, spectacles;LLS;6;Sciences humaines et humanités;2017;2016-17;2016;2016;47;28;19;290;188;102;27;15;12;;;;;y9O3k
141;École doctorale Droit et science politique;DSP;7;Sciences de la société;2017;2016-17;2016;2016;41;24;17;293;138;155;17;4;13;;;;;CyNBf
146;École doctorale Galilée;GALILEE;4;Chimie;2017;2016-17;2016;2016;4;0;4;11;4;7;3;0;3;;;;;71hqm
156;École doctorale Sciences de la mer;;6;Sciences humaines et humanités;2017;2016-17;2016;2016;2;2;0;12;9;3;1;1;0;;;;;EGY9P
162;École doctorale Mécanique, énergétique, génie civil, acoustique;MEGA;5;Biologie, médecine et santé;2017;2016-17;2016;2016;4;2;2;4;2;2;1;0;1;;;;;7wCke
162;École doctorale Mécanique, énergétique, génie civil, acoustique;MEGA;8;Sciences pour l'ingénieur;2017;2016-17;2016;2016;86;15;71;393;83;310;113;26;87;;;;;7wCke
166;École doctorale Information, structures et systèmes;I2S;4;Chimie;2017;2016-17;2016;2016;0;0;0;5;4;1;0;0;0;;;;;2uO68
166;École doctorale Information, structures et systèmes;I2S;5;Biologie, médecine et santé;2017;2016-17;2016;2016;4;4;0;10;6;4;8;3;5;;;;;2uO68
166;École doctorale Information, structures et systèmes;I2S;7;Sciences de la société;2017;2016-17;2016;2016;1;0;1;1;0;1;0;0;0;;;;;2uO68
166;École doctorale Information, structures et systèmes;I2S;8;Sciences pour l'ingénieur;2017;2016-17;2016;2016;34;8;26;101;25;76;23;5;18;;;;;2uO68
173;École doctorale Sciences de l'univers, de l'environnement et de l'espace;SDU2E;10;Sciences agronomiques et écologiques;2017;2016-17;2016;2016;7;2;5;35;16;19;8;4;4;;;;;R0Z9c
178;École doctorale Sciences fondamentales;;3;Sciences de la terre et de l'univers, espace;2017;2016-17;2016;2016;11;3;8;29;12;17;13;4;9;;;;;1AiR7
180;École doctorale Sciences humaines et sociales : cultures, individus, sociétés;SHS;6;Sciences humaines et humanités;2017;2016-17;2016;2016;19;14;5;113;78;35;10;4;6;;;;;D2BT3
181;École doctorale Structure, informations, matière et matériaux;Simem;9;Sciences et technologies de l'information et de la communication;2017;2016-17;2016;2016;0;0;0;0;0;0;15;2;13;;;;;c1D6f
182;École doctorale Physique et chimie-physique;;2;Physique;2017;2016-17;2016;2016;25;7;18;119;30;89;31;4;27;;;;;3My6I
182;École doctorale Physique et chimie-physique;;8;Sciences pour l'ingénieur;2017;2016-17;2016;2016;0;0;0;3;1;2;3;1;2;;;;;3My6I
184;École doctorale Mathématiques et informatique de Marseille;;8;Sciences pour l'ingénieur;2017;2016-17;2016;2016;3;0;3;12;1;11;5;2;3;;;;;DDObG
205;École doctorale Interdisciplinaire Sciences-Santé;EDISS;5;Biologie, médecine et santé;2017;2016-17;2016;2016;63;36;27;250;150;100;47;25;22;;;;;69W38
205;École doctorale Interdisciplinaire Sciences-Santé;EDISS;7;Sciences de la société;2017;2016-17;2016;2016;0;0;0;2;0;2;0;0;0;;;;;69W38
206;École doctorale Chimie : chimie, procédés, environnement;;4;Chimie;2017;2016-17;2016;2016;79;41;38;337;149;188;81;39;42;;;;;m0UhD
206;École doctorale Chimie : chimie, procédés, environnement;;5;Biologie, médecine et santé;2017;2016-17;2016;2016;0;0;0;4;2;2;5;4;1;;;;;m0UhD
209;École doctorale Sciences physiques et de L'ingénieur;SPI;8;Sciences pour l'ingénieur;2017;2016-17;2016;2016;22;9;13;89;26;63;23;6;17;;;;;tZcIZ
211;École doctorale Sciences exactes et leurs applications;ED SEA;1;Mathématiques et leurs interactions;2017;2016-17;2016;2016;8;3;5;25;9;16;5;2;3;;;;;1G1iC
211;École doctorale Sciences exactes et leurs applications;ED SEA;3;Sciences de la terre et de l'univers, espace;2017;2016-17;2016;2016;6;0;6;11;0;11;3;0;3;;;;;1G1iC
211;École doctorale Sciences exactes et leurs applications;ED SEA;9;Sciences et technologies de l'information et de la communication;2017;2016-17;2016;2016;5;2;3;18;7;11;3;2;1;;;;;1G1iC
216;École doctorale Ingénierie pour la santé, la cognition, l'environnement;EDISCE;1;Mathématiques et leurs interactions;2017;2016-17;2016;2016;2;1;1;7;4;3;0;0;0;;;;;fPs1t
216;École doctorale Ingénierie pour la santé, la cognition, l'environnement;EDISCE;5;Biologie, médecine et santé;2017;2016-17;2016;2016;22;12;10;124;46;78;31;10;21;;;;;fPs1t
227;École doctorale Sciences de la nature et de l'homme;;3;Sciences de la terre et de l'univers, espace;2017;2016-17;2016;2016;1;0;1;4;1;3;1;1;0;;;;;xiDA5
227;École doctorale Sciences de la nature et de l'homme;;5;Biologie, médecine et santé;2017;2016-17;2016;2016;10;6;4;68;35;33;19;14;5;;;;;xiDA5
227;École doctorale Sciences de la nature et de l'homme;;9;Sciences et technologies de l'information et de la communication;2017;2016-17;2016;2016;0;0;0;2;1;1;0;0;0;;;;;xiDA5
251;École doctorale Sciences de l'environnement;;6;Sciences humaines et humanités;2017;2016-17;2016;2016;3;3;0;7;5;2;3;2;1;;;;;VR28y
266;École doctorale Biologie, santé, environnement;BIOSE;5;Biologie, médecine et santé;2017;2016-17;2016;2016;40;27;13;165;97;68;43;22;21;;;;;386V9
268;École doctorale Langage et langues : description, théorisation, transmission;;7;Sciences de la société;2017;2016-17;2016;2016;0;0;0;5;4;1;1;0;1;;;;;wAIDE
269;École doctorale Mathématiques, sciences de l'information et de l'ingénieur;MSII;1;Mathématiques et leurs interactions;2017;2016-17;2016;2016;13;4;9;46;11;35;12;4;8;;;;;5E625
269;École doctorale Mathématiques, sciences de l'information et de l'ingénieur;MSII;5;Biologie, médecine et santé;2017;2016-17;2016;2016;1;1;0;8;6;2;1;0;1;;;;;5E625
275;École doctorale Sciences de gestion;EDSG;7;Sciences de la société;2017;2016-17;2016;2016;17;14;3;71;43;28;19;5;14;;;;;6QC4I
279;École doctorale Arts plastiques, esthétique et sciences de l'art;APESA;6;Sciences humaines et humanités;2017;2016-17;2016;2016;38;28;10;222;147;75;26;15;11;;;;;BpW1j
286;École doctorale de l'Ehess;;6;Sciences humaines et humanités;2017;2016-17;2016;2016;76;38;38;546;276;270;61;43;18;;;;;2S146
300;École doctorale Sciences Économiques;ED SE;7;Sciences de la société;2017;2016-17;2016;2016;10;3;7;57;19;38;11;3;8;;;;;5x3fM
305;École doctorale Énergie et environnement;E2;4;Chimie;2017;2016-17;2016;2016;1;1;0;11;6;5;0;0;0;;;;;Kbt8I
309;École doctorale Systèmes;EDSYS;8;Sciences pour l'ingénieur;2017;2016-17;2016;2016;22;9;13;72;30;42;16;5;11;;;;;8TT4b
326;École doctorale Comportement, langage, éducation, socialisation, cognition;CLESCO;6;Sciences humaines et humanités;2017;2016-17;2016;2016;75;41;34;290;192;98;56;39;17;;;;;nWIlG
327;École doctorale Temps, espaces, sociétés, cultures;TESC;6;Sciences humaines et humanités;2017;2016-17;2016;2016;52;22;30;264;133;131;41;22;19;;;;;IjgiJ
351;École doctorale Sciences physiques, mathématiques et de l'information pour l'ingénieur;SPMII;1;Mathématiques et leurs interactions;2017;2016-17;2016;2016;0;0;0;0;0;0;6;0;6;;;;;rY4EP
351;École doctorale Sciences physiques, mathématiques et de l'information pour l'ingénieur;SPMII;4;Chimie;2017;2016-17;2016;2016;0;0;0;0;0;0;2;1;1;;;;;rY4EP
353;École doctorale Sciences pour l'ingénieur : mécanique, physique, micro et nanoélectronique;;5;Biologie, médecine et santé;2017;2016-17;2016;2016;0;0;0;5;2;3;0;0;0;;;;;vk5Kp
353;École doctorale Sciences pour l'ingénieur : mécanique, physique, micro et nanoélectronique;;8;Sciences pour l'ingénieur;2017;2016-17;2016;2016;26;6;20;116;17;99;26;5;21;;;;;vk5Kp
354;École doctorale Langues, lettres et arts;LLA;6;Sciences humaines et humanités;2017;2016-17;2016;2016;47;29;18;217;143;74;15;13;2;;;;;RwcSv
355;École doctorale Espaces, cultures, sociétés;;7;Sciences de la société;2017;2016-17;2016;2016;6;5;1;43;25;18;5;5;0;;;;;2kMf5
361;École doctorale Sciences et Technologies;ED ST;6;Sciences humaines et humanités;2017;2016-17;2016;2016;2;1;1;15;7;8;2;1;1;;;;;cOUmL
364;École doctorale Sciences fondamentales et appliquées;EDSFA;4;Chimie;2017;2016-17;2016;2016;11;8;3;35;25;10;11;6;5;;;;;E483q
372;École doctorale Sciences économiques et de gestion;;7;Sciences de la société;2017;2016-17;2016;2016;48;21;27;173;82;91;44;20;24;;;;;JK63A
373;École doctorale Santé, information/communications et mathématiques, matière;SICMA;5;Biologie, médecine et santé;2017;2016-17;2016;2016;25;9;16;89;35;54;15;5;10;;;;;hTJF5
377;École doctorale Environnement et société;;7;Sciences de la société;2017;2016-17;2016;2016;11;6;5;35;20;15;0;0;0;;;;;ZMG5u
377;École doctorale Environnement et société;;8;Sciences pour l'ingénieur;2017;2016-17;2016;2016;1;0;1;9;2;7;1;1;0;;;;;ZMG5u
378;École doctorale Sciences de l'homme et de la société;SHS;6;Sciences humaines et humanités;2017;2016-17;2016;2016;23;10;13;75;42;33;5;3;2;;;;;3XKuF
382;École doctorale Économie, espaces, sociétés, civilisations : pensée critique, politique et pratique sociale;EESC;6;Sciences humaines et humanités;2017;2016-17;2016;2016;21;6;15;107;51;56;14;6;8;;;;;9NI1W
382;École doctorale Économie, espaces, sociétés, civilisations : pensée critique, politique et pratique sociale;EESC;7;Sciences de la société;2017;2016-17;2016;2016;41;26;15;192;115;77;21;11;10;;;;;9NI1W
394;École doctorale Physiologie et physiopathologie;p2t;5;Biologie, médecine et santé;2017;2016-17;2016;2016;66;44;22;218;133;85;55;33;22;;;;;VMYmT
395;École doctorale Milieux, cultures et sociétés du passé et du présent;MCSPP;6;Sciences humaines et humanités;2017;2016-17;2016;2016;48;28;20;383;251;132;57;40;17;;;;;2quEb
398;École doctorale Géosciences, ressources naturelles et environnement;GRNE;3;Sciences de la terre et de l'univers, espace;2017;2016-17;2016;2016;31;12;19;148;61;87;38;17;21;;;;;Zi4Zf
410;École doctorale Sciences et ingénierie des ressources, procédés, produits, environnement;RP2E;3;Sciences de la terre et de l'univers, espace;2017;2016-17;2016;2016;17;8;9;76;34;42;24;5;19;;;;;Q5fxV
410;École doctorale Sciences et ingénierie des ressources, procédés, produits, environnement;RP2E;8;Sciences pour l'ingénieur;2017;2016-17;2016;2016;28;10;18;128;56;72;39;16;23;;;;;Q5fxV
412;École doctorale Lorraine de chimie et physique moléculaires : synthèses, expériences, simulations, applications : de la molécule aux édifices supramoléculaires;SESAMES;4;Chimie;2017;2016-17;2016;2016;18;8;10;69;35;34;20;9;11;;;;;mvHX2
413;École doctorale Sciences de la terre et de l'environnement;STE;4;Chimie;2017;2016-17;2016;2016;0;0;0;0;0;0;2;2;0;;;;;u9BA9
417;École doctorale Sciences et Ingénierie;S&I;3;Sciences de la terre et de l'univers, espace;2017;2016-17;2016;2016;5;1;4;7;1;6;4;3;1;;;;;SSBvE
417;École doctorale Sciences et Ingénierie;S&I;4;Chimie;2017;2016-17;2016;2016;2;1;1;24;13;11;7;4;3;;;;;SSBvE
417;École doctorale Sciences et Ingénierie;S&I;8;Sciences pour l'ingénieur;2017;2016-17;2016;2016;15;3;12;38;14;24;12;4;8;;;;;SSBvE
432;École doctorale Sciences des métiers de l'ingénieur;SMI;8;Sciences pour l'ingénieur;2017;2016-17;2016;2016;142;31;111;515;119;396;151;37;114;;;;;nSsHB
434;École doctorale Géographie de Paris - Espaces, sociétés, aménagement;EDGP;6;Sciences humaines et humanités;2017;2016-17;2016;2016;59;43;16;286;173;113;28;13;15;;;;;1FmLX
446;École doctorale Biologie - Santé;EDBSL;4;Chimie;2017;2016-17;2016;2016;0;0;0;0;0;0;3;1;2;;;;;4iEUF
446;École doctorale Biologie - Santé;EDBSL;10;Sciences agronomiques et écologiques;2017;2016-17;2016;2016;0;0;0;0;0;0;1;1;0;;;;;4iEUF
454;École doctorale Sciences de l'homme, du politique et du territoire;SHPT;7;Sciences de la société;2017;2016-17;2016;2016;17;10;7;121;71;50;13;7;6;;;;;Opv31
460;École doctorale Sciences juridiques;SJ;7;Sciences de la société;2017;2016-17;2016;2016;28;14;14;133;63;70;13;4;9;;;;;ZB5I5
467;École doctorale Aéronautique, astronautique;AA;10;Sciences agronomiques et écologiques;2017;2016-17;2016;2016;1;0;1;1;0;1;0;0;0;;;;;U7l45
469;École doctorale du Pacifique;EDP;5;Biologie, médecine et santé;2017;2016-17;2016;2016;0;0;0;1;1;0;0;0;0;;;;;t9Z2n
474;École doctorale Interdisciplinaire européenne frontières du vivant;FDV;10;Sciences agronomiques et écologiques;2017;2016-17;2016;2016;2;0;2;5;1;4;0;0;0;;;;;E727j
475;École doctorale Mathématiques, informatique, télécommunications de Toulouse;MITT;1;Mathématiques et leurs interactions;2017;2016-17;2016;2016;32;9;23;136;40;96;40;12;28;;;;;xcp2r
480;École doctorale Montaigne-humanités;;2;Physique;2017;2016-17;2016;2016;1;1;0;4;3;1;0;0;0;;;;;f3SeZ
482;École doctorale Sciences de la matière;SDM;8;Sciences pour l'ingénieur;2017;2016-17;2016;2016;16;7;9;55;24;31;11;6;5;;;;;kmeZ4
483;École doctorale Histoire, géographie, aménagement, urbanisme, archéologie, science politique, sociologie, anthropologie;SCSO;7;Sciences de la société;2017;2016-17;2016;2016;12;8;4;121;54;67;10;5;5;;;;;hc6u4
488;École doctorale Sciences, ingénierie, santé;SIS;1;Mathématiques et leurs interactions;2017;2016-17;2016;2016;2;0;2;8;0;8;5;2;3;;;;;Fy2lK
489;École doctorale Sciences et ingénierie des systèmes, de l'environnement et des organisations;SISEO;10;Sciences agronomiques et écologiques;2017;2016-17;2016;2016;1;0;1;13;5;8;2;0;2;;;;;6pT77
492;École doctorale Droit;;7;Sciences de la société;2017;2016-17;2016;2016;59;31;28;311;155;156;37;18;19;;;;;kOQsX
497;École doctorale Normande de Biologie Intégrative, Santé, Environnement;Ed NBISE;3;Sciences de la terre et de l'univers, espace;2017;2016-17;2016;2016;4;2;2;13;4;9;2;1;1;;;;;0D9Je
497;École doctorale Normande de Biologie Intégrative, Santé, Environnement;Ed NBISE;10;Sciences agronomiques et écologiques;2017;2016-17;2016;2016;4;1;3;33;18;15;5;4;1;;;;;0D9Je
500;École doctorale Matière, molécules, matériaux en Pays de Loire;3MPL;9;Sciences et technologies de l'information et de la communication;2017;2016-17;2016;2016;0;0;0;2;0;2;0;0;0;;;;;822tM
501;École doctorale Droit, économie-gestion, sociétés, territoires;;10;Sciences agronomiques et écologiques;2017;2016-17;2016;2016;4;2;2;9;5;4;0;0;0;;;;;wE7WM
502;École doctorale Biologie - Santé;;4;Chimie;2017;2016-17;2016;2016;3;1;2;6;2;4;4;2;2;;;;;JCFV7
502;École doctorale Biologie - Santé;;8;Sciences pour l'ingénieur;2017;2016-17;2016;2016;1;0;1;2;0;2;0;0;0;;;;;JCFV7
503;École doctorale Sciences et technologies de l'information et de mathématiques;STIM;1;Mathématiques et leurs interactions;2017;2016-17;2016;2016;11;6;5;39;15;24;15;3;12;;;;;JQevP
509;École doctorale Civilisations et sociétés euro-méditerranéennes et comparées;;7;Sciences de la société;2017;2016-17;2016;2016;32;11;21;127;43;84;12;6;6;;;;;9tbyG
512;École doctorale Informatique et mathématiques;InfoMaths;1;Mathématiques et leurs interactions;2017;2016-17;2016;2016;34;10;24;120;30;90;18;6;12;;;;;t86bi
512;École doctorale Informatique et mathématiques;InfoMaths;9;Sciences et technologies de l'information et de la communication;2017;2016-17;2016;2016;74;14;60;243;57;186;36;13;23;;;;;t86bi
515;École doctorale Complexité du vivant;CdV;5;Biologie, médecine et santé;2017;2016-17;2016;2016;83;54;29;320;183;137;85;50;35;;;;;CbV9s
522;École doctorale Sciences et ingénierie en matériaux, mécanique, énergétique et aéronautique;SI-MMEA;8;Sciences pour l'ingénieur;2017;2016-17;2016;2016;56;16;40;218;49;169;60;17;43;;;;;82F19
523;École doctorale Sciences pour l'environnement - Gay Lussac;;5;Biologie, médecine et santé;2017;2016-17;2016;2016;5;3;2;26;16;10;9;8;1;;;;;6xD69
523;École doctorale Sciences pour l'environnement - Gay Lussac;;6;Sciences humaines et humanités;2017;2016-17;2016;2016;3;1;2;6;3;3;0;0;0;;;;;6xD69
526;École doctorale Sociétés et organisations;SORG;6;Sciences humaines et humanités;2017;2016-17;2016;2016;17;6;11;64;25;39;5;3;2;;;;;5F3Fd
530;École doctorale Organisations, marchés, institutions;OMI;7;Sciences de la société;2017;2016-17;2016;2016;22;10;12;131;69;62;26;10;16;;;;;4htv7
531;École doctorale Sciences, ingénierie et environnement;SIE;5;Biologie, médecine et santé;2017;2016-17;2016;2016;1;0;1;3;1;2;1;0;1;;;;;b5BYq
536;École doctorale Sciences et agrosciences;;1;Mathématiques et leurs interactions;2017;2016-17;2016;2016;2;1;1;10;3;7;3;0;3;;;;;pHfqe
536;École doctorale Sciences et agrosciences;;3;Sciences de la terre et de l'univers, espace;2017;2016-17;2016;2016;4;1;3;16;8;8;5;1;4;;;;;pHfqe
536;École doctorale Sciences et agrosciences;;10;Sciences agronomiques et écologiques;2017;2016-17;2016;2016;7;4;3;42;25;17;13;8;5;;;;;pHfqe
540;"École doctorale École transdisciplinaire ""lettres/sciences""";;4;Chimie;2017;2016-17;2016;2016;1;0;1;3;1;2;0;0;0;;;;;tWWw7
543;École doctorale de Dauphine;;7;Sciences de la société;2017;2016-17;2016;2016;55;22;33;266;130;136;59;31;28;;;;;u8w6A
545;École doctorale Sociétés, politique et santé publique;SP2;6;Sciences humaines et humanités;2017;2016-17;2016;2016;41;26;15;118;71;47;17;9;8;;;;;IAKR4
547;École doctorale Sciences, Technologie, Santé;EDSTS;2;Physique;2017;2016-17;2016;2016;2;2;0;19;7;12;4;1;3;;;;;wEdn2
547;École doctorale Sciences, Technologie, Santé;EDSTS;8;Sciences pour l'ingénieur;2017;2016-17;2016;2016;17;7;10;58;15;43;13;3;10;;;;;wEdn2
548;École doctorale Mer et Sciences;;3;Sciences de la terre et de l'univers, espace;2017;2016-17;2016;2016;2;0;2;6;3;3;2;0;2;;;;;QX0fS
548;École doctorale Mer et Sciences;;8;Sciences pour l'ingénieur;2017;2016-17;2016;2016;1;0;1;7;2;5;0;0;0;;;;;QX0fS
549;École doctorale Santé, Sciences Biologiques et Chimie du Vivant;SSBCV;3;Sciences de la terre et de l'univers, espace;2017;2016-17;2016;2016;1;0;1;2;1;1;0;0;0;;;;;B9ggO
549;École doctorale Santé, Sciences Biologiques et Chimie du Vivant;SSBCV;5;Biologie, médecine et santé;2017;2016-17;2016;2016;58;35;23;193;116;77;41;21;20;;;;;B9ggO
551;École doctorale Mathématiques, Informatique, Physique Théorique et Ingénierie des Systèmes;MIPTIS;8;Sciences pour l'ingénieur;2017;2016-17;2016;2016;0;0;0;0;0;0;1;0;1;;;;;Mpudz
552;École doctorale Énergie - Matériaux - Sciences de la Terre et de l'Univers;EMTSU;1;Mathématiques et leurs interactions;2017;2016-17;2016;2016;0;0;0;1;0;1;0;0;0;;;;;NTZhw
552;École doctorale Énergie - Matériaux - Sciences de la Terre et de l'Univers;EMTSU;10;Sciences agronomiques et écologiques;2017;2016-17;2016;2016;0;0;0;1;1;0;0;0;0;;;;;NTZhw
553;École doctorale Carnot - Pasteur;;1;Mathématiques et leurs interactions;2017;2016-17;2016;2016;11;3;8;47;15;32;14;5;9;;;;;6h4Z7
553;École doctorale Carnot - Pasteur;;7;Sciences de la société;2017;2016-17;2016;2016;0;0;0;0;0;0;3;0;3;;;;;6h4Z7
554;École doctorale Environnements - Santé;E-S;4;Chimie;2017;2016-17;2016;2016;0;0;0;1;0;1;0;0;0;;;;;ElyFU
554;École doctorale Environnements - Santé;E-S;10;Sciences agronomiques et écologiques;2017;2016-17;2016;2016;31;14;17;124;67;57;44;27;17;;;;;ElyFU
556;École doctorale Homme, Sociétés, Risques, Territoire;HSRT;6;Sciences humaines et humanités;2017;2016-17;2016;2016;46;20;26;230;99;131;33;16;17;;;;;5QEaX
556;École doctorale Homme, Sociétés, Risques, Territoire;HSRT;7;Sciences de la société;2017;2016-17;2016;2016;6;3;3;58;27;31;15;5;10;;;;;5QEaX
558;École doctorale Histoire, Mémoire, Patrimoine, Langage;HMPL;6;Sciences humaines et humanités;2017;2016-17;2016;2016;67;39;28;336;183;153;52;30;22;;;;;uX3jT
566;École doctorale Sciences du Sport, de la Motricité et du Mouvement Humain;SMMH;6;Sciences humaines et humanités;2017;2016-17;2016;2016;12;6;6;69;33;36;14;4;10;;;;;3iv8y
566;École doctorale Sciences du Sport, de la Motricité et du Mouvement Humain;SMMH;9;Sciences et technologies de l'information et de la communication;2017;2016-17;2016;2016;2;1;1;2;1;1;0;0;0;;;;;3iv8y
570;École doctorale Santé Publique;EDSP;5;Biologie, médecine et santé;2017;2016-17;2016;2016;33;23;10;139;96;43;35;24;11;;;;;9lgE4
570;École doctorale Santé Publique;EDSP;6;Sciences humaines et humanités;2017;2016-17;2016;2016;3;3;0;8;7;1;0;0;0;;;;;9lgE4
570;École doctorale Santé Publique;EDSP;7;Sciences de la société;2017;2016-17;2016;2016;1;1;0;4;3;1;0;0;0;;;;;9lgE4
573;École doctorale Interfaces : Approches Interdisciplinaires, Fondements, Applications et Innovation;ED INTERFACES;4;Chimie;2017;2016-17;2016;2016;6;4;2;39;22;17;8;4;4;;;;;gG820
573;École doctorale Interfaces : Approches Interdisciplinaires, Fondements, Applications et Innovation;ED INTERFACES;8;Sciences pour l'ingénieur;2017;2016-17;2016;2016;16;5;11;82;29;53;16;7;9;;;;;gG820
574;École doctorale de Mathématiques Hadamard;EDMH;1;Mathématiques et leurs interactions;2017;2016-17;2016;2016;93;12;81;292;60;232;70;15;55;;;;;4pqal
576;École doctorale Particules, Hadrons, Énergie, Noyau, Instrumentation, Imagerie, Cosmos et Simulation;PHENIICS;4;Chimie;2017;2016-17;2016;2016;1;0;1;10;4;6;5;2;3;;;;;qC4rf
577;École doctorale Structure et dynamique des systèmes vivants;SDSV;5;Biologie, médecine et santé;2017;2016-17;2016;2016;56;31;25;251;146;105;66;35;31;;;;;4bsxJ
579;École doctorale Sciences mécaniques et energétiques, matériaux et géosciences;SMEMaG;8;Sciences pour l'ingénieur;2017;2016-17;2016;2016;70;20;50;316;76;240;65;26;39;;;;;atMj7
580;École doctorale Sciences et technologies de l'information et de la communication;STIC;1;Mathématiques et leurs interactions;2017;2016-17;2016;2016;0;0;0;10;1;9;1;0;1;;;;;AzCC0
580;École doctorale Sciences et technologies de l'information et de la communication;STIC;8;Sciences pour l'ingénieur;2017;2016-17;2016;2016;5;2;3;15;5;10;1;0;1;;;;;AzCC0
583;École doctorale Risques et Société;;4;Chimie;2017;2016-17;2016;2016;1;1;0;2;2;0;1;0;1;;;;;wUBi9
583;École doctorale Risques et Société;;8;Sciences pour l'ingénieur;2017;2016-17;2016;2016;1;1;0;3;1;2;0;0;0;;;;;wUBi9
583;École doctorale Risques et Société;;9;Sciences et technologies de l'information et de la communication;2017;2016-17;2016;2016;2;1;1;3;1;2;0;0;0;;;;;wUBi9
583;École doctorale Risques et Société;;10;Sciences agronomiques et écologiques;2017;2016-17;2016;2016;1;0;1;1;0;1;0;0;0;;;;;wUBi9
584;École doctorale Biodiversité, Agriculture, Alimentation, Environnement, Terre, Eau;GAIA;3;Sciences de la terre et de l'univers, espace;2017;2016-17;2016;2016;16;9;7;67;28;39;14;5;9;;;;;F1h5f
585;École doctorale Sciences, Technologie,  Sante;EDSTS;1;Mathématiques et leurs interactions;2017;2016-17;2016;2016;6;0;6;17;6;11;3;0;3;;;;;NM3Dl
585;École doctorale Sciences, Technologie,  Sante;EDSTS;2;Physique;2017;2016-17;2016;2016;3;2;1;16;9;7;3;1;2;;;;;NM3Dl
585;École doctorale Sciences, Technologie,  Sante;EDSTS;4;Chimie;2017;2016-17;2016;2016;4;2;2;40;14;26;3;1;2;;;;;NM3Dl
586;École doctorale Sciences Humaines et Sociales;EDSHS;6;Sciences humaines et humanités;2017;2016-17;2016;2016;40;20;20;190;99;91;27;17;10;;;;;0RKVX
587;École doctorale Diversites, santé et développement en Amazonie;;1;Mathématiques et leurs interactions;2017;2016-17;2016;2016;0;0;0;1;1;0;0;0;0;;;;;V14tj
587;École doctorale Diversites, santé et développement en Amazonie;;4;Chimie;2017;2016-17;2016;2016;1;1;0;4;3;1;0;0;0;;;;;V14tj
588;École doctorale Milieu insulaire tropical : dynamiques de développement, sociétés, patrimoine et culture dans l'espace Caraïbes-Amériques;;7;Sciences de la société;2017;2016-17;2016;2016;23;15;8;89;52;37;3;1;2;;;;;4W5IO
589;École doctorale Milieu insulaire tropical à risques : protection, valorisation , santé et développement;;1;Mathématiques et leurs interactions;2017;2016-17;2016;2016;7;3;4;14;8;6;2;0;2;;;;;2cqi3
589;École doctorale Milieu insulaire tropical à risques : protection, valorisation , santé et développement;;2;Physique;2017;2016-17;2016;2016;2;0;2;8;2;6;1;1;0;;;;;2cqi3
590;École doctorale Mathematiques, Information, Ingenierie des Systemes;MIIS;8;Sciences pour l'ingénieur;2017;2016-17;2016;2016;1;0;1;4;2;2;0;0;0;;;;;L20t5
594;École doctorale Sociétés, Espaces, Pratiques, Temps;ED SEPT;6;Sciences humaines et humanités;2017;2016-17;2016;2016;70;36;34;383;187;196;0;0;0;;;;;N85H3
7;École doctorale Georges Vedel - Droit public interne, science administrative et science politique;;7;Sciences de la société;2019;2018-19;2018;2018;29;14;15;191;76;115;18;4;14;;;;;Dw881
37;École doctorale Sciences physiques pour l'ingénieur et microtechniques;SPIM;8;Sciences pour l'ingénieur;2019;2018-19;2018;2018;42;14;28;192;54;138;54;12;42;;;;;F7G1B
37;École doctorale Sciences physiques pour l'ingénieur et microtechniques;SPIM;9;Sciences et technologies de l'information et de la communication;2019;2018-19;2018;2018;52;19;33;224;66;158;56;12;44;;;;;F7G1B
40;École doctorale Sciences chimiques;EDSC;4;Chimie;2019;2018-19;2018;2018;65;24;41;278;119;159;87;43;44;;;;;wde3D
47;École doctorale Physique;;2;Physique;2019;2018-19;2018;2018;83;20;63;338;77;261;85;21;64;;;;;8kNpd
47;École doctorale Physique;;9;Sciences et technologies de l'information et de la communication;2019;2018-19;2018;2018;1;0;1;2;1;1;0;0;0;;;;;8kNpd
50;École doctorale Langues, littératures et sciences humaines;LLSH;9;Sciences et technologies de l'information et de la communication;2019;2018-19;2018;2018;4;2;2;49;30;19;14;8;6;;;;;8THzQ
52;École doctorale Physique et astrophysique de Lyon;PHAST;2;Physique;2019;2018-19;2018;2018;58;11;47;153;40;113;40;8;32;;;;;61XPb
60;École doctorale Territoires, temps, sociétés et développement;TTSD;6;Sciences humaines et humanités;2019;2018-19;2018;2018;54;40;14;201;124;77;32;18;14;;;;;fkIh6
62;École doctorale Sciences de la vie et de la santé;;1;Mathématiques et leurs interactions;2019;2018-19;2018;2018;0;0;0;1;0;1;0;0;0;;;;;vZzE7
71;École doctorale Sciences pour l'ingénieur;;9;Sciences et technologies de l'information et de la communication;2019;2018-19;2018;2018;12;3;9;58;15;43;13;4;9;;;;;H6UYp
86;École doctorale Sociétés, humanités, arts, lettres;LSHS;7;Sciences de la société;2019;2018-19;2018;2018;4;3;1;25;13;12;0;0;0;;;;;O8E6y
88;École doctorale Droit et science politique;DSP;7;Sciences de la société;2019;2018-19;2018;2018;34;14;20;241;113;128;22;9;13;;;;;elnAJ
104;École doctorale Sciences de la matière, du rayonnement et de l'environnement;SMRE;4;Chimie;2019;2018-19;2018;2018;62;24;38;223;100;123;56;26;30;;;;;Q5iFz
138;École doctorale Lettres, langues, spectacles;LLS;6;Sciences humaines et humanités;2019;2018-19;2018;2018;41;29;12;224;144;80;33;25;8;;;;;y9O3k
146;École doctorale Galilée;GALILEE;4;Chimie;2019;2018-19;2018;2018;5;2;3;13;5;8;2;2;0;;;;;71hqm
146;École doctorale Galilée;GALILEE;8;Sciences pour l'ingénieur;2019;2018-19;2018;2018;11;3;8;38;14;24;8;5;3;;;;;71hqm
166;École doctorale Information, structures et systèmes;I2S;1;Mathématiques et leurs interactions;2019;2018-19;2018;2018;26;12;14;69;22;47;14;5;9;;;;;2uO68
168;École doctorale Sciences chimiques et biologiques pour la santé;SCBS;4;Chimie;2019;2018-19;2018;2018;0;0;0;0;0;0;1;1;0;;;;;8cEME
178;École doctorale Sciences fondamentales;;2;Physique;2019;2018-19;2018;2018;7;1;6;25;3;22;9;1;8;;;;;1AiR7
178;École doctorale Sciences fondamentales;;3;Sciences de la terre et de l'univers, espace;2019;2018-19;2018;2018;7;3;4;38;13;25;8;3;5;;;;;1AiR7
178;École doctorale Sciences fondamentales;;4;Chimie;2019;2018-19;2018;2018;15;6;9;54;24;30;17;9;8;;;;;1AiR7
180;École doctorale Sciences humaines et sociales : cultures, individus, sociétés;SHS;7;Sciences de la société;2019;2018-19;2018;2018;18;10;8;99;59;40;16;9;7;;;;;D2BT3
182;École doctorale Physique et chimie-physique;;2;Physique;2019;2018-19;2018;2018;25;6;19;119;37;82;18;5;13;;;;;3My6I
182;École doctorale Physique et chimie-physique;;3;Sciences de la terre et de l'univers, espace;2019;2018-19;2018;2018;1;0;1;5;0;5;1;0;1;;;;;3My6I
182;École doctorale Physique et chimie-physique;;4;Chimie;2019;2018-19;2018;2018;30;11;19;102;48;54;27;11;16;;;;;3My6I
205;École doctorale Interdisciplinaire Sciences-Santé;EDISS;5;Biologie, médecine et santé;2019;2018-19;2018;2018;57;32;25;271;153;118;69;48;21;;;;;69W38
216;École doctorale Ingénierie pour la santé, la cognition, l'environnement;EDISCE;5;Biologie, médecine et santé;2019;2018-19;2018;2018;30;17;13;109;51;58;27;9;18;;;;;fPs1t
220;École doctorale Électronique, électrotechnique, automatique, traitement du signal;EEATS;1;Mathématiques et leurs interactions;2019;2018-19;2018;2018;4;1;3;10;3;7;2;1;1;;;;;IxEaw
220;École doctorale Électronique, électrotechnique, automatique, traitement du signal;EEATS;4;Chimie;2019;2018-19;2018;2018;0;0;0;1;0;1;0;0;0;;;;;IxEaw
220;École doctorale Électronique, électrotechnique, automatique, traitement du signal;EEATS;8;Sciences pour l'ingénieur;2019;2018-19;2018;2018;52;11;41;228;53;175;48;10;38;;;;;IxEaw
222;École doctorale Sciences chimiques;EDSC;2;Physique;2019;2018-19;2018;2018;2;0;2;10;3;7;2;1;1;;;;;AdU8Q
224;École doctorale Cognition, langage, interaction;;6;Sciences humaines et humanités;2019;2018-19;2018;2018;31;20;11;152;99;53;23;13;10;;;;;7v43e
227;École doctorale Sciences de la nature et de l'homme;;6;Sciences humaines et humanités;2019;2018-19;2018;2018;7;6;1;40;22;18;9;7;2;;;;;xiDA5
251;École doctorale Sciences de l'environnement;;10;Sciences agronomiques et écologiques;2019;2018-19;2018;2018;7;5;2;35;21;14;13;9;4;;;;;VR28y
269;École doctorale Mathématiques, sciences de l'information et de l'ingénieur;MSII;1;Mathématiques et leurs interactions;2019;2018-19;2018;2018;14;4;10;49;12;37;16;5;11;;;;;5E625
269;École doctorale Mathématiques, sciences de l'information et de l'ingénieur;MSII;2;Physique;2019;2018-19;2018;2018;1;0;1;2;0;2;0;0;0;;;;;5E625
269;École doctorale Mathématiques, sciences de l'information et de l'ingénieur;MSII;5;Biologie, médecine et santé;2019;2018-19;2018;2018;0;0;0;12;5;7;2;1;1;;;;;5E625
269;École doctorale Mathématiques, sciences de l'information et de l'ingénieur;MSII;6;Sciences humaines et humanités;2019;2018-19;2018;2018;1;1;0;1;1;0;0;0;0;;;;;5E625
286;École doctorale de l'Ehess;;6;Sciences humaines et humanités;2019;2018-19;2018;2018;95;48;47;521;258;263;62;33;29;;;;;2S146
286;École doctorale de l'Ehess;;7;Sciences de la société;2019;2018-19;2018;2018;140;75;65;959;551;408;129;72;57;;;;;2S146
323;École doctorale Génie électrique, électronique et télécommunications;GEET;8;Sciences pour l'ingénieur;2019;2018-19;2018;2018;48;6;42;205;53;152;50;14;36;;;;;arcz6
327;École doctorale Temps, espaces, sociétés, cultures;TESC;7;Sciences de la société;2019;2018-19;2018;2018;23;16;7;97;57;40;6;2;4;;;;;IjgiJ
353;École doctorale Sciences pour l'ingénieur : mécanique, physique, micro et nanoélectronique;;2;Physique;2019;2018-19;2018;2018;0;0;0;12;3;9;10;0;10;;;;;vk5Kp
353;École doctorale Sciences pour l'ingénieur : mécanique, physique, micro et nanoélectronique;;5;Biologie, médecine et santé;2019;2018-19;2018;2018;0;0;0;0;0;0;1;1;0;;;;;vk5Kp
361;École doctorale Sciences et Technologies;ED ST;6;Sciences humaines et humanités;2019;2018-19;2018;2018;4;2;2;19;8;11;5;1;4;;;;;cOUmL
364;École doctorale Sciences fondamentales et appliquées;EDSFA;2;Physique;2019;2018-19;2018;2018;13;1;12;51;11;40;12;2;10;;;;;E483q
364;École doctorale Sciences fondamentales et appliquées;EDSFA;4;Chimie;2019;2018-19;2018;2018;16;6;10;47;26;21;11;7;4;;;;;E483q
377;École doctorale Environnement et société;;7;Sciences de la société;2019;2018-19;2018;2018;8;6;2;41;27;14;6;4;2;;;;;ZMG5u
382;École doctorale Économie, espaces, sociétés, civilisations : pensée critique, politique et pratique sociale;EESC;7;Sciences de la société;2019;2018-19;2018;2018;26;13;13;128;67;61;18;11;7;;;;;9NI1W
388;École doctorale Chimie physique et chimie analytique de Paris centre;CPCA;4;Chimie;2019;2018-19;2018;2018;93;41;52;312;136;176;79;34;45;;;;;M0Hnd
396;École doctorale Économie, organisations, société;EOS;8;Sciences pour l'ingénieur;2019;2018-19;2018;2018;0;0;0;0;0;0;1;0;1;;;;;Es5e7
398;École doctorale Géosciences, ressources naturelles et environnement;GRNE;3;Sciences de la terre et de l'univers, espace;2019;2018-19;2018;2018;34;14;20;120;58;62;40;14;26;;;;;Zi4Zf
400;École doctorale Savoirs scientifiques : épistémologie, histoire des sciences, didactique des disciplines;;1;Mathématiques et leurs interactions;2019;2018-19;2018;2018;3;2;1;21;9;12;8;4;4;;;;;nRax3
400;École doctorale Savoirs scientifiques : épistémologie, histoire des sciences, didactique des disciplines;;8;Sciences pour l'ingénieur;2019;2018-19;2018;2018;0;0;0;1;0;1;0;0;0;;;;;nRax3
401;École doctorale Sciences sociales;;6;Sciences humaines et humanités;2019;2018-19;2018;2018;31;12;19;154;75;79;18;6;12;;;;;raQ7K
401;École doctorale Sciences sociales;;7;Sciences de la société;2019;2018-19;2018;2018;33;21;12;175;101;74;19;11;8;;;;;raQ7K
401;École doctorale Sciences sociales;;9;Sciences et technologies de l'information et de la communication;2019;2018-19;2018;2018;13;4;9;36;10;26;5;3;2;;;;;raQ7K
410;École doctorale Sciences et ingénierie des ressources, procédés, produits, environnement;RP2E;3;Sciences de la terre et de l'univers, espace;2019;2018-19;2018;2018;0;0;0;0;0;0;5;1;4;;;;;Q5fxV
410;École doctorale Sciences et ingénierie des ressources, procédés, produits, environnement;RP2E;4;Chimie;2019;2018-19;2018;2018;0;0;0;0;0;0;1;0;1;;;;;Q5fxV
410;École doctorale Sciences et ingénierie des ressources, procédés, produits, environnement;RP2E;8;Sciences pour l'ingénieur;2019;2018-19;2018;2018;0;0;0;0;0;0;14;6;8;;;;;Q5fxV
410;École doctorale Sciences et ingénierie des ressources, procédés, produits, environnement;RP2E;10;Sciences agronomiques et écologiques;2019;2018-19;2018;2018;0;0;0;0;0;0;5;3;2;;;;;Q5fxV
412;École doctorale Lorraine de chimie et physique moléculaires : synthèses, expériences, simulations, applications : de la molécule aux édifices supramoléculaires;SESAMES;4;Chimie;2019;2018-19;2018;2018;0;0;0;0;0;0;7;3;4;;;;;mvHX2
417;École doctorale Sciences et Ingénierie;S&I;8;Sciences pour l'ingénieur;2019;2018-19;2018;2018;12;4;8;51;20;31;2;1;1;;;;;SSBvE
434;École doctorale Géographie de Paris - Espaces, sociétés, aménagement;EDGP;6;Sciences humaines et humanités;2019;2018-19;2018;2018;55;30;25;287;172;115;38;19;19;;;;;1FmLX
446;École doctorale Biologie - Santé;EDBSL;5;Biologie, médecine et santé;2019;2018-19;2018;2018;88;59;29;347;191;156;74;46;28;;;;;4iEUF
461;École doctorale Droit et science politique;;7;Sciences de la société;2019;2018-19;2018;2018;55;28;27;280;154;126;23;14;9;;;;;QGArN
463;École doctorale Sciences du mouvement humain;SMH;5;Biologie, médecine et santé;2019;2018-19;2018;2018;20;6;14;62;28;34;16;6;10;;;;;UbtlY
467;École doctorale Aéronautique, astronautique;AA;5;Biologie, médecine et santé;2019;2018-19;2018;2018;0;0;0;4;3;1;0;0;0;;;;;U7l45
467;École doctorale Aéronautique, astronautique;AA;10;Sciences agronomiques et écologiques;2019;2018-19;2018;2018;0;0;0;1;0;1;0;0;0;;;;;U7l45
468;École doctorale Mécanique, énergétique, génie civil, procédés;MEGEP;8;Sciences pour l'ingénieur;2019;2018-19;2018;2018;125;34;91;485;130;355;119;31;88;;;;;4XUTB
472;École doctorale de l'EPHE;;1;Mathématiques et leurs interactions;2019;2018-19;2018;2018;2;0;2;4;2;2;1;0;1;;;;;27zK4
472;École doctorale de l'EPHE;;2;Physique;2019;2018-19;2018;2018;0;0;0;1;1;0;0;0;0;;;;;27zK4
472;École doctorale de l'EPHE;;4;Chimie;2019;2018-19;2018;2018;2;2;0;2;2;0;0;0;0;;;;;27zK4
474;École doctorale Interdisciplinaire européenne frontières du vivant;FDV;3;Sciences de la terre et de l'univers, espace;2019;2018-19;2018;2018;2;2;0;4;4;0;3;1;2;;;;;E727j
474;École doctorale Interdisciplinaire européenne frontières du vivant;FDV;5;Biologie, médecine et santé;2019;2018-19;2018;2018;23;11;12;90;42;48;29;13;16;;;;;E727j
474;École doctorale Interdisciplinaire européenne frontières du vivant;FDV;6;Sciences humaines et humanités;2019;2018-19;2018;2018;4;3;1;7;5;2;2;2;0;;;;;E727j
474;École doctorale Interdisciplinaire européenne frontières du vivant;FDV;9;Sciences et technologies de l'information et de la communication;2019;2018-19;2018;2018;2;1;1;2;1;1;0;0;0;;;;;E727j
476;École doctorale Neurosciences et cognition;NSCO;5;Biologie, médecine et santé;2019;2018-19;2018;2018;37;23;14;145;83;62;28;12;16;;;;;B1H0x
478;École doctorale Sciences de Gestion;;7;Sciences de la société;2019;2018-19;2018;2018;13;7;6;58;37;21;9;7;2;;;;;q34kB
479;École doctorale Sciences juridiques et politiques;;7;Sciences de la société;2019;2018-19;2018;2018;36;18;18;324;164;160;49;20;29;;;;;34mid
480;École doctorale Montaigne-humanités;;2;Physique;2019;2018-19;2018;2018;4;3;1;7;6;1;1;0;1;;;;;f3SeZ
480;École doctorale Montaigne-humanités;;3;Sciences de la terre et de l'univers, espace;2019;2018-19;2018;2018;6;2;4;22;9;13;3;0;3;;;;;f3SeZ
481;École doctorale Sciences sociales et humanités;SSH;6;Sciences humaines et humanités;2019;2018-19;2018;2018;23;11;12;129;77;52;11;6;5;;;;;E3z5j
482;École doctorale Sciences de la matière;SDM;5;Biologie, médecine et santé;2019;2018-19;2018;2018;0;0;0;2;1;1;0;0;0;;;;;kmeZ4
483;École doctorale Histoire, géographie, aménagement, urbanisme, archéologie, science politique, sociologie, anthropologie;SCSO;7;Sciences de la société;2019;2018-19;2018;2018;46;23;23;245;140;105;19;10;9;;;;;hc6u4
488;École doctorale Sciences, ingénierie, santé;SIS;4;Chimie;2019;2018-19;2018;2018;4;2;2;17;8;9;3;1;2;;;;;Fy2lK
488;École doctorale Sciences, ingénierie, santé;SIS;10;Sciences agronomiques et écologiques;2019;2018-19;2018;2018;2;0;2;5;2;3;0;0;0;;;;;Fy2lK
489;École doctorale Sciences et ingénierie des systèmes, de l'environnement et des organisations;SISEO;2;Physique;2019;2018-19;2018;2018;1;0;1;1;0;1;0;0;0;;;;;6pT77
489;École doctorale Sciences et ingénierie des systèmes, de l'environnement et des organisations;SISEO;5;Biologie, médecine et santé;2019;2018-19;2018;2018;0;0;0;4;0;4;0;0;0;;;;;6pT77
489;École doctorale Sciences et ingénierie des systèmes, de l'environnement et des organisations;SISEO;8;Sciences pour l'ingénieur;2019;2018-19;2018;2018;14;8;6;60;22;38;13;4;9;;;;;6pT77
493;École doctorale Erasme;;6;Sciences humaines et humanités;2019;2018-19;2018;2018;23;18;5;111;75;36;16;13;3;;;;;FPW4T
508;École doctorale Normande de chimie;EDNC;5;Biologie, médecine et santé;2019;2018-19;2018;2018;3;2;1;11;7;4;4;3;1;;;;;E52OO
519;École doctorale Sciences humaines et sociales - Perspectives européennes;SHS-PE;6;Sciences humaines et humanités;2019;2018-19;2018;2018;42;23;19;286;172;114;42;27;15;;;;;2f5qs
521;École doctorale Sciences et ingénierie pour l'information, mathématiques;S2I;1;Mathématiques et leurs interactions;2019;2018-19;2018;2018;0;0;0;0;0;0;8;5;3;;;;;V6i83
521;École doctorale Sciences et ingénierie pour l'information, mathématiques;S2I;9;Sciences et technologies de l'information et de la communication;2019;2018-19;2018;2018;0;0;0;0;0;0;24;4;20;;;;;V6i83
522;École doctorale Sciences et ingénierie en matériaux, mécanique, énergétique et aéronautique;SI-MMEA;2;Physique;2019;2018-19;2018;2018;0;0;0;0;0;0;10;1;9;;;;;82F19
523;École doctorale Sciences pour l'environnement - Gay Lussac;;3;Sciences de la terre et de l'univers, espace;2019;2018-19;2018;2018;0;0;0;0;0;0;7;3;4;;;;;6xD69
531;École doctorale Sciences, ingénierie et environnement;SIE;8;Sciences pour l'ingénieur;2019;2018-19;2018;2018;52;23;29;217;86;131;69;26;43;;;;;b5BYq
536;École doctorale Sciences et agrosciences;;10;Sciences agronomiques et écologiques;2019;2018-19;2018;2018;7;4;3;39;22;17;8;3;5;;;;;pHfqe
540;"École doctorale École transdisciplinaire ""lettres/sciences""";;4;Chimie;2019;2018-19;2018;2018;0;0;0;1;0;1;1;0;1;;;;;tWWw7
540;"École doctorale École transdisciplinaire ""lettres/sciences""";;6;Sciences humaines et humanités;2019;2018-19;2018;2018;34;11;23;167;72;95;20;12;8;;;;;tWWw7
541;École doctorale de sciences humaines et sociales de La Réunion;SHS;7;Sciences de la société;2019;2018-19;2018;2018;9;2;7;43;23;20;11;6;5;;;;;21SpE
542;École doctorale de sciences de La Réunion;STS;5;Biologie, médecine et santé;2019;2018-19;2018;2018;4;4;0;28;15;13;8;4;4;;;;;2pAql
544;École doctorale Inter-Med : Espaces, temps, cultures;INTER-MED;6;Sciences humaines et humanités;2019;2018-19;2018;2018;14;7;7;78;46;32;23;10;13;;;;;7VjtD
549;École doctorale Santé, Sciences Biologiques et Chimie du Vivant;SSBCV;4;Chimie;2019;2018-19;2018;2018;14;8;6;51;24;27;14;3;11;;;;;B9ggO
551;École doctorale Mathématiques, Informatique, Physique Théorique et Ingénierie des Systèmes;MIPTIS;2;Physique;2019;2018-19;2018;2018;2;0;2;8;0;8;1;0;1;;;;;Mpudz
552;École doctorale Énergie - Matériaux - Sciences de la Terre et de l'Univers;EMTSU;2;Physique;2019;2018-19;2018;2018;8;3;5;23;9;14;12;4;8;;;;;NTZhw
553;École doctorale Carnot - Pasteur;;4;Chimie;2019;2018-19;2018;2018;26;10;16;83;33;50;19;4;15;;;;;6h4Z7
560;École doctorale Sciences de la terre et de l'environnement et Physique de l'univers, Paris;STEP'UP;2;Physique;2019;2018-19;2018;2018;3;1;2;21;6;15;9;3;6;;;;;Z2VI9
562;École doctorale Bio Sorbonne Paris Cité;BioSPC;5;Biologie, médecine et santé;2019;2018-19;2018;2018;147;100;47;522;349;173;139;98;41;;;;;4Yju6
563;École doctorale Médicament - Toxicologie - Chimie - Imageries;MTCI;4;Chimie;2019;2018-19;2018;2018;12;7;5;45;23;22;15;9;6;;;;;j8uk1
564;École doctorale Physique en Ile de France;PIF;2;Physique;2019;2018-19;2018;2018;188;38;150;619;131;488;151;46;105;;;;;39AcN
573;École doctorale Interfaces : Approches Interdisciplinaires, Fondements, Applications et Innovation;ED INTERFACES;4;Chimie;2019;2018-19;2018;2018;14;7;7;42;20;22;9;5;4;;;;;gG820
574;École doctorale de Mathématiques Hadamard;EDMH;1;Mathématiques et leurs interactions;2019;2018-19;2018;2018;87;15;72;329;60;269;76;12;64;;;;;4pqal
575;École doctorale Electrical, Optical, Bio : Physics and Engineering;EOBE;5;Biologie, médecine et santé;2019;2018-19;2018;2018;5;2;3;11;5;6;0;0;0;;;;;dfhyn
576;École doctorale Particules, Hadrons, Énergie, Noyau, Instrumentation, Imagerie, Cosmos et Simulation;PHENIICS;3;Sciences de la terre et de l'univers, espace;2019;2018-19;2018;2018;3;1;2;5;2;3;1;0;1;;;;;qC4rf
577;École doctorale Structure et dynamique des systèmes vivants;SDSV;4;Chimie;2019;2018-19;2018;2018;0;0;0;1;1;0;1;1;0;;;;;4bsxJ
578;École doctorale Sciences de l'Homme et de la Société;ED SHS;1;Mathématiques et leurs interactions;2019;2018-19;2018;2018;1;0;1;1;0;1;0;0;0;;;;;Ud43O
578;École doctorale Sciences de l'Homme et de la Société;ED SHS;9;Sciences et technologies de l'information et de la communication;2019;2018-19;2018;2018;1;0;1;1;0;1;0;0;0;;;;;Ud43O
579;École doctorale Sciences mécaniques et energétiques, matériaux et géosciences;SMEMaG;2;Physique;2019;2018-19;2018;2018;14;3;11;55;10;45;13;3;10;;;;;atMj7
579;École doctorale Sciences mécaniques et energétiques, matériaux et géosciences;SMEMaG;8;Sciences pour l'ingénieur;2019;2018-19;2018;2018;57;19;38;297;76;221;69;11;58;;;;;atMj7
581;École doctorale Agriculture, alimentation, biologie, environnement, santé;ABIES;10;Sciences agronomiques et écologiques;2019;2018-19;2018;2018;22;15;7;107;71;36;27;15;12;;;;;c1x56
583;École doctorale Risques et Société;;7;Sciences de la société;2019;2018-19;2018;2018;5;3;2;10;5;5;0;0;0;;;;;wUBi9
584;École doctorale Biodiversité, Agriculture, Alimentation, Environnement, Terre, Eau;GAIA;5;Biologie, médecine et santé;2019;2018-19;2018;2018;15;7;8;64;30;34;15;9;6;;;;;F1h5f
586;École doctorale Sciences Humaines et Sociales;EDSHS;7;Sciences de la société;2019;2018-19;2018;2018;14;3;11;79;37;42;7;2;5;;;;;0RKVX
587;École doctorale Diversites, santé et développement en Amazonie;;4;Chimie;2019;2018-19;2018;2018;0;0;0;1;0;1;1;1;0;;;;;V14tj
587;École doctorale Diversites, santé et développement en Amazonie;;7;Sciences de la société;2019;2018-19;2018;2018;4;3;1;10;5;5;0;0;0;;;;;V14tj
588;École doctorale Milieu insulaire tropical : dynamiques de développement, sociétés, patrimoine et culture dans l'espace Caraïbes-Amériques;;6;Sciences humaines et humanités;2019;2018-19;2018;2018;26;20;6;134;83;51;7;6;1;;;;;4W5IO
589;École doctorale Milieu insulaire tropical à risques : protection, valorisation , santé et développement;;1;Mathématiques et leurs interactions;2019;2018-19;2018;2018;4;0;4;12;4;8;2;1;1;;;;;2cqi3
589;École doctorale Milieu insulaire tropical à risques : protection, valorisation , santé et développement;;9;Sciences et technologies de l'information et de la communication;2019;2018-19;2018;2018;2;0;2;6;0;6;1;0;1;;;;;2cqi3
596;École doctorale Matière, Molécules et Matériaux;ED 3M;5;Biologie, médecine et santé;2019;2018-19;2018;2018;0;0;0;1;1;0;0;0;0;;;;;77947
596;École doctorale Matière, Molécules et Matériaux;ED 3M;9;Sciences et technologies de l'information et de la communication;2019;2018-19;2018;2018;10;3;7;33;10;23;11;0;11;;;;;77947
598;École doctorale Sciences de La Mer et du Littoral;SML;10;Sciences agronomiques et écologiques;2019;2018-19;2018;2018;16;9;7;69;36;33;22;10;12;;;;;Smen6
601;École doctorale Mathématiques et Sciences et Technologies de l'information et de la Communication;MathSTIC;1;Mathématiques et leurs interactions;2019;2018-19;2018;2018;44;10;34;130;39;91;38;14;24;;;;;3Ue20
602;École doctorale Sciences pour l'Ingénieur;SPI;8;Sciences pour l'ingénieur;2019;2018-19;2018;2018;118;36;82;547;167;380;135;43;92;;;;;8yWbu
603;École doctorale Éducation, Langages, Interactions, Cognition, Clinique, Expertise - ED 603;ELICCE;6;Sciences humaines et humanités;2019;2018-19;2018;2018;60;37;23;380;214;166;44;26;18;;;;;1Mzw7
604;École doctorale Sociétés, Temps, Territoires;STT;10;Sciences agronomiques et écologiques;2019;2018-19;2018;2018;0;0;0;7;5;2;1;0;1;;;;;SZI5T
605;École doctorale Biologie Santé;ED BS;4;Chimie;2019;2018-19;2018;2018;1;0;1;4;1;3;4;2;2;;;;;w8CxU
606;École doctorale Chimie - Mécanique - Matériaux - Physique;C2MP;2;Physique;2019;2018-19;2018;2018;23;6;17;91;21;70;13;2;11;;;;;UkNR2
607;École doctorale Sciences et Ingénierie des Ressources Naturelles;SIReNA;3;Sciences de la terre et de l'univers, espace;2019;2018-19;2018;2018;15;4;11;69;27;42;5;1;4;;;;;vi9w2
610;École doctorale Sciences et Ingénierie des Systèmes, Mathématiques, Informatique;SISMI;1;Mathématiques et leurs interactions;2019;2018-19;2018;2018;5;2;3;31;7;24;0;0;0;;;;;dBCUB
610;École doctorale Sciences et Ingénierie des Systèmes, Mathématiques, Informatique;SISMI;9;Sciences et technologies de l'information et de la communication;2019;2018-19;2018;2018;40;13;27;107;25;82;0;0;0;;;;;dBCUB
613;École doctorale Sciences de la Société, Territoires, Sciences Economiques et de Gestion;SSTSEG;6;Sciences humaines et humanités;2019;2018-19;2018;2018;8;2;6;50;22;28;0;0;0;;;;;6eLRF
614;École doctorale Chimie, Écologie, Géosciences, Agrosciences - Théodore Monod;CEGA;5;Biologie, médecine et santé;2019;2018-19;2018;2018;3;0;3;10;5;5;0;0;0;;;;;uc10I
617;École doctorale Sciences de la Société : Territoires, Economie et Droit;SSTED;6;Sciences humaines et humanités;2019;2018-19;2018;2018;13;7;6;81;36;45;14;6;8;;;;;Kl9ZX
618;École doctorale EUCLIDE;;1;Mathématiques et leurs interactions;2019;2018-19;2018;2018;0;0;0;2;0;2;0;0;0;;;;;qveTN
621;École doctorale Ingénierie des Systèmes, Matériaux, Mécanique, Énergétique;ISMME;2;Physique;2019;2018-19;2018;2018;0;0;0;1;0;1;0;0;0;;;;;B2549
9;École doctorale Droit international, droit européen, relations internationales et droit comparé;;7;Sciences de la société;2018;2017-18;2017;2017;43;27;16;248;157;91;19;12;7;;;;;v1emR
34;École doctorale Matériaux;;2;Physique;2018;2017-18;2017;2017;15;5;10;93;37;56;30;11;19;;;;;1Iufh
40;École doctorale Sciences chimiques;EDSC;4;Chimie;2018;2017-18;2017;2017;77;38;39;288;134;154;82;33;49;;;;;wde3D
62;École doctorale Sciences de la vie et de la santé;;10;Sciences agronomiques et écologiques;2018;2017-18;2017;2017;2;2;0;3;2;1;0;0;0;;;;;vZzE7
65;École doctorale Sciences de la Vie, Santé, Agronomie, Environnement;;5;Biologie, médecine et santé;2018;2017-18;2017;2017;40;26;14;142;112;30;47;29;18;;;;;MAOG4
73;École doctorale Sciences économiques, sociales, de l'aménagement et du management;SESAM;6;Sciences humaines et humanités;2018;2017-18;2017;2017;29;13;16;185;90;95;23;9;14;;;;;IQ0Hk
73;École doctorale Sciences économiques, sociales, de l'aménagement et du management;SESAM;7;Sciences de la société;2018;2017-18;2017;2017;23;11;12;104;48;56;21;9;12;;;;;IQ0Hk
77;École doctorale Informatique, automatique, électronique, électrotechnique, mathématiques;IAEM;9;Sciences et technologies de l'information et de la communication;2018;2017-18;2017;2017;52;15;37;225;62;163;72;20;52;;;;;TCHTA
79;École doctorale Sciences juridiques, politiques, économiques et de gestion;SJPEG;7;Sciences de la société;2018;2017-18;2017;2017;34;20;14;174;88;86;24;8;16;;;;;ea4x6
84;École doctorale Sciences et technologies de l'information et de la communication;STIC;9;Sciences et technologies de l'information et de la communication;2018;2017-18;2017;2017;64;18;46;221;68;153;48;13;35;;;;;9wS2W
92;École doctorale Vie -  Agro - Santé;;10;Sciences agronomiques et écologiques;2018;2017-18;2017;2017;0;0;0;0;0;0;13;8;5;;;;;RjvXY
112;École doctorale Archéologie;;6;Sciences humaines et humanités;2018;2017-18;2017;2017;26;21;5;218;129;89;34;26;8;;;;;EvU7R
120;École doctorale Littérature française et comparée;;6;Sciences humaines et humanités;2018;2017-18;2017;2017;49;34;15;217;152;65;38;27;11;;;;;3ULpe
124;École doctorale Histoire de l'art et archéologie;;6;Sciences humaines et humanités;2018;2017-18;2017;2017;22;17;5;169;113;56;31;20;11;;;;;MBN4L
131;École doctorale Langue, littérature, image, civilisations et sciences humaines (domaines francophone et anglophone);LLI;6;Sciences humaines et humanités;2018;2017-18;2017;2017;17;13;4;147;100;47;28;18;10;;;;;a47aW
146;École doctorale Galilée;GALILEE;4;Chimie;2018;2017-18;2017;2017;12;5;7;40;19;21;2;1;1;;;;;71hqm
154;École doctorale Sciences de la vie et de la santé;SVS;5;Biologie, médecine et santé;2018;2017-18;2017;2017;101;66;35;315;192;123;74;45;29;;;;;hLn36
156;École doctorale Sciences de la mer;;6;Sciences humaines et humanités;2018;2017-18;2017;2017;0;0;0;0;0;0;3;2;1;;;;;EGY9P
156;École doctorale Sciences de la mer;;10;Sciences agronomiques et écologiques;2018;2017-18;2017;2017;0;0;0;0;0;0;12;8;4;;;;;EGY9P
159;École doctorale Esthétique, sciences et technologies des arts;EDESTA;6;Sciences humaines et humanités;2018;2017-18;2017;2017;39;21;18;246;148;98;36;24;12;;;;;zj1Vj
162;École doctorale Mécanique, énergétique, génie civil, acoustique;MEGA;8;Sciences pour l'ingénieur;2018;2017-18;2017;2017;95;26;69;425;98;327;96;27;69;;;;;7wCke
166;École doctorale Information, structures et systèmes;I2S;10;Sciences agronomiques et écologiques;2018;2017-18;2017;2017;1;0;1;4;1;3;1;0;1;;;;;2uO68
168;École doctorale Sciences chimiques et biologiques pour la santé;SCBS;5;Biologie, médecine et santé;2018;2017-18;2017;2017;95;54;41;354;203;151;87;54;33;;;;;8cEME
173;École doctorale Sciences de l'univers, de l'environnement et de l'espace;SDU2E;8;Sciences pour l'ingénieur;2018;2017-18;2017;2017;6;2;4;22;6;16;3;0;3;;;;;R0Z9c
173;École doctorale Sciences de l'univers, de l'environnement et de l'espace;SDU2E;10;Sciences agronomiques et écologiques;2018;2017-18;2017;2017;3;1;2;29;15;14;5;4;1;;;;;R0Z9c
178;École doctorale Sciences fondamentales;;2;Physique;2018;2017-18;2017;2017;5;1;4;30;4;26;13;4;9;;;;;1AiR7
182;École doctorale Physique et chimie-physique;;4;Chimie;2018;2017-18;2017;2017;28;12;16;85;41;44;15;8;7;;;;;3My6I
205;École doctorale Interdisciplinaire Sciences-Santé;EDISS;5;Biologie, médecine et santé;2018;2017-18;2017;2017;50;25;25;266;152;114;45;25;20;;;;;69W38
205;École doctorale Interdisciplinaire Sciences-Santé;EDISS;9;Sciences et technologies de l'information et de la communication;2018;2017-18;2017;2017;2;1;1;4;2;2;1;0;1;;;;;69W38
209;École doctorale Sciences physiques et de L'ingénieur;SPI;8;Sciences pour l'ingénieur;2018;2017-18;2017;2017;20;11;9;81;31;50;28;4;24;;;;;tZcIZ
211;École doctorale Sciences exactes et leurs applications;ED SEA;5;Biologie, médecine et santé;2018;2017-18;2017;2017;4;2;2;9;6;3;4;2;2;;;;;1G1iC
216;École doctorale Ingénierie pour la santé, la cognition, l'environnement;EDISCE;2;Physique;2018;2017-18;2017;2017;1;0;1;5;0;5;0;0;0;;;;;fPs1t
216;École doctorale Ingénierie pour la santé, la cognition, l'environnement;EDISCE;4;Chimie;2018;2017-18;2017;2017;0;0;0;3;2;1;1;1;0;;;;;fPs1t
220;École doctorale Électronique, électrotechnique, automatique, traitement du signal;EEATS;1;Mathématiques et leurs interactions;2018;2017-18;2017;2017;0;0;0;7;3;4;0;0;0;;;;;IxEaw
220;École doctorale Électronique, électrotechnique, automatique, traitement du signal;EEATS;5;Biologie, médecine et santé;2018;2017-18;2017;2017;1;1;0;1;1;0;0;0;0;;;;;IxEaw
220;École doctorale Électronique, électrotechnique, automatique, traitement du signal;EEATS;9;Sciences et technologies de l'information et de la communication;2018;2017-18;2017;2017;41;5;36;213;46;167;81;24;57;;;;;IxEaw
221;École doctorale Augustin Cournot - Sciences économiques et de gestion - Sciences, technologies et sociétés;EDAC;9;Sciences et technologies de l'information et de la communication;2018;2017-18;2017;2017;0;0;0;0;0;0;1;1;0;;;;;5z9rW
224;École doctorale Cognition, langage, interaction;;6;Sciences humaines et humanités;2018;2017-18;2017;2017;38;23;15;156;97;59;26;12;14;;;;;7v43e
224;École doctorale Cognition, langage, interaction;;8;Sciences pour l'ingénieur;2018;2017-18;2017;2017;1;0;1;8;6;2;2;2;0;;;;;7v43e
227;École doctorale Sciences de la nature et de l'homme;;7;Sciences de la société;2018;2017-18;2017;2017;3;2;1;3;2;1;2;1;1;;;;;xiDA5
227;École doctorale Sciences de la nature et de l'homme;;10;Sciences agronomiques et écologiques;2018;2017-18;2017;2017;42;22;20;143;78;65;23;11;12;;;;;xiDA5
251;École doctorale Sciences de l'environnement;;3;Sciences de la terre et de l'univers, espace;2018;2017-18;2017;2017;20;8;12;88;43;45;26;7;19;;;;;VR28y
254;École doctorale Sciences de la matière;;8;Sciences pour l'ingénieur;2018;2017-18;2017;2017;0;0;0;0;0;0;7;2;5;;;;;365F2
265;École doctorale Langues, littératures et sociétés du monde;;6;Sciences humaines et humanités;2018;2017-18;2017;2017;58;30;28;284;177;107;45;29;16;;;;;4YWGW
266;École doctorale Biologie, santé, environnement;BIOSE;5;Biologie, médecine et santé;2018;2017-18;2017;2017;29;19;10;149;94;55;43;18;25;;;;;386V9
269;École doctorale Mathématiques, sciences de l'information et de l'ingénieur;MSII;9;Sciences et technologies de l'information et de la communication;2018;2017-18;2017;2017;34;15;19;114;24;90;0;0;0;;;;;5E625
279;École doctorale Arts plastiques, esthétique et sciences de l'art;APESA;6;Sciences humaines et humanités;2018;2017-18;2017;2017;29;22;7;200;137;63;30;16;14;;;;;BpW1j
305;École doctorale Énergie et environnement;E2;5;Biologie, médecine et santé;2018;2017-18;2017;2017;8;5;3;29;17;12;8;3;5;;;;;Kbt8I
309;École doctorale Systèmes;EDSYS;9;Sciences et technologies de l'information et de la communication;2018;2017-18;2017;2017;28;9;19;99;23;76;21;3;18;;;;;8TT4b
327;École doctorale Temps, espaces, sociétés, cultures;TESC;3;Sciences de la terre et de l'univers, espace;2018;2017-18;2017;2017;0;0;0;6;2;4;1;0;1;;;;;IjgiJ
327;École doctorale Temps, espaces, sociétés, cultures;TESC;7;Sciences de la société;2018;2017-18;2017;2017;18;11;7;93;48;45;15;6;9;;;;;IjgiJ
328;École doctorale Arts, lettres, langues, philosophie et communication;ALLPH@;6;Sciences humaines et humanités;2018;2017-18;2017;2017;62;38;24;260;164;96;36;24;12;;;;;xLxMh
352;École doctorale Physique et sciences de la matière;;2;Physique;2018;2017-18;2017;2017;75;22;53;269;80;189;72;26;46;;;;;fb5YC
353;École doctorale Sciences pour l'ingénieur : mécanique, physique, micro et nanoélectronique;;3;Sciences de la terre et de l'univers, espace;2018;2017-18;2017;2017;0;0;0;5;2;3;0;0;0;;;;;vk5Kp
353;École doctorale Sciences pour l'ingénieur : mécanique, physique, micro et nanoélectronique;;5;Biologie, médecine et santé;2018;2017-18;2017;2017;0;0;0;5;2;3;0;0;0;;;;;vk5Kp
355;École doctorale Espaces, cultures, sociétés;;8;Sciences pour l'ingénieur;2018;2017-18;2017;2017;0;0;0;1;1;0;1;1;0;;;;;2kMf5
359;École doctorale Mathématiques, télécommunications, informatique, signal, systèmes, électronique;MATISSE;9;Sciences et technologies de l'information et de la communication;2018;2017-18;2017;2017;0;0;0;0;0;0;42;13;29;;;;;Y0r76
361;École doctorale Sciences et Technologies;ED ST;9;Sciences et technologies de l'information et de la communication;2018;2017-18;2017;2017;29;15;14;123;46;77;28;13;15;;;;;cOUmL
364;École doctorale Sciences fondamentales et appliquées;EDSFA;8;Sciences pour l'ingénieur;2018;2017-18;2017;2017;15;3;12;53;15;38;14;4;10;;;;;E483q
370;École doctorale Lettres, sciences humaines et sociales;LSHS;9;Sciences et technologies de l'information et de la communication;2018;2017-18;2017;2017;1;0;1;4;3;1;3;2;1;;;;;xAXXx
373;École doctorale Santé, information/communications et mathématiques, matière;SICMA;1;Mathématiques et leurs interactions;2018;2017-18;2017;2017;0;0;0;0;0;0;2;0;2;;;;;hTJF5
373;École doctorale Santé, information/communications et mathématiques, matière;SICMA;5;Biologie, médecine et santé;2018;2017-18;2017;2017;0;0;0;0;0;0;9;2;7;;;;;hTJF5
377;École doctorale Environnement et société;;6;Sciences humaines et humanités;2018;2017-18;2017;2017;11;6;5;52;33;19;6;4;2;;;;;ZMG5u
377;École doctorale Environnement et société;;8;Sciences pour l'ingénieur;2018;2017-18;2017;2017;1;1;0;11;3;8;0;0;0;;;;;ZMG5u
377;École doctorale Environnement et société;;10;Sciences agronomiques et écologiques;2018;2017-18;2017;2017;4;2;2;14;8;6;3;2;1;;;;;ZMG5u
391;École doctorale Sciences mécaniques, acoustique et électronique et robotique de Paris;SMAER;8;Sciences pour l'ingénieur;2018;2017-18;2017;2017;71;16;55;214;47;167;64;19;45;;;;;k0eue
400;École doctorale Savoirs scientifiques : épistémologie, histoire des sciences, didactique des disciplines;;3;Sciences de la terre et de l'univers, espace;2018;2017-18;2017;2017;0;0;0;0;0;0;1;0;1;;;;;nRax3
400;École doctorale Savoirs scientifiques : épistémologie, histoire des sciences, didactique des disciplines;;5;Biologie, médecine et santé;2018;2017-18;2017;2017;1;1;0;18;14;4;2;0;2;;;;;nRax3
402;École doctorale Sciences de la vie et de la santé;SVS;5;Biologie, médecine et santé;2018;2017-18;2017;2017;43;30;13;117;77;40;25;14;11;;;;;YKgsU
409;École doctorale Énergie, mécanique, matériaux;EMMA;4;Chimie;2018;2017-18;2017;2017;8;2;6;107;30;77;31;8;23;;;;;KXlbK
414;École doctorale Sciences de la vie et de la santé;;5;Biologie, médecine et santé;2018;2017-18;2017;2017;105;64;41;526;285;241;121;73;48;;;;;YI4xS
434;École doctorale Géographie de Paris - Espaces, sociétés, aménagement;EDGP;6;Sciences humaines et humanités;2018;2017-18;2017;2017;43;31;12;269;166;103;36;22;14;;;;;1FmLX
460;École doctorale Sciences juridiques;SJ;6;Sciences humaines et humanités;2018;2017-18;2017;2017;12;6;6;13;7;6;0;0;0;;;;;ZB5I5
463;École doctorale Sciences du mouvement humain;SMH;6;Sciences humaines et humanités;2018;2017-18;2017;2017;5;2;3;20;11;9;7;2;5;;;;;UbtlY
467;École doctorale Aéronautique, astronautique;AA;1;Mathématiques et leurs interactions;2018;2017-18;2017;2017;5;2;3;19;4;15;2;0;2;;;;;U7l45
467;École doctorale Aéronautique, astronautique;AA;5;Biologie, médecine et santé;2018;2017-18;2017;2017;1;0;1;7;4;3;0;0;0;;;;;U7l45
472;École doctorale de l'EPHE;;7;Sciences de la société;2018;2017-18;2017;2017;4;1;3;30;10;20;3;0;3;;;;;27zK4
473;École doctorale Sciences de l'homme et de la société;SHS;7;Sciences de la société;2018;2017-18;2017;2017;0;0;0;1;0;1;0;0;0;;;;;8qKD9
474;École doctorale Interdisciplinaire européenne frontières du vivant;FDV;1;Mathématiques et leurs interactions;2018;2017-18;2017;2017;2;1;1;6;1;5;1;0;1;;;;;E727j
474;École doctorale Interdisciplinaire européenne frontières du vivant;FDV;5;Biologie, médecine et santé;2018;2017-18;2017;2017;12;5;7;60;30;30;25;9;16;;;;;E727j
480;École doctorale Montaigne-humanités;;2;Physique;2018;2017-18;2017;2017;1;1;0;5;4;1;1;1;0;;;;;f3SeZ
482;École doctorale Sciences de la matière;SDM;4;Chimie;2018;2017-18;2017;2017;54;29;25;208;89;119;54;18;36;;;;;kmeZ4
487;École doctorale Philosophie;PHCR;6;Sciences humaines et humanités;2018;2017-18;2017;2017;22;10;12;149;64;85;22;6;16;;;;;3BRzJ
488;École doctorale Sciences, ingénierie, santé;SIS;1;Mathématiques et leurs interactions;2018;2017-18;2017;2017;6;2;4;13;2;11;0;0;0;;;;;Fy2lK
488;École doctorale Sciences, ingénierie, santé;SIS;3;Sciences de la terre et de l'univers, espace;2018;2017-18;2017;2017;2;2;0;14;5;9;11;3;8;;;;;Fy2lK
489;École doctorale Sciences et ingénierie des systèmes, de l'environnement et des organisations;SISEO;5;Biologie, médecine et santé;2018;2017-18;2017;2017;2;0;2;5;0;5;2;0;2;;;;;6pT77
489;École doctorale Sciences et ingénierie des systèmes, de l'environnement et des organisations;SISEO;10;Sciences agronomiques et écologiques;2018;2017-18;2017;2017;2;1;1;12;5;7;2;0;2;;;;;6pT77
493;École doctorale Erasme;;7;Sciences de la société;2018;2017-18;2017;2017;35;18;17;189;91;98;36;11;25;;;;;FPW4T
497;École doctorale Normande de Biologie Intégrative, Santé, Environnement;Ed NBISE;10;Sciences agronomiques et écologiques;2018;2017-18;2017;2017;6;4;2;24;10;14;14;11;3;;;;;0D9Je
498;École doctorale Sciences pour l'ingénieur, géosciences, architecture;SPIGA;8;Sciences pour l'ingénieur;2018;2017-18;2017;2017;0;0;0;0;0;0;32;8;24;;;;;0vlKH
500;École doctorale Matière, molécules, matériaux en Pays de Loire;3MPL;4;Chimie;2018;2017-18;2017;2017;0;0;0;0;0;0;7;3;4;;;;;822tM
510;École doctorale Ingénierie - Matériaux, mécanique, environnement, énergétique, procédés, production;IMEP2;3;Sciences de la terre et de l'univers, espace;2018;2017-18;2017;2017;0;0;0;1;0;1;1;0;1;;;;;Ce7NF
510;École doctorale Ingénierie - Matériaux, mécanique, environnement, énergétique, procédés, production;IMEP2;4;Chimie;2018;2017-18;2017;2017;0;0;0;31;11;20;21;8;13;;;;;Ce7NF
519;École doctorale Sciences humaines et sociales - Perspectives européennes;SHS-PE;7;Sciences de la société;2018;2017-18;2017;2017;23;13;10;122;70;52;19;8;11;;;;;2f5qs
521;École doctorale Sciences et ingénierie pour l'information, mathématiques;S2I;8;Sciences pour l'ingénieur;2018;2017-18;2017;2017;15;3;12;56;18;38;20;3;17;;;;;V6i83
523;École doctorale Sciences pour l'environnement - Gay Lussac;;4;Chimie;2018;2017-18;2017;2017;23;12;11;66;29;37;30;11;19;;;;;6xD69
524;École doctorale Biologie - santé;;5;Biologie, médecine et santé;2018;2017-18;2017;2017;36;22;14;142;83;59;32;18;14;;;;;S7Kk6
527;École doctorale Cognition, comportement, langage(s);CCL;6;Sciences humaines et humanités;2018;2017-18;2017;2017;22;10;12;83;49;34;15;10;5;;;;;MvpY8
528;École doctorale Ville, transports et territoires;VTT;6;Sciences humaines et humanités;2018;2017-18;2017;2017;29;20;9;148;87;61;29;15;14;;;;;68zCc
531;École doctorale Sciences, ingénierie et environnement;SIE;4;Chimie;2018;2017-18;2017;2017;15;8;7;44;25;19;13;6;7;;;;;b5BYq
532;École doctorale Mathématiques et sciences et technologies de l'information et de la communication;MSTIC;1;Mathématiques et leurs interactions;2018;2017-18;2017;2017;24;3;21;70;14;56;20;6;14;;;;;t43KM
532;École doctorale Mathématiques et sciences et technologies de l'information et de la communication;MSTIC;9;Sciences et technologies de l'information et de la communication;2018;2017-18;2017;2017;37;9;28;136;34;102;41;8;33;;;;;t43KM
536;École doctorale Sciences et agrosciences;;9;Sciences et technologies de l'information et de la communication;2018;2017-18;2017;2017;7;3;4;27;7;20;8;1;7;;;;;pHfqe
537;École doctorale Culture et patrimoine;C&P;7;Sciences de la société;2018;2017-18;2017;2017;3;2;1;18;11;7;7;3;4;;;;;GxI4a
544;École doctorale Inter-Med : Espaces, temps, cultures;INTER-MED;7;Sciences de la société;2018;2017-18;2017;2017;37;14;23;143;60;83;15;2;13;;;;;7VjtD
545;École doctorale Sociétés, politique et santé publique;SP2;6;Sciences humaines et humanités;2018;2017-18;2017;2017;36;17;19;129;71;58;21;15;6;;;;;IAKR4
546;École doctorale Abbé Grégoire;;1;Mathématiques et leurs interactions;2018;2017-18;2017;2017;2;0;2;2;0;2;0;0;0;;;;;ZSn7q
548;École doctorale Mer et Sciences;;2;Physique;2018;2017-18;2017;2017;1;1;0;5;2;3;2;1;1;;;;;QX0fS
548;École doctorale Mer et Sciences;;6;Sciences humaines et humanités;2018;2017-18;2017;2017;3;2;1;4;2;2;0;0;0;;;;;QX0fS
548;École doctorale Mer et Sciences;;9;Sciences et technologies de l'information et de la communication;2018;2017-18;2017;2017;5;2;3;21;10;11;3;0;3;;;;;QX0fS
552;École doctorale Énergie - Matériaux - Sciences de la Terre et de l'Univers;EMTSU;1;Mathématiques et leurs interactions;2018;2017-18;2017;2017;0;0;0;1;0;1;0;0;0;;;;;NTZhw
554;École doctorale Environnements - Santé;E-S;2;Physique;2018;2017-18;2017;2017;0;0;0;3;0;3;0;0;0;;;;;ElyFU
554;École doctorale Environnements - Santé;E-S;5;Biologie, médecine et santé;2018;2017-18;2017;2017;74;41;33;270;157;113;61;38;23;;;;;ElyFU
562;École doctorale Bio Sorbonne Paris Cité;BioSPC;5;Biologie, médecine et santé;2018;2017-18;2017;2017;142;99;43;545;365;180;132;83;49;;;;;4Yju6
564;École doctorale Physique en Ile de France;PIF;2;Physique;2018;2017-18;2017;2017;163;34;129;613;144;469;165;34;131;;;;;39AcN
571;École doctorale Sciences Chimiques : Molécules, Matériaux, Instrumentation et Biosystemes;2MIB;2;Physique;2018;2017-18;2017;2017;1;1;0;7;4;3;0;0;0;;;;;zbi37
573;École doctorale Interfaces : Approches Interdisciplinaires, Fondements, Applications et Innovation;ED INTERFACES;1;Mathématiques et leurs interactions;2018;2017-18;2017;2017;6;1;5;27;2;25;5;1;4;;;;;gG820
573;École doctorale Interfaces : Approches Interdisciplinaires, Fondements, Applications et Innovation;ED INTERFACES;2;Physique;2018;2017-18;2017;2017;24;8;16;96;30;66;25;8;17;;;;;gG820
575;École doctorale Electrical, Optical, Bio : Physics and Engineering;EOBE;2;Physique;2018;2017-18;2017;2017;18;9;9;118;46;72;28;9;19;;;;;dfhyn
575;École doctorale Electrical, Optical, Bio : Physics and Engineering;EOBE;4;Chimie;2018;2017-18;2017;2017;0;0;0;1;0;1;0;0;0;;;;;dfhyn
579;École doctorale Sciences mécaniques et energétiques, matériaux et géosciences;SMEMaG;2;Physique;2018;2017-18;2017;2017;12;0;12;44;8;36;6;2;4;;;;;atMj7
579;École doctorale Sciences mécaniques et energétiques, matériaux et géosciences;SMEMaG;5;Biologie, médecine et santé;2018;2017-18;2017;2017;1;1;0;4;3;1;1;1;0;;;;;atMj7
579;École doctorale Sciences mécaniques et energétiques, matériaux et géosciences;SMEMaG;9;Sciences et technologies de l'information et de la communication;2018;2017-18;2017;2017;1;0;1;2;0;2;1;0;1;;;;;atMj7
582;École doctorale Cancérologie, Biologie, Médecine, Santé;CBMS;2;Physique;2018;2017-18;2017;2017;0;0;0;2;1;1;0;0;0;;;;;75bj4
583;École doctorale Risques et Société;;5;Biologie, médecine et santé;2018;2017-18;2017;2017;0;0;0;2;0;2;0;0;0;;;;;wUBi9
585;École doctorale Sciences, Technologie,  Sante;EDSTS;4;Chimie;2018;2017-18;2017;2017;14;6;8;41;17;24;9;2;7;;;;;NM3Dl
585;École doctorale Sciences, Technologie,  Sante;EDSTS;8;Sciences pour l'ingénieur;2018;2017-18;2017;2017;12;3;9;35;16;19;5;1;4;;;;;NM3Dl
585;École doctorale Sciences, Technologie,  Sante;EDSTS;10;Sciences agronomiques et écologiques;2018;2017-18;2017;2017;9;3;6;25;14;11;12;5;7;;;;;NM3Dl
587;École doctorale Diversites, santé et développement en Amazonie;;4;Chimie;2018;2017-18;2017;2017;0;0;0;2;1;1;0;0;0;;;;;V14tj
587;École doctorale Diversites, santé et développement en Amazonie;;6;Sciences humaines et humanités;2018;2017-18;2017;2017;3;2;1;10;7;3;0;0;0;;;;;V14tj
587;École doctorale Diversites, santé et développement en Amazonie;;7;Sciences de la société;2018;2017-18;2017;2017;3;2;1;10;4;6;1;1;0;;;;;V14tj
587;École doctorale Diversites, santé et développement en Amazonie;;9;Sciences et technologies de l'information et de la communication;2018;2017-18;2017;2017;1;0;1;1;0;1;1;0;1;;;;;V14tj
588;École doctorale Milieu insulaire tropical : dynamiques de développement, sociétés, patrimoine et culture dans l'espace Caraïbes-Amériques;;7;Sciences de la société;2018;2017-18;2017;2017;15;7;8;73;43;30;8;6;2;;;;;4W5IO
589;École doctorale Milieu insulaire tropical à risques : protection, valorisation , santé et développement;;3;Sciences de la terre et de l'univers, espace;2018;2017-18;2017;2017;0;0;0;3;2;1;0;0;0;;;;;2cqi3
594;École doctorale Sociétés, Espaces, Pratiques, Temps;ED SEPT;7;Sciences de la société;2018;2017-18;2017;2017;14;6;8;65;36;29;11;7;4;;;;;N85H3
594;École doctorale Sociétés, Espaces, Pratiques, Temps;ED SEPT;8;Sciences pour l'ingénieur;2018;2017-18;2017;2017;0;0;0;1;0;1;0;0;0;;;;;N85H3
595;École doctorale Arts, Lettres, Langues;ED ALL;6;Sciences humaines et humanités;2018;2017-18;2017;2017;79;47;32;408;263;145;23;20;3;;;;;a8f9b
596;École doctorale Matière, Molécules et Matériaux;ED 3M;5;Biologie, médecine et santé;2018;2017-18;2017;2017;0;0;0;1;1;0;0;0;0;;;;;77947
598;École doctorale Sciences de La Mer et du Littoral;SML;4;Chimie;2018;2017-18;2017;2017;0;0;0;3;0;3;1;0;1;;;;;Smen6
598;École doctorale Sciences de La Mer et du Littoral;SML;6;Sciences humaines et humanités;2018;2017-18;2017;2017;5;3;2;11;8;3;5;3;2;;;;;Smen6
601;École doctorale Mathématiques et Sciences et Technologies de l'information et de la Communication;MathSTIC;8;Sciences pour l'ingénieur;2018;2017-18;2017;2017;8;0;8;29;8;21;3;1;2;;;;;3Ue20
601;École doctorale Mathématiques et Sciences et Technologies de l'information et de la Communication;MathSTIC;9;Sciences et technologies de l'information et de la communication;2018;2017-18;2017;2017;251;60;191;905;201;704;176;42;134;;;;;3Ue20
602;École doctorale Sciences pour l'Ingénieur;SPI;6;Sciences humaines et humanités;2018;2017-18;2017;2017;5;1;4;14;6;8;2;1;1;;;;;8yWbu
605;École doctorale Biologie Santé;ED BS;5;Biologie, médecine et santé;2018;2017-18;2017;2017;138;78;60;527;281;246;95;57;38;;;;;w8CxU
6;École doctorale Droit privé;;7;Sciences de la société;2014;2013-14;2013;2013;60;37;23;317;157;160;23;13;10;;;;;UMnW1
7;École doctorale Georges Vedel - Droit public interne, science administrative et science politique;;7;Sciences de la société;2014;2013-14;2013;2013;37;12;25;165;64;101;14;8;6;;;;;Dw881
8;École doctorale Histoire du droit, philosophie du droit et sociologie du droit;;7;Sciences de la société;2014;2013-14;2013;2013;19;8;11;82;35;47;7;3;4;;;;;pGSed
9;École doctorale Droit international, droit européen, relations internationales et droit comparé;;7;Sciences de la société;2014;2013-14;2013;2013;43;22;21;263;154;109;16;8;8;;;;;v1emR
22;École doctorale Mondes anciens et médiévaux;;6;Sciences humaines et humanités;2014;2013-14;2013;2013;49;24;25;228;131;97;28;17;11;;;;;fqCbl
31;École doctorale Pratiques et théories du sens;;6;Sciences humaines et humanités;2014;2013-14;2013;2013;91;54;37;515;295;220;76;49;27;;;;;1S466
34;École doctorale Matériaux;;1;Mathématiques et leurs interactions;2014;2013-14;2013;2013;7;2;5;10;4;6;12;5;7;;;;;1Iufh
34;École doctorale Matériaux;;8;Sciences pour l'ingénieur;2014;2013-14;2013;2013;28;12;16;179;76;103;11;3;8;;;;;1Iufh
38;École doctorale Langages, espaces, temps, sociétés;;7;Sciences de la société;2014;2013-14;2013;2013;7;4;3;21;13;8;2;1;1;;;;;pGgDX
62;École doctorale Sciences de la vie et de la santé;;5;Biologie, médecine et santé;2014;2013-14;2013;2013;175;114;61;613;351;262;183;94;89;;;;;vZzE7
65;École doctorale Sciences de la Vie, Santé, Agronomie, Environnement;;5;Biologie, médecine et santé;2014;2013-14;2013;2013;51;33;18;138;94;44;33;15;18;;;;;MAOG4
70;École doctorale Sciences pour l'ingénieur;EDSPI;9;Sciences et technologies de l'information et de la communication;2014;2013-14;2013;2013;32;8;24;169;34;135;29;4;25;;;;;G413P
72;École doctorale Sciences pour l'ingénieur;SPI;1;Mathématiques et leurs interactions;2014;2013-14;2013;2013;22;5;17;67;18;49;17;7;10;;;;;47QPx
72;École doctorale Sciences pour l'ingénieur;SPI;8;Sciences pour l'ingénieur;2014;2013-14;2013;2013;80;17;63;334;83;251;95;26;69;;;;;47QPx
73;École doctorale Sciences économiques, sociales, de l'aménagement et du management;SESAM;7;Sciences de la société;2014;2013-14;2013;2013;68;30;38;248;118;130;38;25;13;;;;;IQ0Hk
85;École doctorale Sciences de la vie et de la santé;SVS;5;Biologie, médecine et santé;2014;2013-14;2013;2013;52;31;21;156;89;67;30;14;16;;;;;YdiMF
86;École doctorale Sociétés, humanités, arts, lettres;LSHS;7;Sciences de la société;2014;2013-14;2013;2013;5;5;0;41;26;15;5;3;2;;;;;O8E6y
104;École doctorale Sciences de la matière, du rayonnement et de l'environnement;SMRE;2;Physique;2014;2013-14;2013;2013;27;9;18;54;18;36;22;6;16;;;;;Q5iFz
104;École doctorale Sciences de la matière, du rayonnement et de l'environnement;SMRE;9;Sciences et technologies de l'information et de la communication;2014;2013-14;2013;2013;1;0;1;1;0;1;0;0;0;;;;;Q5iFz
105;École doctorale Terre, univers, environnement;;3;Sciences de la terre et de l'univers, espace;2014;2013-14;2013;2013;53;22;31;204;83;121;51;19;32;;;;;lcWAf
112;École doctorale Archéologie;;6;Sciences humaines et humanités;2014;2013-14;2013;2013;26;11;15;333;203;130;25;11;14;;;;;EvU7R
119;École doctorale Science politique;;7;Sciences de la société;2014;2013-14;2013;2013;21;10;11;113;58;55;20;11;9;;;;;eyibb
124;École doctorale Histoire de l'art et archéologie;;6;Sciences humaines et humanités;2014;2013-14;2013;2013;46;25;21;252;167;85;26;18;8;;;;;MBN4L
127;École doctorale Astronomie et astrophysique d'Ile de France;A&A;3;Sciences de la terre et de l'univers, espace;2014;2013-14;2013;2013;49;20;29;158;57;101;49;19;30;;;;;cPXrq
130;École doctorale Informatique, télécommunications et électronique de Paris;EDITE;9;Sciences et technologies de l'information et de la communication;2014;2013-14;2013;2013;197;52;145;841;249;592;212;54;158;;;;;O5ysj
146;École doctorale Galilée;GALILEE;1;Mathématiques et leurs interactions;2014;2013-14;2013;2013;19;2;17;36;8;28;14;3;11;;;;;71hqm
146;École doctorale Galilée;GALILEE;5;Biologie, médecine et santé;2014;2013-14;2013;2013;21;14;7;55;36;19;14;9;5;;;;;71hqm
151;École doctorale Biologie, santé, biotechnologies;;5;Biologie, médecine et santé;2014;2013-14;2013;2013;87;56;31;358;213;145;83;48;35;;;;;yP8w4
156;École doctorale Sciences de la mer;;3;Sciences de la terre et de l'univers, espace;2014;2013-14;2013;2013;17;10;7;69;28;41;12;7;5;;;;;EGY9P
162;École doctorale Mécanique, énergétique, génie civil, acoustique;MEGA;9;Sciences et technologies de l'information et de la communication;2014;2013-14;2013;2013;3;1;2;4;1;3;1;0;1;;;;;7wCke
166;École doctorale Information, structures et systèmes;I2S;2;Physique;2014;2013-14;2013;2013;16;9;7;73;22;51;21;6;15;;;;;2uO68
166;École doctorale Information, structures et systèmes;I2S;5;Biologie, médecine et santé;2014;2013-14;2013;2013;6;2;4;17;7;10;0;0;0;;;;;2uO68
168;École doctorale Sciences chimiques et biologiques pour la santé;SCBS;5;Biologie, médecine et santé;2014;2013-14;2013;2013;104;61;43;331;202;129;99;55;44;;;;;8cEME
178;École doctorale Sciences fondamentales;;2;Physique;2014;2013-14;2013;2013;11;3;8;33;5;28;13;5;8;;;;;1AiR7
178;École doctorale Sciences fondamentales;;3;Sciences de la terre et de l'univers, espace;2014;2013-14;2013;2013;9;3;6;38;15;23;10;5;5;;;;;1AiR7
181;École doctorale Structure, informations, matière et matériaux;Simem;8;Sciences pour l'ingénieur;2014;2013-14;2013;2013;11;4;7;24;6;18;8;2;6;;;;;c1D6f
181;École doctorale Structure, informations, matière et matériaux;Simem;9;Sciences et technologies de l'information et de la communication;2014;2013-14;2013;2013;20;3;17;59;11;48;17;4;13;;;;;c1D6f
184;École doctorale Mathématiques et informatique de Marseille;;9;Sciences et technologies de l'information et de la communication;2014;2013-14;2013;2013;22;5;17;74;20;54;18;4;14;;;;;DDObG
205;École doctorale Interdisciplinaire Sciences-Santé;EDISS;4;Chimie;2014;2013-14;2013;2013;4;2;2;27;11;16;5;3;2;;;;;69W38
211;École doctorale Sciences exactes et leurs applications;ED SEA;2;Physique;2014;2013-14;2013;2013;3;0;3;12;2;10;2;0;2;;;;;1G1iC
211;École doctorale Sciences exactes et leurs applications;ED SEA;3;Sciences de la terre et de l'univers, espace;2014;2013-14;2013;2013;3;0;3;10;4;6;1;0;1;;;;;1G1iC
216;École doctorale Ingénierie pour la santé, la cognition, l'environnement;EDISCE;7;Sciences de la société;2014;2013-14;2013;2013;1;1;0;3;1;2;0;0;0;;;;;fPs1t
216;École doctorale Ingénierie pour la santé, la cognition, l'environnement;EDISCE;9;Sciences et technologies de l'information et de la communication;2014;2013-14;2013;2013;3;2;1;23;8;15;10;6;4;;;;;fPs1t
220;École doctorale Électronique, électrotechnique, automatique, traitement du signal;EEATS;9;Sciences et technologies de l'information et de la communication;2014;2013-14;2013;2013;90;26;64;396;101;295;100;22;78;;;;;IxEaw
222;École doctorale Sciences chimiques;EDSC;4;Chimie;2014;2013-14;2013;2013;62;21;41;277;116;161;72;29;43;;;;;AdU8Q
224;École doctorale Cognition, langage, interaction;;8;Sciences pour l'ingénieur;2014;2013-14;2013;2013;1;1;0;7;4;3;1;1;0;;;;;7v43e
227;École doctorale Sciences de la nature et de l'homme;;6;Sciences humaines et humanités;2014;2013-14;2013;2013;9;5;4;32;21;11;12;7;5;;;;;xiDA5
234;École doctorale de Sciences Po;;7;Sciences de la société;2014;2013-14;2013;2013;63;29;34;374;195;179;69;38;31;;;;;ux756
249;École doctorale Droit comparé;;7;Sciences de la société;2014;2013-14;2013;2013;27;16;11;149;87;62;16;9;7;;;;;yu36C
250;École doctorale Sciences chimiques;;4;Chimie;2014;2013-14;2013;2013;31;16;15;100;42;58;21;10;11;;;;;O0Fav
251;École doctorale Sciences de l'environnement;;3;Sciences de la terre et de l'univers, espace;2014;2013-14;2013;2013;35;13;22;108;54;54;32;17;15;;;;;VR28y
251;École doctorale Sciences de l'environnement;;5;Biologie, médecine et santé;2014;2013-14;2013;2013;1;0;1;11;4;7;6;3;3;;;;;VR28y
254;École doctorale Sciences de la matière;;4;Chimie;2014;2013-14;2013;2013;51;26;25;165;81;84;49;20;29;;;;;365F2
260;École doctorale pluridisciplinaire;;5;Biologie, médecine et santé;2014;2013-14;2013;2013;17;10;7;83;52;31;8;5;3;;;;;sCk1f
260;École doctorale pluridisciplinaire;;10;Sciences agronomiques et écologiques;2014;2013-14;2013;2013;1;1;0;14;11;3;1;1;0;;;;;sCk1f
266;École doctorale Biologie, santé, environnement;BIOSE;5;Biologie, médecine et santé;2014;2013-14;2013;2013;46;26;20;165;87;78;43;26;17;;;;;386V9
269;École doctorale Mathématiques, sciences de l'information et de l'ingénieur;MSII;9;Sciences et technologies de l'information et de la communication;2014;2013-14;2013;2013;4;1;3;41;9;32;4;0;4;;;;;5E625
279;École doctorale Arts plastiques, esthétique et sciences de l'art;APESA;6;Sciences humaines et humanités;2014;2013-14;2013;2013;47;32;15;277;191;86;43;30;13;;;;;BpW1j
282;École doctorale Droit privé;;7;Sciences de la société;2014;2013-14;2013;2013;55;24;31;310;157;153;29;14;15;;;;;Gz5rp
285;École doctorale Sciences pratiques;;5;Biologie, médecine et santé;2014;2013-14;2013;2013;3;1;2;10;6;4;2;2;0;;;;;Jd3t2
304;École doctorale Sciences et environnements;;5;Biologie, médecine et santé;2014;2013-14;2013;2013;9;6;3;24;10;14;5;4;1;;;;;2ywZn
304;École doctorale Sciences et environnements;;7;Sciences de la société;2014;2013-14;2013;2013;3;2;1;14;11;3;2;2;0;;;;;2ywZn
305;École doctorale Énergie et environnement;E2;1;Mathématiques et leurs interactions;2014;2013-14;2013;2013;1;0;1;5;1;4;1;1;0;;;;;Kbt8I
305;École doctorale Énergie et environnement;E2;2;Physique;2014;2013-14;2013;2013;2;1;1;8;1;7;1;0;1;;;;;Kbt8I
327;École doctorale Temps, espaces, sociétés, cultures;TESC;7;Sciences de la société;2014;2013-14;2013;2013;23;13;10;140;76;64;26;16;10;;;;;IjgiJ
328;École doctorale Arts, lettres, langues, philosophie et communication;ALLPH@;6;Sciences humaines et humanités;2014;2013-14;2013;2013;71;43;28;297;167;130;44;26;18;;;;;xLxMh
351;École doctorale Sciences physiques, mathématiques et de l'information pour l'ingénieur;SPMII;3;Sciences de la terre et de l'univers, espace;2014;2013-14;2013;2013;1;1;0;2;1;1;1;0;1;;;;;rY4EP
351;École doctorale Sciences physiques, mathématiques et de l'information pour l'ingénieur;SPMII;8;Sciences pour l'ingénieur;2014;2013-14;2013;2013;37;8;29;142;37;105;41;9;32;;;;;rY4EP
359;École doctorale Mathématiques, télécommunications, informatique, signal, systèmes, électronique;MATISSE;9;Sciences et technologies de l'information et de la communication;2014;2013-14;2013;2013;107;25;82;419;103;316;130;27;103;;;;;Y0r76
361;École doctorale Sciences et Technologies;ED ST;7;Sciences de la société;2014;2013-14;2013;2013;1;0;1;4;0;4;0;0;0;;;;;cOUmL
373;École doctorale Santé, information/communications et mathématiques, matière;SICMA;1;Mathématiques et leurs interactions;2014;2013-14;2013;2013;5;4;1;15;8;7;5;1;4;;;;;hTJF5
373;École doctorale Santé, information/communications et mathématiques, matière;SICMA;10;Sciences agronomiques et écologiques;2014;2013-14;2013;2013;4;2;2;13;7;6;5;3;2;;;;;hTJF5
388;École doctorale Chimie physique et chimie analytique de Paris centre;CPCA;4;Chimie;2014;2013-14;2013;2013;73;37;36;237;109;128;66;32;34;;;;;M0Hnd
390;École doctorale Génie des procédés et technologies avancées;;8;Sciences pour l'ingénieur;2014;2013-14;2013;2013;0;0;0;0;0;0;19;8;11;;;;;sK3wm
393;École doctorale Pierre Louis de Santé Publique : Épidémiologie et Sciences de l'information biomédicale;PLSP;5;Biologie, médecine et santé;2014;2013-14;2013;2013;43;28;15;83;50;33;40;22;18;;;;;69445
400;École doctorale Savoirs scientifiques : épistémologie, histoire des sciences, didactique des disciplines;;2;Physique;2014;2013-14;2013;2013;2;1;1;15;2;13;0;0;0;;;;;nRax3
402;École doctorale Sciences de la vie et de la santé;SVS;5;Biologie, médecine et santé;2014;2013-14;2013;2013;28;14;14;94;51;43;28;16;12;;;;;YKgsU
405;École doctorale Économie, management,mathématiques et physique de Cergy;EM2C;1;Mathématiques et leurs interactions;2014;2013-14;2013;2013;5;0;5;24;8;16;3;2;1;;;;;QbwSB
412;École doctorale Lorraine de chimie et physique moléculaires : synthèses, expériences, simulations, applications : de la molécule aux édifices supramoléculaires;SESAMES;4;Chimie;2014;2013-14;2013;2013;15;8;7;77;35;42;17;7;10;;;;;mvHX2
417;École doctorale Sciences et Ingénierie;S&I;2;Physique;2014;2013-14;2013;2013;5;0;5;8;0;8;2;0;2;;;;;SSBvE
417;École doctorale Sciences et Ingénierie;S&I;4;Chimie;2014;2013-14;2013;2013;4;3;1;25;13;12;6;4;2;;;;;SSBvE
417;École doctorale Sciences et Ingénierie;S&I;5;Biologie, médecine et santé;2014;2013-14;2013;2013;2;2;0;9;8;1;1;0;1;;;;;SSBvE
426;École doctorale Gènes, génomes, cellules;;5;Biologie, médecine et santé;2014;2013-14;2013;2013;43;22;21;129;72;57;30;14;16;;;;;XPaY8
436;École doctorale Médicament, toxicologie, chimie, environnement;MTCE;4;Chimie;2014;2013-14;2013;2013;16;8;8;41;19;22;15;7;8;;;;;dPsg3
446;École doctorale Biologie - Santé;EDBSL;4;Chimie;2014;2013-14;2013;2013;0;0;0;0;0;0;1;0;1;;;;;4iEUF
447;École doctorale de l'école polytechnique;;5;Biologie, médecine et santé;2014;2013-14;2013;2013;7;5;2;11;5;6;1;1;0;;;;;zgCCh
454;École doctorale Sciences de l'homme, du politique et du territoire;SHPT;6;Sciences humaines et humanités;2014;2013-14;2013;2013;34;15;19;220;112;108;28;13;15;;;;;Opv31
456;École doctorale Sciences du sport, de la motricité et du mouvement humain;;6;Sciences humaines et humanités;2014;2013-14;2013;2013;20;13;7;47;25;22;11;6;5;;;;;GqvEI
458;École doctorale Sciences écologiques, vétérinaires, agronomiques et bioingénieries;SEVAB;10;Sciences agronomiques et écologiques;2014;2013-14;2013;2013;63;30;33;247;131;116;54;27;27;;;;;Yf3TI
460;École doctorale Sciences juridiques;SJ;7;Sciences de la société;2014;2013-14;2013;2013;24;15;9;125;58;67;15;8;7;;;;;ZB5I5
463;École doctorale Sciences du mouvement humain;SMH;8;Sciences pour l'ingénieur;2014;2013-14;2013;2013;3;2;1;18;4;14;7;1;6;;;;;UbtlY
468;École doctorale Mécanique, énergétique, génie civil, procédés;MEGEP;8;Sciences pour l'ingénieur;2014;2013-14;2013;2013;136;46;90;455;142;313;103;27;76;;;;;4XUTB
472;École doctorale de l'EPHE;;3;Sciences de la terre et de l'univers, espace;2014;2013-14;2013;2013;1;0;1;9;5;4;4;0;4;;;;;27zK4
472;École doctorale de l'EPHE;;5;Biologie, médecine et santé;2014;2013-14;2013;2013;13;8;5;42;26;16;12;8;4;;;;;27zK4
472;École doctorale de l'EPHE;;10;Sciences agronomiques et écologiques;2014;2013-14;2013;2013;10;7;3;27;17;10;9;2;7;;;;;27zK4
474;École doctorale Interdisciplinaire européenne frontières du vivant;FDV;8;Sciences pour l'ingénieur;2014;2013-14;2013;2013;0;0;0;1;1;0;0;0;0;;;;;E727j
475;École doctorale Mathématiques, informatique, télécommunications de Toulouse;MITT;1;Mathématiques et leurs interactions;2014;2013-14;2013;2013;40;10;30;166;54;112;41;11;30;;;;;xcp2r
475;École doctorale Mathématiques, informatique, télécommunications de Toulouse;MITT;9;Sciences et technologies de l'information et de la communication;2014;2013-14;2013;2013;74;24;50;314;86;228;72;14;58;;;;;xcp2r
476;École doctorale Neurosciences et cognition;NSCO;5;Biologie, médecine et santé;2014;2013-14;2013;2013;28;17;11;114;66;48;28;14;14;;;;;B1H0x
481;École doctorale Sciences sociales et humanités;SSH;6;Sciences humaines et humanités;2014;2013-14;2013;2013;36;20;16;146;93;53;11;5;6;;;;;E3z5j
481;École doctorale Sciences sociales et humanités;SSH;7;Sciences de la société;2014;2013-14;2013;2013;45;23;22;170;80;90;15;7;8;;;;;E3z5j
484;École doctorale Lettres, langues, linguistique, arts;3LA;6;Sciences humaines et humanités;2014;2013-14;2013;2013;106;65;41;556;338;218;68;43;25;;;;;BlCQD
486;École doctorale Sciences économiques et de gestion;SEG;7;Sciences de la société;2014;2013-14;2013;2013;41;21;20;158;73;85;39;19;20;;;;;h1GZ3
488;École doctorale Sciences, ingénierie, santé;SIS;3;Sciences de la terre et de l'univers, espace;2014;2013-14;2013;2013;10;4;6;31;12;19;7;2;5;;;;;Fy2lK
488;École doctorale Sciences, ingénierie, santé;SIS;4;Chimie;2014;2013-14;2013;2013;4;2;2;17;7;10;3;0;3;;;;;Fy2lK
488;École doctorale Sciences, ingénierie, santé;SIS;10;Sciences agronomiques et écologiques;2014;2013-14;2013;2013;2;2;0;8;7;1;2;1;1;;;;;Fy2lK
489;École doctorale Sciences et ingénierie des systèmes, de l'environnement et des organisations;SISEO;8;Sciences pour l'ingénieur;2014;2013-14;2013;2013;16;5;11;48;12;36;14;4;10;;;;;6pT77
489;École doctorale Sciences et ingénierie des systèmes, de l'environnement et des organisations;SISEO;10;Sciences agronomiques et écologiques;2014;2013-14;2013;2013;3;1;2;10;3;7;2;1;1;;;;;6pT77
495;École doctorale Végétal, environnement, nutrition, agroalimentaire, mer;VENAM;3;Sciences de la terre et de l'univers, espace;2014;2013-14;2013;2013;0;0;0;6;4;2;2;2;0;;;;;HL495
496;École doctorale Sociétés, cultures, échanges;SCE;7;Sciences de la société;2014;2013-14;2013;2013;2;1;1;3;2;1;0;0;0;;;;;633tC
497;École doctorale Normande de Biologie Intégrative, Santé, Environnement;Ed NBISE;5;Biologie, médecine et santé;2014;2013-14;2013;2013;67;33;34;246;129;117;54;33;21;;;;;0D9Je
497;École doctorale Normande de Biologie Intégrative, Santé, Environnement;Ed NBISE;10;Sciences agronomiques et écologiques;2014;2013-14;2013;2013;8;7;1;26;15;11;7;5;2;;;;;0D9Je
498;École doctorale Sciences pour l'ingénieur, géosciences, architecture;SPIGA;8;Sciences pour l'ingénieur;2014;2013-14;2013;2013;95;20;75;358;88;270;72;18;54;;;;;0vlKH
502;École doctorale Biologie - Santé;;4;Chimie;2014;2013-14;2013;2013;1;1;0;2;1;1;0;0;0;;;;;JCFV7
504;École doctorale Cognition, éducation, interactions;CEI;6;Sciences humaines et humanités;2014;2013-14;2013;2013;44;27;17;203;118;85;23;14;9;;;;;39naT
504;École doctorale Cognition, éducation, interactions;CEI;9;Sciences et technologies de l'information et de la communication;2014;2013-14;2013;2013;1;0;1;2;1;1;0;0;0;;;;;39naT
515;École doctorale Complexité du vivant;CdV;5;Biologie, médecine et santé;2014;2013-14;2013;2013;85;47;38;306;176;130;67;43;24;;;;;CbV9s
521;École doctorale Sciences et ingénierie pour l'information, mathématiques;S2I;1;Mathématiques et leurs interactions;2014;2013-14;2013;2013;7;3;4;38;17;21;14;5;9;;;;;V6i83
523;École doctorale Sciences pour l'environnement - Gay Lussac;;3;Sciences de la terre et de l'univers, espace;2014;2013-14;2013;2013;8;2;6;37;15;22;9;3;6;;;;;6xD69
523;École doctorale Sciences pour l'environnement - Gay Lussac;;8;Sciences pour l'ingénieur;2014;2013-14;2013;2013;0;0;0;3;2;1;0;0;0;;;;;6xD69
526;École doctorale Sociétés et organisations;SORG;7;Sciences de la société;2014;2013-14;2013;2013;33;15;18;108;51;57;16;4;12;;;;;5F3Fd
528;École doctorale Ville, transports et territoires;VTT;3;Sciences de la terre et de l'univers, espace;2014;2013-14;2013;2013;2;1;1;3;2;1;0;0;0;;;;;68zCc
528;École doctorale Ville, transports et territoires;VTT;6;Sciences humaines et humanités;2014;2013-14;2013;2013;22;12;10;153;79;74;39;24;15;;;;;68zCc
530;École doctorale Organisations, marchés, institutions;OMI;6;Sciences humaines et humanités;2014;2013-14;2013;2013;39;17;22;104;52;52;12;4;8;;;;;4htv7
531;École doctorale Sciences, ingénierie et environnement;SIE;1;Mathématiques et leurs interactions;2014;2013-14;2013;2013;0;0;0;1;0;1;0;0;0;;;;;b5BYq
532;École doctorale Mathématiques et sciences et technologies de l'information et de la communication;MSTIC;1;Mathématiques et leurs interactions;2014;2013-14;2013;2013;24;8;16;75;22;53;17;4;13;;;;;t43KM
532;École doctorale Mathématiques et sciences et technologies de l'information et de la communication;MSTIC;3;Sciences de la terre et de l'univers, espace;2014;2013-14;2013;2013;1;1;0;14;5;9;3;0;3;;;;;t43KM
533;École doctorale Sciences du management : Gestion, organisation, décision, information;GODI;7;Sciences de la société;2014;2013-14;2013;2013;29;14;15;140;66;74;27;11;16;;;;;ld7FG
534;École doctorale Modélisation et instrumentation en physique, énergie, géosciences et environnement;MIPEGE;1;Mathématiques et leurs interactions;2014;2013-14;2013;2013;0;0;0;1;0;1;0;0;0;;;;;K93eR
534;École doctorale Modélisation et instrumentation en physique, énergie, géosciences et environnement;MIPEGE;2;Physique;2014;2013-14;2013;2013;23;13;10;81;28;53;23;8;15;;;;;K93eR
534;École doctorale Modélisation et instrumentation en physique, énergie, géosciences et environnement;MIPEGE;8;Sciences pour l'ingénieur;2014;2013-14;2013;2013;0;0;0;1;0;1;1;0;1;;;;;K93eR
535;École doctorale Sciences de la société;SDS;7;Sciences de la société;2014;2013-14;2013;2013;30;12;18;106;63;43;11;4;7;;;;;iEUOV
538;École doctorale Culture, régulation, institutions et territoire;CRIT;6;Sciences humaines et humanités;2014;2013-14;2013;2013;16;12;4;135;78;57;8;7;1;;;;;8T505
539;École doctorale Sciences et technologies de Versailles;;2;Physique;2014;2013-14;2013;2013;7;2;5;23;6;17;2;0;2;;;;;nv3h8
539;École doctorale Sciences et technologies de Versailles;;9;Sciences et technologies de l'information et de la communication;2014;2013-14;2013;2013;13;6;7;61;22;39;15;3;12;;;;;nv3h8
540;"École doctorale École transdisciplinaire ""lettres/sciences""";;6;Sciences humaines et humanités;2014;2013-14;2013;2013;31;21;10;65;37;28;0;0;0;;;;;tWWw7
541;École doctorale de sciences humaines et sociales de La Réunion;SHS;6;Sciences humaines et humanités;2014;2013-14;2013;2013;23;12;11;98;64;34;17;8;9;;;;;21SpE
542;École doctorale de sciences de La Réunion;STS;6;Sciences humaines et humanités;2014;2013-14;2013;2013;;;;;;;3;1;2;;;;;2pAql
543;École doctorale de Dauphine;;1;Mathématiques et leurs interactions;2014;2013-14;2013;2013;12;5;7;41;12;29;12;1;11;;;;;u8w6A
543;École doctorale de Dauphine;;7;Sciences de la société;2014;2013-14;2013;2013;78;42;36;363;183;180;55;23;32;;;;;u8w6A
545;École doctorale Sociétés, politique et santé publique;SP2;5;Biologie, médecine et santé;2014;2013-14;2013;2013;19;10;9;47;27;20;11;8;3;;;;;IAKR4
545;École doctorale Sociétés, politique et santé publique;SP2;6;Sciences humaines et humanités;2014;2013-14;2013;2013;19;12;7;83;48;35;20;11;9;;;;;IAKR4
545;École doctorale Sociétés, politique et santé publique;SP2;7;Sciences de la société;2014;2013-14;2013;2013;23;17;6;114;65;49;26;14;12;;;;;IAKR4
546;École doctorale Abbé Grégoire;;5;Biologie, médecine et santé;2014;2013-14;2013;2013;2;1;1;9;4;5;3;2;1;;;;;ZSn7q
546;École doctorale Abbé Grégoire;;8;Sciences pour l'ingénieur;2014;2013-14;2013;2013;7;1;6;11;3;8;6;1;5;;;;;ZSn7q
547;École doctorale Sciences, Technologie, Santé;EDSTS;9;Sciences et technologies de l'information et de la communication;2014;2013-14;2013;2013;9;3;6;57;16;41;12;4;8;;;;;wEdn2
548;École doctorale Mer et Sciences;;2;Physique;2014;2013-14;2013;2013;2;1;1;11;4;7;2;1;1;;;;;QX0fS
548;École doctorale Mer et Sciences;;5;Biologie, médecine et santé;2014;2013-14;2013;2013;2;1;1;10;7;3;2;1;1;;;;;QX0fS
549;École doctorale Santé, Sciences Biologiques et Chimie du Vivant;SSBCV;4;Chimie;2014;2013-14;2013;2013;14;8;6;38;23;15;9;4;5;;;;;B9ggO
549;École doctorale Santé, Sciences Biologiques et Chimie du Vivant;SSBCV;5;Biologie, médecine et santé;2014;2013-14;2013;2013;43;23;20;173;100;73;66;40;26;;;;;B9ggO
549;École doctorale Santé, Sciences Biologiques et Chimie du Vivant;SSBCV;9;Sciences et technologies de l'information et de la communication;2014;2013-14;2013;2013;1;0;1;3;0;3;0;0;0;;;;;B9ggO
552;École doctorale Énergie - Matériaux - Sciences de la Terre et de l'Univers;EMTSU;8;Sciences pour l'ingénieur;2014;2013-14;2013;2013;25;4;21;79;19;60;21;4;17;;;;;NTZhw
554;École doctorale Environnements - Santé;E-S;4;Chimie;2014;2013-14;2013;2013;1;0;1;2;0;2;1;0;1;;;;;ElyFU
554;École doctorale Environnements - Santé;E-S;6;Sciences humaines et humanités;2014;2013-14;2013;2013;2;1;1;12;6;6;5;1;4;;;;;ElyFU
555;École doctorale Sciences de l'Homme et de la Société;SHS;6;Sciences humaines et humanités;2014;2013-14;2013;2013;64;35;29;312;155;157;30;14;16;;;;;44G6m
555;École doctorale Sciences de l'Homme et de la Société;SHS;7;Sciences de la société;2014;2013-14;2013;2013;51;18;33;224;100;124;17;8;9;;;;;44G6m
556;École doctorale Homme, Sociétés, Risques, Territoire;HSRT;7;Sciences de la société;2014;2013-14;2013;2013;15;5;10;75;30;45;6;4;2;;;;;5QEaX
7;École doctorale Georges Vedel - Droit public interne, science administrative et science politique;;7;Sciences de la société;2015;2014-15;2014;2014;42;15;27;168;64;104;19;9;10;;;;;Dw881
8;École doctorale Histoire du droit, philosophie du droit et sociologie du droit;;7;Sciences de la société;2015;2014-15;2014;2014;19;8;11;85;35;50;9;2;7;;;;;pGSed
22;École doctorale Mondes anciens et médiévaux;;6;Sciences humaines et humanités;2015;2014-15;2014;2014;35;20;15;184;105;79;37;19;18;;;;;fqCbl
31;École doctorale Pratiques et théories du sens;;7;Sciences de la société;2015;2014-15;2014;2014;4;4;0;26;17;9;1;1;0;;;;;1S466
47;École doctorale Physique;;9;Sciences et technologies de l'information et de la communication;2015;2014-15;2014;2014;0;0;0;1;1;0;0;0;0;;;;;8kNpd
50;École doctorale Langues, littératures et sciences humaines;LLSH;7;Sciences de la société;2015;2014-15;2014;2014;0;0;0;2;2;0;1;1;0;;;;;8THzQ
65;École doctorale Sciences de la Vie, Santé, Agronomie, Environnement;;10;Sciences agronomiques et écologiques;2015;2014-15;2014;2014;14;8;6;64;34;30;22;16;6;;;;;MAOG4
67;École doctorale Sciences juridiques et politiques;;7;Sciences de la société;2015;2014-15;2014;2014;121;54;67;656;336;320;88;45;43;;;;;qrOj1
71;École doctorale Sciences pour l'ingénieur;;1;Mathématiques et leurs interactions;2015;2014-15;2014;2014;1;1;0;8;6;2;1;1;0;;;;;H6UYp
71;École doctorale Sciences pour l'ingénieur;;7;Sciences de la société;2015;2014-15;2014;2014;5;3;2;29;15;14;3;1;2;;;;;H6UYp
73;École doctorale Sciences économiques, sociales, de l'aménagement et du management;SESAM;1;Mathématiques et leurs interactions;2015;2014-15;2014;2014;3;1;2;9;1;8;2;2;0;;;;;IQ0Hk
85;École doctorale Sciences de la vie et de la santé;SVS;5;Biologie, médecine et santé;2015;2014-15;2014;2014;55;33;22;168;98;70;39;19;20;;;;;YdiMF
92;École doctorale Vie -  Agro - Santé;;2;Physique;2015;2014-15;2014;2014;0;0;0;1;1;0;0;0;0;;;;;RjvXY
92;École doctorale Vie -  Agro - Santé;;3;Sciences de la terre et de l'univers, espace;2015;2014-15;2014;2014;0;0;0;1;1;0;1;0;1;;;;;RjvXY
104;École doctorale Sciences de la matière, du rayonnement et de l'environnement;SMRE;3;Sciences de la terre et de l'univers, espace;2015;2014-15;2014;2014;9;4;5;28;10;18;11;1;10;;;;;Q5iFz
104;École doctorale Sciences de la matière, du rayonnement et de l'environnement;SMRE;10;Sciences agronomiques et écologiques;2015;2014-15;2014;2014;25;17;8;87;48;39;18;5;13;;;;;Q5iFz
112;École doctorale Archéologie;;6;Sciences humaines et humanités;2015;2014-15;2014;2014;40;23;17;309;189;120;32;21;11;;;;;EvU7R
113;École doctorale Histoire;;6;Sciences humaines et humanités;2015;2014-15;2014;2014;65;29;36;333;150;183;50;25;25;;;;;G5wHs
119;École doctorale Science politique;;7;Sciences de la société;2015;2014-15;2014;2014;16;6;10;102;50;52;16;8;8;;;;;eyibb
120;École doctorale Littérature française et comparée;;6;Sciences humaines et humanités;2015;2014-15;2014;2014;52;33;19;266;190;76;36;26;10;;;;;3ULpe
122;École doctorale Europe latine - Amérique latine;;7;Sciences de la société;2015;2014-15;2014;2014;12;8;4;105;59;46;11;7;4;;;;;z9lZY
129;École doctorale Sciences de l'environnement d'Ile de France;SEIF;3;Sciences de la terre et de l'univers, espace;2015;2014-15;2014;2014;45;22;23;194;95;99;40;24;16;;;;;TnAPh
139;École doctorale Connaissance, langage, modélisation;CLM;6;Sciences humaines et humanités;2015;2014-15;2014;2014;57;29;28;320;212;108;35;16;19;;;;;1lxGH
141;École doctorale Droit et science politique;DSP;7;Sciences de la société;2015;2014-15;2014;2014;69;34;35;203;118;85;28;16;12;;;;;CyNBf
156;École doctorale Sciences de la mer;;5;Biologie, médecine et santé;2015;2014-15;2014;2014;17;11;6;70;44;26;18;10;8;;;;;EGY9P
166;École doctorale Information, structures et systèmes;I2S;1;Mathématiques et leurs interactions;2015;2014-15;2014;2014;18;6;12;63;19;44;17;5;12;;;;;2uO68
166;École doctorale Information, structures et systèmes;I2S;2;Physique;2015;2014-15;2014;2014;18;5;13;80;26;54;22;3;19;;;;;2uO68
168;École doctorale Sciences chimiques et biologiques pour la santé;SCBS;4;Chimie;2015;2014-15;2014;2014;2;2;0;4;3;1;1;1;0;;;;;8cEME
173;École doctorale Sciences de l'univers, de l'environnement et de l'espace;SDU2E;10;Sciences agronomiques et écologiques;2015;2014-15;2014;2014;11;6;5;38;20;18;11;6;5;;;;;R0Z9c
178;École doctorale Sciences fondamentales;;4;Chimie;2015;2014-15;2014;2014;16;9;7;61;29;32;12;6;6;;;;;1AiR7
180;École doctorale Sciences humaines et sociales : cultures, individus, sociétés;SHS;6;Sciences humaines et humanités;2015;2014-15;2014;2014;36;21;15;126;87;39;19;15;4;;;;;D2BT3
182;École doctorale Physique et chimie-physique;;5;Biologie, médecine et santé;2015;2014-15;2014;2014;0;0;0;2;1;1;4;2;2;;;;;3My6I
184;École doctorale Mathématiques et informatique de Marseille;;9;Sciences et technologies de l'information et de la communication;2015;2014-15;2014;2014;6;4;2;38;15;23;2;1;1;;;;;DDObG
205;École doctorale Interdisciplinaire Sciences-Santé;EDISS;9;Sciences et technologies de l'information et de la communication;2015;2014-15;2014;2014;1;0;1;4;0;4;1;0;1;;;;;69W38
209;École doctorale Sciences physiques et de L'ingénieur;SPI;2;Physique;2015;2014-15;2014;2014;32;11;21;93;24;69;21;4;17;;;;;tZcIZ
209;École doctorale Sciences physiques et de L'ingénieur;SPI;8;Sciences pour l'ingénieur;2015;2014-15;2014;2014;22;4;18;79;17;62;22;7;15;;;;;tZcIZ
211;École doctorale Sciences exactes et leurs applications;ED SEA;5;Biologie, médecine et santé;2015;2014-15;2014;2014;3;1;2;21;15;6;4;3;1;;;;;1G1iC
216;École doctorale Ingénierie pour la santé, la cognition, l'environnement;EDISCE;4;Chimie;2015;2014-15;2014;2014;1;1;0;1;1;0;0;0;0;;;;;fPs1t
218;École doctorale Chimie et sciences du vivant;EDCSV;10;Sciences agronomiques et écologiques;2015;2014-15;2014;2014;2;0;2;13;5;8;4;2;2;;;;;8bcJh
222;École doctorale Sciences chimiques;EDSC;2;Physique;2015;2014-15;2014;2014;5;2;3;31;11;20;0;0;0;;;;;AdU8Q
224;École doctorale Cognition, langage, interaction;;8;Sciences pour l'ingénieur;2015;2014-15;2014;2014;3;2;1;8;6;2;2;1;1;;;;;7v43e
227;École doctorale Sciences de la nature et de l'homme;;4;Chimie;2015;2014-15;2014;2014;2;1;1;3;2;1;1;1;0;;;;;xiDA5
251;École doctorale Sciences de l'environnement;;6;Sciences humaines et humanités;2015;2014-15;2014;2014;1;1;0;7;4;3;4;3;1;;;;;VR28y
254;École doctorale Sciences de la matière;;2;Physique;2015;2014-15;2014;2014;25;5;20;72;15;57;14;4;10;;;;;365F2
260;École doctorale pluridisciplinaire;;2;Physique;2015;2014-15;2014;2014;2;0;2;7;2;5;2;0;2;;;;;sCk1f
260;École doctorale pluridisciplinaire;;5;Biologie, médecine et santé;2015;2014-15;2014;2014;21;13;8;96;60;36;10;6;4;;;;;sCk1f
260;École doctorale pluridisciplinaire;;9;Sciences et technologies de l'information et de la communication;2015;2014-15;2014;2014;0;0;0;4;2;2;1;1;0;;;;;sCk1f
265;École doctorale Langues, littératures et sociétés du monde;;6;Sciences humaines et humanités;2015;2014-15;2014;2014;68;44;24;298;178;120;34;22;12;;;;;4YWGW
269;École doctorale Mathématiques, sciences de l'information et de l'ingénieur;MSII;2;Physique;2015;2014-15;2014;2014;0;0;0;4;1;3;0;0;0;;;;;5E625
273;École doctorale Biologie et biotechnologie;B2T;5;Biologie, médecine et santé;2015;2014-15;2014;2014;47;29;18;172;108;64;62;38;24;;;;;Wtta6
279;École doctorale Arts plastiques, esthétique et sciences de l'art;APESA;6;Sciences humaines et humanités;2015;2014-15;2014;2014;48;34;14;250;171;79;41;27;14;;;;;BpW1j
280;École doctorale Philosophie;;6;Sciences humaines et humanités;2015;2014-15;2014;2014;54;19;35;248;93;155;29;10;19;;;;;kJxnm
285;École doctorale Sciences pratiques;;2;Physique;2015;2014-15;2014;2014;7;5;2;26;9;17;7;3;4;;;;;Jd3t2
304;École doctorale Sciences et environnements;;6;Sciences humaines et humanités;2015;2014-15;2014;2014;4;1;3;14;6;8;3;1;2;;;;;2ywZn
306;École doctorale Sciences des procédés, sciences des aliments;;4;Chimie;2015;2014-15;2014;2014;3;2;1;9;5;4;5;1;4;;;;;adF7W
309;École doctorale Systèmes;EDSYS;9;Sciences et technologies de l'information et de la communication;2015;2014-15;2014;2014;24;4;20;101;17;84;17;4;13;;;;;8TT4b
323;École doctorale Génie électrique, électronique et télécommunications;GEET;8;Sciences pour l'ingénieur;2015;2014-15;2014;2014;23;4;19;100;20;80;18;4;14;;;;;arcz6
323;École doctorale Génie électrique, électronique et télécommunications;GEET;9;Sciences et technologies de l'information et de la communication;2015;2014-15;2014;2014;28;6;22;112;31;81;30;10;20;;;;;arcz6
327;École doctorale Temps, espaces, sociétés, cultures;TESC;6;Sciences humaines et humanités;2015;2014-15;2014;2014;49;28;21;254;138;116;22;10;12;;;;;IjgiJ
328;École doctorale Arts, lettres, langues, philosophie et communication;ALLPH@;6;Sciences humaines et humanités;2015;2014-15;2014;2014;65;40;25;304;176;128;48;24;24;;;;;xLxMh
340;École doctorale Biologie moléculaire, intégrative et cellulaire;BMIC;5;Biologie, médecine et santé;2015;2014-15;2014;2014;66;46;20;249;147;102;67;42;25;;;;;db7xq
351;École doctorale Sciences physiques, mathématiques et de l'information pour l'ingénieur;SPMII;1;Mathématiques et leurs interactions;2015;2014-15;2014;2014;8;4;4;34;13;21;7;4;3;;;;;rY4EP
351;École doctorale Sciences physiques, mathématiques et de l'information pour l'ingénieur;SPMII;3;Sciences de la terre et de l'univers, espace;2015;2014-15;2014;2014;0;0;0;1;1;0;0;0;0;;;;;rY4EP
352;École doctorale Physique et sciences de la matière;;2;Physique;2015;2014-15;2014;2014;71;19;52;226;66;160;60;21;39;;;;;fb5YC
355;École doctorale Espaces, cultures, sociétés;;7;Sciences de la société;2015;2014-15;2014;2014;14;8;6;50;29;21;2;2;0;;;;;2kMf5
361;École doctorale Sciences et Technologies;ED ST;7;Sciences de la société;2015;2014-15;2014;2014;1;0;1;3;0;3;0;0;0;;;;;cOUmL
361;École doctorale Sciences et Technologies;ED ST;9;Sciences et technologies de l'information et de la communication;2015;2014-15;2014;2014;27;11;16;117;45;72;30;9;21;;;;;cOUmL
364;École doctorale Sciences fondamentales et appliquées;EDSFA;4;Chimie;2015;2014-15;2014;2014;9;5;4;27;17;10;11;6;5;;;;;E483q
373;École doctorale Santé, information/communications et mathématiques, matière;SICMA;10;Sciences agronomiques et écologiques;2015;2014-15;2014;2014;5;4;1;18;12;6;3;1;2;;;;;hTJF5
377;École doctorale Environnement et société;;2;Physique;2015;2014-15;2014;2014;0;0;0;2;0;2;0;0;0;;;;;ZMG5u
378;École doctorale Sciences de l'homme et de la société;SHS;7;Sciences de la société;2015;2014-15;2014;2014;12;6;6;91;37;54;14;5;9;;;;;3XKuF
386;École doctorale Sciences mathématiques de Paris centre;SMPC;1;Mathématiques et leurs interactions;2015;2014-15;2014;2014;83;14;69;324;82;242;64;18;46;;;;;wMj98
395;École doctorale Milieux, cultures et sociétés du passé et du présent;MCSPP;6;Sciences humaines et humanités;2015;2014-15;2014;2014;75;49;26;432;294;138;55;34;21;;;;;2quEb
397;École doctorale Physique et chimie des matériaux;;2;Physique;2015;2014-15;2014;2014;30;14;16;117;41;76;22;9;13;;;;;WxSt9
398;École doctorale Géosciences, ressources naturelles et environnement;GRNE;3;Sciences de la terre et de l'univers, espace;2015;2014-15;2014;2014;32;11;21;149;64;85;40;16;24;;;;;Zi4Zf
400;École doctorale Savoirs scientifiques : épistémologie, histoire des sciences, didactique des disciplines;;5;Biologie, médecine et santé;2015;2014-15;2014;2014;4;4;0;29;12;17;2;2;0;;;;;nRax3
400;École doctorale Savoirs scientifiques : épistémologie, histoire des sciences, didactique des disciplines;;8;Sciences pour l'ingénieur;2015;2014-15;2014;2014;0;0;0;0;0;0;1;0;1;;;;;nRax3
405;École doctorale Économie, management,mathématiques et physique de Cergy;EM2C;2;Physique;2015;2014-15;2014;2014;0;0;0;4;0;4;0;0;0;;;;;QbwSB
405;École doctorale Économie, management,mathématiques et physique de Cergy;EM2C;7;Sciences de la société;2015;2014-15;2014;2014;9;2;7;66;31;35;16;8;8;;;;;QbwSB
410;École doctorale Sciences et ingénierie des ressources, procédés, produits, environnement;RP2E;4;Chimie;2015;2014-15;2014;2014;1;1;0;12;7;5;6;1;5;;;;;Q5fxV
413;École doctorale Sciences de la terre et de l'environnement;STE;3;Sciences de la terre et de l'univers, espace;2015;2014-15;2014;2014;17;7;10;67;34;33;16;7;9;;;;;u9BA9
413;École doctorale Sciences de la terre et de l'environnement;STE;7;Sciences de la société;2015;2014-15;2014;2014;2;2;0;14;9;5;4;2;2;;;;;u9BA9
413;École doctorale Sciences de la terre et de l'environnement;STE;10;Sciences agronomiques et écologiques;2015;2014-15;2014;2014;1;1;0;2;2;0;0;0;0;;;;;u9BA9
417;École doctorale Sciences et Ingénierie;S&I;3;Sciences de la terre et de l'univers, espace;2015;2014-15;2014;2014;1;0;1;7;3;4;4;1;3;;;;;SSBvE
417;École doctorale Sciences et Ingénierie;S&I;4;Chimie;2015;2014-15;2014;2014;5;2;3;25;13;12;3;2;1;;;;;SSBvE
420;École doctorale Santé publique Paris 11 - Paris 5;;5;Biologie, médecine et santé;2015;2014-15;2014;2014;32;24;8;157;105;52;27;17;10;;;;;3BNdi
422;École doctorale Sciences et technologies de l'information, des télécommunications et des systèmes;;9;Sciences et technologies de l'information et de la communication;2015;2014-15;2014;2014;65;17;48;260;73;187;67;20;47;;;;;998UM
425;École doctorale Innovation thérapeutique : du fondamental à l'appliqué;;5;Biologie, médecine et santé;2015;2014-15;2014;2014;63;37;26;238;136;102;45;25;20;;;;;DkgNy
426;École doctorale Gènes, génomes, cellules;;5;Biologie, médecine et santé;2015;2014-15;2014;2014;28;16;12;120;66;54;30;19;11;;;;;XPaY8
435;École doctorale Agriculture, alimentation, biologie, environnement et santé;;5;Biologie, médecine et santé;2015;2014-15;2014;2014;22;14;8;99;60;39;22;17;5;;;;;mC35U
446;École doctorale Biologie - Santé;EDBSL;6;Sciences humaines et humanités;2015;2014-15;2014;2014;0;0;0;0;0;0;1;0;1;;;;;4iEUF
447;École doctorale de l'école polytechnique;;2;Physique;2015;2014-15;2014;2014;47;14;33;192;47;145;46;8;38;;;;;zgCCh
447;École doctorale de l'école polytechnique;;7;Sciences de la société;2015;2014-15;2014;2014;2;0;2;27;9;18;3;0;3;;;;;zgCCh
447;École doctorale de l'école polytechnique;;9;Sciences et technologies de l'information et de la communication;2015;2014-15;2014;2014;18;4;14;85;14;71;13;1;12;;;;;zgCCh
456;École doctorale Sciences du sport, de la motricité et du mouvement humain;;5;Biologie, médecine et santé;2015;2014-15;2014;2014;12;7;5;37;18;19;6;2;4;;;;;GqvEI
460;École doctorale Sciences juridiques;SJ;7;Sciences de la société;2015;2014-15;2014;2014;26;13;13;124;61;63;18;9;9;;;;;ZB5I5
467;École doctorale Aéronautique, astronautique;AA;2;Physique;2015;2014-15;2014;2014;1;0;1;4;1;3;0;0;0;;;;;U7l45
467;École doctorale Aéronautique, astronautique;AA;5;Biologie, médecine et santé;2015;2014-15;2014;2014;1;0;1;2;1;1;0;0;0;;;;;U7l45
468;École doctorale Mécanique, énergétique, génie civil, procédés;MEGEP;8;Sciences pour l'ingénieur;2015;2014-15;2014;2014;114;33;81;461;146;315;104;29;75;;;;;4XUTB
469;École doctorale du Pacifique;EDP;2;Physique;2015;2014-15;2014;2014;1;1;0;2;1;1;0;0;0;;;;;t9Z2n
469;École doctorale du Pacifique;EDP;3;Sciences de la terre et de l'univers, espace;2015;2014-15;2014;2014;4;3;1;9;5;4;4;1;3;;;;;t9Z2n
469;École doctorale du Pacifique;EDP;5;Biologie, médecine et santé;2015;2014-15;2014;2014;1;1;0;1;1;0;1;1;0;;;;;t9Z2n
469;École doctorale du Pacifique;EDP;6;Sciences humaines et humanités;2015;2014-15;2014;2014;0;0;0;16;9;7;5;5;0;;;;;t9Z2n
469;École doctorale du Pacifique;EDP;7;Sciences de la société;2015;2014-15;2014;2014;5;4;1;20;10;10;1;0;1;;;;;t9Z2n
472;École doctorale de l'EPHE;;3;Sciences de la terre et de l'univers, espace;2015;2014-15;2014;2014;0;0;0;15;7;8;12;8;4;;;;;27zK4
473;École doctorale Sciences de l'homme et de la société;SHS;7;Sciences de la société;2015;2014-15;2014;2014;2;0;2;3;0;3;1;0;1;;;;;8qKD9
476;École doctorale Neurosciences et cognition;NSCO;5;Biologie, médecine et santé;2015;2014-15;2014;2014;24;10;14;115;69;46;22;11;11;;;;;B1H0x
476;École doctorale Neurosciences et cognition;NSCO;6;Sciences humaines et humanités;2015;2014-15;2014;2014;5;4;1;23;17;6;9;7;2;;;;;B1H0x
480;École doctorale Montaigne-humanités;;3;Sciences de la terre et de l'univers, espace;2015;2014-15;2014;2014;7;2;5;27;9;18;4;2;2;;;;;f3SeZ
480;École doctorale Montaigne-humanités;;6;Sciences humaines et humanités;2015;2014-15;2014;2014;108;69;39;561;322;239;78;41;37;;;;;f3SeZ
481;École doctorale Sciences sociales et humanités;SSH;6;Sciences humaines et humanités;2015;2014-15;2014;2014;34;18;16;153;95;58;14;11;3;;;;;E3z5j
488;École doctorale Sciences, ingénierie, santé;SIS;5;Biologie, médecine et santé;2015;2014-15;2014;2014;17;3;14;70;23;47;10;4;6;;;;;Fy2lK
489;École doctorale Sciences et ingénierie des systèmes, de l'environnement et des organisations;SISEO;9;Sciences et technologies de l'information et de la communication;2015;2014-15;2014;2014;5;3;2;24;10;14;0;0;0;;;;;6pT77
491;École doctorale Langages, idées, sociétés, institutions, territoires;LISIT;6;Sciences humaines et humanités;2015;2014-15;2014;2014;74;33;41;381;208;173;54;33;21;;;;;iB25j
493;École doctorale Erasme;;6;Sciences humaines et humanités;2015;2014-15;2014;2014;28;22;6;130;95;35;16;7;9;;;;;FPW4T
497;École doctorale Normande de Biologie Intégrative, Santé, Environnement;Ed NBISE;3;Sciences de la terre et de l'univers, espace;2015;2014-15;2014;2014;6;3;3;13;7;6;3;1;2;;;;;0D9Je
497;École doctorale Normande de Biologie Intégrative, Santé, Environnement;Ed NBISE;10;Sciences agronomiques et écologiques;2015;2014-15;2014;2014;2;1;1;17;14;3;3;2;1;;;;;0D9Je
500;École doctorale Matière, molécules, matériaux en Pays de Loire;3MPL;8;Sciences pour l'ingénieur;2015;2014-15;2014;2014;1;0;1;11;2;9;4;1;3;;;;;822tM
501;École doctorale Droit, économie-gestion, sociétés, territoires;;7;Sciences de la société;2015;2014-15;2014;2014;81;28;53;342;154;188;36;17;19;;;;;wE7WM
502;École doctorale Biologie - Santé;;5;Biologie, médecine et santé;2015;2014-15;2014;2014;80;43;37;339;186;153;80;52;28;;;;;JCFV7
504;École doctorale Cognition, éducation, interactions;CEI;6;Sciences humaines et humanités;2015;2014-15;2014;2014;50;33;17;207;123;84;26;12;14;;;;;39naT
505;École doctorale Sciences de l'homme, des organisations et de la société;SHOS;7;Sciences de la société;2015;2014-15;2014;2014;60;28;32;342;162;180;63;23;40;;;;;qts78
508;École doctorale Normande de chimie;EDNC;4;Chimie;2015;2014-15;2014;2014;34;20;14;132;62;70;38;17;21;;;;;E52OO
511;École doctorale Sciences et ingénierie;S&I;2;Physique;2015;2014-15;2014;2014;2;1;1;2;1;1;0;0;0;;;;;7aXuB
512;École doctorale Informatique et mathématiques;InfoMaths;9;Sciences et technologies de l'information et de la communication;2015;2014-15;2014;2014;57;9;48;199;52;147;21;8;13;;;;;t86bi
517;École doctorale Particules, noyaux, cosmologie;;2;Physique;2015;2014-15;2014;2014;32;8;24;84;21;63;36;12;24;;;;;9kK48
519;École doctorale Sciences humaines et sociales - Perspectives européennes;SHS-PE;6;Sciences humaines et humanités;2015;2014-15;2014;2014;76;46;30;396;224;172;44;22;22;;;;;2f5qs
522;École doctorale Sciences et ingénierie en matériaux, mécanique, énergétique et aéronautique;SI-MMEA;3;Sciences de la terre et de l'univers, espace;2015;2014-15;2014;2014;0;0;0;0;0;0;15;6;9;;;;;82F19
522;École doctorale Sciences et ingénierie en matériaux, mécanique, énergétique et aéronautique;SI-MMEA;4;Chimie;2015;2014-15;2014;2014;14;8;6;40;23;17;5;1;4;;;;;82F19
523;École doctorale Sciences pour l'environnement - Gay Lussac;;6;Sciences humaines et humanités;2015;2014-15;2014;2014;1;1;0;6;2;4;1;1;0;;;;;6xD69
526;École doctorale Sociétés et organisations;SORG;6;Sciences humaines et humanités;2015;2014-15;2014;2014;12;7;5;59;28;31;8;5;3;;;;;5F3Fd
530;École doctorale Organisations, marchés, institutions;OMI;7;Sciences de la société;2015;2014-15;2014;2014;26;17;9;172;90;82;16;9;7;;;;;4htv7
539;École doctorale Sciences et technologies de Versailles;;1;Mathématiques et leurs interactions;2015;2014-15;2014;2014;4;1;3;15;5;10;1;0;1;;;;;nv3h8
539;École doctorale Sciences et technologies de Versailles;;4;Chimie;2015;2014-15;2014;2014;7;3;4;38;19;19;8;6;2;;;;;nv3h8
540;"École doctorale École transdisciplinaire ""lettres/sciences""";;6;Sciences humaines et humanités;2015;2014-15;2014;2014;35;14;21;93;49;44;2;1;1;;;;;tWWw7
540;"École doctorale École transdisciplinaire ""lettres/sciences""";;7;Sciences de la société;2015;2014-15;2014;2014;0;0;0;0;0;0;1;0;1;;;;;tWWw7
542;École doctorale de sciences de La Réunion;STS;1;Mathématiques et leurs interactions;2015;2014-15;2014;2014;8;2;6;27;9;18;2;2;0;;;;;2pAql
542;École doctorale de sciences de La Réunion;STS;4;Chimie;2015;2014-15;2014;2014;2;2;0;21;6;15;7;4;3;;;;;2pAql
545;École doctorale Sociétés, politique et santé publique;SP2;5;Biologie, médecine et santé;2015;2014-15;2014;2014;21;14;7;60;36;24;12;7;5;;;;;IAKR4
545;École doctorale Sociétés, politique et santé publique;SP2;7;Sciences de la société;2015;2014-15;2014;2014;26;13;13;108;64;44;20;12;8;;;;;IAKR4
547;École doctorale Sciences, Technologie, Santé;EDSTS;1;Mathématiques et leurs interactions;2015;2014-15;2014;2014;3;2;1;20;6;14;3;1;2;;;;;wEdn2
548;École doctorale Mer et Sciences;;2;Physique;2015;2014-15;2014;2014;3;2;1;7;3;4;5;3;2;;;;;QX0fS
549;École doctorale Santé, Sciences Biologiques et Chimie du Vivant;SSBCV;4;Chimie;2015;2014-15;2014;2014;18;9;9;45;23;22;9;7;2;;;;;B9ggO
551;École doctorale Mathématiques, Informatique, Physique Théorique et Ingénierie des Systèmes;MIPTIS;8;Sciences pour l'ingénieur;2015;2014-15;2014;2014;1;0;1;2;0;2;1;0;1;;;;;Mpudz
552;École doctorale Énergie - Matériaux - Sciences de la Terre et de l'Univers;EMTSU;2;Physique;2015;2014-15;2014;2014;8;4;4;39;15;24;8;2;6;;;;;NTZhw
552;École doctorale Énergie - Matériaux - Sciences de la Terre et de l'Univers;EMTSU;3;Sciences de la terre et de l'univers, espace;2015;2014-15;2014;2014;12;4;8;54;19;35;9;4;5;;;;;NTZhw
552;École doctorale Énergie - Matériaux - Sciences de la Terre et de l'Univers;EMTSU;8;Sciences pour l'ingénieur;2015;2014-15;2014;2014;25;5;20;83;17;66;21;5;16;;;;;NTZhw
553;École doctorale Carnot - Pasteur;;2;Physique;2015;2014-15;2014;2014;12;2;10;50;13;37;6;2;4;;;;;6h4Z7
554;École doctorale Environnements - Santé;E-S;5;Biologie, médecine et santé;2015;2014-15;2014;2014;56;33;23;215;121;94;44;14;30;;;;;ElyFU
555;École doctorale Sciences de l'Homme et de la Société;SHS;6;Sciences humaines et humanités;2015;2014-15;2014;2014;52;25;27;305;151;154;34;21;13;;;;;44G6m
556;École doctorale Homme, Sociétés, Risques, Territoire;HSRT;7;Sciences de la société;2015;2014-15;2014;2014;13;5;8;68;27;41;5;3;2;;;;;5QEaX
559;École doctorale Management Panthéon-Sorbonne;;7;Sciences de la société;2015;2014-15;2014;2014;50;22;28;192;84;108;31;18;13;;;;;4SP7k
564;École doctorale Physique en Ile de France;PIF;2;Physique;2015;2014-15;2014;2014;167;38;129;577;147;430;143;31;112;;;;;39AcN
565;École doctorale Droit de la Sorbonne;DS;7;Sciences de la société;2015;2014-15;2014;2014;139;58;81;953;455;498;74;40;34;;;;;aXJ7L
7;École doctorale Georges Vedel - Droit public interne, science administrative et science politique;;7;Sciences de la société;2012;2011-12;2011;2011;25;10;15;160;64;96;23;5;18;;;;;Dw881
20;École doctorale Civilisations, cultures, littératures et sociétés;;6;Sciences humaines et humanités;2012;2011-12;2011;2011;69;47;22;235;169;66;33;20;13;;;;;agjNi
37;École doctorale Sciences physiques pour l'ingénieur et microtechniques;SPIM;8;Sciences pour l'ingénieur;2012;2011-12;2011;2011;69;15;54;251;51;200;55;8;47;;;;;F7G1B
38;École doctorale Langages, espaces, temps, sociétés;;9;Sciences et technologies de l'information et de la communication;2012;2011-12;2011;2011;2;1;1;6;3;3;0;0;0;;;;;pGgDX
50;École doctorale Langues, littératures et sciences humaines;LLSH;7;Sciences de la société;2012;2011-12;2011;2011;7;7;0;17;14;3;0;0;0;;;;;8THzQ
52;École doctorale Physique et astrophysique de Lyon;PHAST;3;Sciences de la terre et de l'univers, espace;2012;2011-12;2011;2011;3;0;3;8;4;4;5;2;3;;;;;61XPb
65;École doctorale Sciences de la Vie, Santé, Agronomie, Environnement;;5;Biologie, médecine et santé;2012;2011-12;2011;2011;36;21;15;155;84;71;37;18;19;;;;;MAOG4
70;École doctorale Sciences pour l'ingénieur;EDSPI;9;Sciences et technologies de l'information et de la communication;2012;2011-12;2011;2011;47;7;40;167;22;145;28;4;24;;;;;G413P
71;École doctorale Sciences pour l'ingénieur;;1;Mathématiques et leurs interactions;2012;2011-12;2011;2011;1;1;0;5;3;2;1;0;1;;;;;H6UYp
77;École doctorale Informatique, automatique, électronique, électrotechnique, mathématiques;IAEM;8;Sciences pour l'ingénieur;2012;2011-12;2011;2011;3;0;3;28;3;25;8;3;5;;;;;TCHTA
84;École doctorale Sciences et technologies de l'information et de la communication;STIC;8;Sciences pour l'ingénieur;2012;2011-12;2011;2011;0;0;0;1;1;0;0;0;0;;;;;9wS2W
86;École doctorale Sociétés, humanités, arts, lettres;LSHS;7;Sciences de la société;2012;2011-12;2011;2011;4;2;2;47;27;20;9;7;2;;;;;O8E6y
101;École doctorale de Sciences juridiques;;6;Sciences humaines et humanités;2012;2011-12;2011;2011;3;2;1;31;13;18;5;4;1;;;;;569G2
101;École doctorale de Sciences juridiques;;9;Sciences et technologies de l'information et de la communication;2012;2011-12;2011;2011;0;0;0;1;0;1;0;0;0;;;;;569G2
102;École doctorale Santé, sciences, technologies;;4;Chimie;2012;2011-12;2011;2011;6;2;4;13;4;9;5;2;3;;;;;4h65n
104;École doctorale Sciences de la matière, du rayonnement et de l'environnement;SMRE;5;Biologie, médecine et santé;2012;2011-12;2011;2011;2;0;2;4;1;3;0;0;0;;;;;Q5iFz
104;École doctorale Sciences de la matière, du rayonnement et de l'environnement;SMRE;10;Sciences agronomiques et écologiques;2012;2011-12;2011;2011;21;9;12;51;23;28;16;8;8;;;;;Q5iFz
107;École doctorale Physique de la région parisienne;;2;Physique;2012;2011-12;2011;2011;84;14;70;281;44;237;78;14;64;;;;;O3g7O
124;École doctorale Histoire de l'art et archéologie;;6;Sciences humaines et humanités;2012;2011-12;2011;2011;46;35;11;266;199;67;36;25;11;;;;;MBN4L
131;École doctorale Langue, littérature, image, civilisations et sciences humaines (domaines francophone et anglophone);LLI;6;Sciences humaines et humanités;2012;2011-12;2011;2011;60;35;25;320;209;111;28;22;6;;;;;a47aW
139;École doctorale Connaissance, langage, modélisation;CLM;1;Mathématiques et leurs interactions;2012;2011-12;2011;2011;1;1;0;3;1;2;0;0;0;;;;;1lxGH
145;École doctorale Sciences du végétal : du gène à l'écosystème;;5;Biologie, médecine et santé;2012;2011-12;2011;2011;22;13;9;127;71;56;21;10;11;;;;;ubDmM
146;École doctorale Galilée;GALILEE;2;Physique;2012;2011-12;2011;2011;16;7;9;46;13;33;9;3;6;;;;;71hqm
146;École doctorale Galilée;GALILEE;4;Chimie;2012;2011-12;2011;2011;2;2;0;18;13;5;6;2;4;;;;;71hqm
146;École doctorale Galilée;GALILEE;8;Sciences pour l'ingénieur;2012;2011-12;2011;2011;6;2;4;24;10;14;3;1;2;;;;;71hqm
146;École doctorale Galilée;GALILEE;9;Sciences et technologies de l'information et de la communication;2012;2011-12;2011;2011;14;9;5;61;25;36;11;4;7;;;;;71hqm
149;École doctorale Carnot;;2;Physique;2012;2011-12;2011;2011;15;5;10;49;11;38;18;5;13;;;;;zuThw
149;École doctorale Carnot;;4;Chimie;2012;2011-12;2011;2011;18;4;14;77;21;56;17;4;13;;;;;zuThw
158;École doctorale Cerveau, cognition, comportement;3C;6;Sciences humaines et humanités;2012;2011-12;2011;2011;5;1;4;17;4;13;5;3;2;;;;;Il62F
160;École doctorale Électronique, électrotechnique, automatique;EEA;9;Sciences et technologies de l'information et de la communication;2012;2011-12;2011;2011;39;10;29;141;31;110;32;10;22;;;;;EgfMQ
162;École doctorale Mécanique, énergétique, génie civil, acoustique;MEGA;5;Biologie, médecine et santé;2012;2011-12;2011;2011;2;2;0;35;10;25;6;0;6;;;;;7wCke
166;École doctorale Information, structures et systèmes;I2S;3;Sciences de la terre et de l'univers, espace;2012;2011-12;2011;2011;0;0;0;3;1;2;1;0;1;;;;;2uO68
173;École doctorale Sciences de l'univers, de l'environnement et de l'espace;SDU2E;3;Sciences de la terre et de l'univers, espace;2012;2011-12;2011;2011;71;27;44;246;102;144;48;24;24;;;;;R0Z9c
177;École doctorale Sciences et technologies de l'université d'Orléans;;1;Mathématiques et leurs interactions;2012;2011-12;2011;2011;3;3;0;17;8;9;3;2;1;;;;;JI65m
177;École doctorale Sciences et technologies de l'université d'Orléans;;3;Sciences de la terre et de l'univers, espace;2012;2011-12;2011;2011;17;8;9;40;17;23;11;6;5;;;;;JI65m
177;École doctorale Sciences et technologies de l'université d'Orléans;;4;Chimie;2012;2011-12;2011;2011;16;9;7;70;34;36;16;6;10;;;;;JI65m
177;École doctorale Sciences et technologies de l'université d'Orléans;;5;Biologie, médecine et santé;2012;2011-12;2011;2011;10;7;3;46;29;17;17;5;12;;;;;JI65m
178;École doctorale Sciences fondamentales;;4;Chimie;2012;2011-12;2011;2011;9;4;5;58;30;28;21;9;12;;;;;1AiR7
182;École doctorale Physique et chimie-physique;;2;Physique;2012;2011-12;2011;2011;30;11;19;127;38;89;40;13;27;;;;;3My6I
182;École doctorale Physique et chimie-physique;;4;Chimie;2012;2011-12;2011;2011;15;6;9;40;14;26;1;0;1;;;;;3My6I
206;École doctorale Chimie : chimie, procédés, environnement;;4;Chimie;2012;2011-12;2011;2011;92;35;57;354;150;204;88;34;54;;;;;m0UhD
209;École doctorale Sciences physiques et de L'ingénieur;SPI;9;Sciences et technologies de l'information et de la communication;2012;2011-12;2011;2011;34;5;29;139;31;108;42;6;36;;;;;tZcIZ
211;École doctorale Sciences exactes et leurs applications;ED SEA;10;Sciences agronomiques et écologiques;2012;2011-12;2011;2011;5;4;1;12;5;7;2;1;1;;;;;1G1iC
218;École doctorale Chimie et sciences du vivant;EDCSV;5;Biologie, médecine et santé;2012;2011-12;2011;2011;54;28;26;230;129;101;61;35;26;;;;;8bcJh
220;École doctorale Électronique, électrotechnique, automatique, traitement du signal;EEATS;8;Sciences pour l'ingénieur;2012;2011-12;2011;2011;31;8;23;107;27;80;27;4;23;;;;;IxEaw
221;École doctorale Augustin Cournot - Sciences économiques et de gestion - Sciences, technologies et sociétés;EDAC;6;Sciences humaines et humanités;2012;2011-12;2011;2011;2;1;1;9;4;5;1;0;1;;;;;5z9rW
221;École doctorale Augustin Cournot - Sciences économiques et de gestion - Sciences, technologies et sociétés;EDAC;7;Sciences de la société;2012;2011-12;2011;2011;21;5;16;86;34;52;12;5;7;;;;;5z9rW
227;École doctorale Sciences de la nature et de l'homme;;6;Sciences humaines et humanités;2012;2011-12;2011;2011;7;6;1;42;27;15;13;6;7;;;;;xiDA5
251;École doctorale Sciences de l'environnement;;10;Sciences agronomiques et écologiques;2012;2011-12;2011;2011;12;8;4;59;36;23;16;7;9;;;;;VR28y
254;École doctorale Sciences de la matière;;3;Sciences de la terre et de l'univers, espace;2012;2011-12;2011;2011;13;4;9;45;17;28;9;1;8;;;;;365F2
254;École doctorale Sciences de la matière;;4;Chimie;2012;2011-12;2011;2011;53;24;29;172;66;106;47;9;38;;;;;365F2
254;École doctorale Sciences de la matière;;8;Sciences pour l'ingénieur;2012;2011-12;2011;2011;12;3;9;50;10;40;16;3;13;;;;;365F2
269;École doctorale Mathématiques, sciences de l'information et de l'ingénieur;MSII;2;Physique;2012;2011-12;2011;2011;0;0;0;11;3;8;2;0;2;;;;;5E625
269;École doctorale Mathématiques, sciences de l'information et de l'ingénieur;MSII;3;Sciences de la terre et de l'univers, espace;2012;2011-12;2011;2011;0;0;0;1;0;1;0;0;0;;;;;5E625
279;École doctorale Arts plastiques, esthétique et sciences de l'art;APESA;6;Sciences humaines et humanités;2012;2011-12;2011;2011;42;29;13;327;229;98;20;14;6;;;;;BpW1j
285;École doctorale Sciences pratiques;;5;Biologie, médecine et santé;2012;2011-12;2011;2011;2;1;1;9;5;4;2;1;1;;;;;Jd3t2
285;École doctorale Sciences pratiques;;6;Sciences humaines et humanités;2012;2011-12;2011;2011;0;0;0;21;10;11;4;2;2;;;;;Jd3t2
285;École doctorale Sciences pratiques;;7;Sciences de la société;2012;2011-12;2011;2011;8;6;2;33;19;14;5;5;0;;;;;Jd3t2
287;École doctorale Sciences pour l'ingénieur;;1;Mathématiques et leurs interactions;2012;2011-12;2011;2011;7;0;7;51;17;34;13;2;11;;;;;48Q1j
287;École doctorale Sciences pour l'ingénieur;;7;Sciences de la société;2012;2011-12;2011;2011;0;0;0;2;0;2;1;0;1;;;;;48Q1j
304;École doctorale Sciences et environnements;;3;Sciences de la terre et de l'univers, espace;2012;2011-12;2011;2011;6;6;0;32;22;10;11;5;6;;;;;2ywZn
305;École doctorale Énergie et environnement;E2;1;Mathématiques et leurs interactions;2012;2011-12;2011;2011;4;0;4;5;0;5;2;0;2;;;;;Kbt8I
305;École doctorale Énergie et environnement;E2;3;Sciences de la terre et de l'univers, espace;2012;2011-12;2011;2011;5;3;2;19;11;8;3;1;2;;;;;Kbt8I
306;École doctorale Sciences des procédés, sciences des aliments;;9;Sciences et technologies de l'information et de la communication;2012;2011-12;2011;2011;0;0;0;1;0;1;0;0;0;;;;;adF7W
309;École doctorale Systèmes;EDSYS;8;Sciences pour l'ingénieur;2012;2011-12;2011;2011;22;6;16;103;33;70;20;4;16;;;;;8TT4b
309;École doctorale Systèmes;EDSYS;9;Sciences et technologies de l'information et de la communication;2012;2011-12;2011;2011;21;5;16;74;11;63;25;5;20;;;;;8TT4b
323;École doctorale Génie électrique, électronique et télécommunications;GEET;8;Sciences pour l'ingénieur;2012;2011-12;2011;2011;36;13;23;81;17;64;22;4;18;;;;;arcz6
327;École doctorale Temps, espaces, sociétés, cultures;TESC;7;Sciences de la société;2012;2011-12;2011;2011;36;19;17;170;89;81;28;19;9;;;;;IjgiJ
340;École doctorale Biologie moléculaire, intégrative et cellulaire;BMIC;5;Biologie, médecine et santé;2012;2011-12;2011;2011;60;33;27;272;163;109;68;40;28;;;;;db7xq
341;École doctorale Évolution, écosystèmes, microbiologie, modélisation;E2M2;3;Sciences de la terre et de l'univers, espace;2012;2011-12;2011;2011;3;2;1;14;6;8;2;1;1;;;;;J83I0
341;École doctorale Évolution, écosystèmes, microbiologie, modélisation;E2M2;10;Sciences agronomiques et écologiques;2012;2011-12;2011;2011;29;16;13;127;66;61;34;18;16;;;;;J83I0
353;École doctorale Sciences pour l'ingénieur : mécanique, physique, micro et nanoélectronique;;4;Chimie;2012;2011-12;2011;2011;0;0;0;2;2;0;0;0;0;;;;;vk5Kp
358;École doctorale Sciences, technologies, santé;;5;Biologie, médecine et santé;2012;2011-12;2011;2011;15;11;4;62;40;22;16;8;8;;;;;OZA3U
368;École doctorale Sciences et santé;;2;Physique;2012;2011-12;2011;2011;2;1;1;7;1;6;1;1;0;;;;;4L0a1
368;École doctorale Sciences et santé;;8;Sciences pour l'ingénieur;2012;2011-12;2011;2011;7;1;6;19;5;14;2;1;1;;;;;4L0a1
368;École doctorale Sciences et santé;;9;Sciences et technologies de l'information et de la communication;2012;2011-12;2011;2011;10;0;10;32;6;26;7;1;6;;;;;4L0a1
373;École doctorale Santé, information/communications et mathématiques, matière;SICMA;4;Chimie;2012;2011-12;2011;2011;8;5;3;31;15;16;11;6;5;;;;;hTJF5
373;École doctorale Santé, information/communications et mathématiques, matière;SICMA;10;Sciences agronomiques et écologiques;2012;2011-12;2011;2011;2;1;1;8;4;4;3;3;0;;;;;hTJF5
377;École doctorale Environnement et société;;2;Physique;2012;2011-12;2011;2011;3;1;2;11;1;10;3;1;2;;;;;ZMG5u
396;École doctorale Économie, organisations, société;EOS;6;Sciences humaines et humanités;2012;2011-12;2011;2011;4;1;3;42;16;26;8;3;5;;;;;Es5e7
397;École doctorale Physique et chimie des matériaux;;4;Chimie;2012;2011-12;2011;2011;30;13;17;126;55;71;25;15;10;;;;;WxSt9
402;École doctorale Sciences de la vie et de la santé;SVS;5;Biologie, médecine et santé;2012;2011-12;2011;2011;22;10;12;83;46;37;27;13;14;;;;;YKgsU
405;École doctorale Économie, management,mathématiques et physique de Cergy;EM2C;7;Sciences de la société;2012;2011-12;2011;2011;18;10;8;54;28;26;10;6;4;;;;;QbwSB
406;École doctorale Chimie moléculaire de Paris centre;;4;Chimie;2012;2011-12;2011;2011;27;7;20;106;42;64;25;9;16;;;;;a5dKy
411;École doctorale Humanités nouvelles : Fernand Braudel;;9;Sciences et technologies de l'information et de la communication;2012;2011-12;2011;2011;8;3;5;38;18;20;5;2;3;;;;;l2rFh
412;École doctorale Lorraine de chimie et physique moléculaires : synthèses, expériences, simulations, applications : de la molécule aux édifices supramoléculaires;SESAMES;4;Chimie;2012;2011-12;2011;2011;20;11;9;62;26;36;15;7;8;;;;;mvHX2
414;École doctorale Sciences de la vie et de la santé;;4;Chimie;2012;2011-12;2011;2011;0;0;0;3;2;1;0;0;0;;;;;YI4xS
414;École doctorale Sciences de la vie et de la santé;;6;Sciences humaines et humanités;2012;2011-12;2011;2011;0;0;0;3;1;2;0;0;0;;;;;YI4xS
415;"École doctorale Interdisciplinaire ""Arts et métiers""";;2;Physique;2012;2011-12;2011;2011;0;0;0;0;0;0;4;1;3;;;;;B3z99
415;"École doctorale Interdisciplinaire ""Arts et métiers""";;6;Sciences humaines et humanités;2012;2011-12;2011;2011;0;0;0;0;0;0;6;4;2;;;;;B3z99
415;"École doctorale Interdisciplinaire ""Arts et métiers""";;8;Sciences pour l'ingénieur;2012;2011-12;2011;2011;0;0;0;0;0;0;4;0;4;;;;;B3z99
422;École doctorale Sciences et technologies de l'information, des télécommunications et des systèmes;;5;Biologie, médecine et santé;2012;2011-12;2011;2011;9;4;5;49;28;21;13;6;7;;;;;998UM
423;École doctorale Des génomes aux organismes;;4;Chimie;2012;2011-12;2011;2011;2;2;0;7;4;3;1;0;1;;;;;VguHK
423;École doctorale Des génomes aux organismes;;5;Biologie, médecine et santé;2012;2011-12;2011;2011;34;19;15;135;66;69;27;14;13;;;;;VguHK
435;École doctorale Agriculture, alimentation, biologie, environnement et santé;;3;Sciences de la terre et de l'univers, espace;2012;2011-12;2011;2011;0;0;0;9;2;7;2;0;2;;;;;mC35U
435;École doctorale Agriculture, alimentation, biologie, environnement et santé;;4;Chimie;2012;2011-12;2011;2011;4;2;2;18;11;7;5;5;0;;;;;mC35U
435;École doctorale Agriculture, alimentation, biologie, environnement et santé;;6;Sciences humaines et humanités;2012;2011-12;2011;2011;3;3;0;26;16;10;3;2;1;;;;;mC35U
435;École doctorale Agriculture, alimentation, biologie, environnement et santé;;9;Sciences et technologies de l'information et de la communication;2012;2011-12;2011;2011;1;0;1;1;0;1;0;0;0;;;;;mC35U
436;École doctorale Médicament, toxicologie, chimie, environnement;MTCE;4;Chimie;2012;2011-12;2011;2011;16;7;9;55;26;29;10;7;3;;;;;dPsg3
441;École doctorale Histoire de l'art;;6;Sciences humaines et humanités;2012;2011-12;2011;2011;37;26;11;267;195;72;30;22;8;;;;;d5W3U
447;École doctorale de l'école polytechnique;;4;Chimie;2012;2011-12;2011;2011;14;5;9;47;20;27;13;8;5;;;;;zgCCh
447;École doctorale de l'école polytechnique;;6;Sciences humaines et humanités;2012;2011-12;2011;2011;6;0;6;27;11;16;5;3;2;;;;;zgCCh
455;École doctorale Économie, Gestion, Information et Communication;EGIC;9;Sciences et technologies de l'information et de la communication;2012;2011-12;2011;2011;9;7;2;91;50;41;12;9;3;;;;;qCOg3
456;École doctorale Sciences du sport, de la motricité et du mouvement humain;;5;Biologie, médecine et santé;2012;2011-12;2011;2011;9;5;4;45;22;23;7;3;4;;;;;GqvEI
458;École doctorale Sciences écologiques, vétérinaires, agronomiques et bioingénieries;SEVAB;10;Sciences agronomiques et écologiques;2012;2011-12;2011;2011;62;29;33;237;123;114;56;29;27;;;;;Yf3TI
463;École doctorale Sciences du mouvement humain;SMH;8;Sciences pour l'ingénieur;2012;2011-12;2011;2011;5;2;3;17;6;11;1;0;1;;;;;UbtlY
469;École doctorale du Pacifique;EDP;1;Mathématiques et leurs interactions;2012;2011-12;2011;2011;0;0;0;1;0;1;0;0;0;;;;;t9Z2n
469;École doctorale du Pacifique;EDP;5;Biologie, médecine et santé;2012;2011-12;2011;2011;1;1;0;3;2;1;3;1;2;;;;;t9Z2n
470;École doctorale Chimie de Paris-Sud;;4;Chimie;2012;2011-12;2011;2011;67;26;41;246;108;138;69;33;36;;;;;aExpW
472;École doctorale de l'EPHE;;5;Biologie, médecine et santé;2012;2011-12;2011;2011;9;7;2;46;28;18;7;3;4;;;;;27zK4
472;École doctorale de l'EPHE;;6;Sciences humaines et humanités;2012;2011-12;2011;2011;125;62;63;531;262;269;65;26;39;;;;;27zK4
473;École doctorale Sciences de l'homme et de la société;SHS;6;Sciences humaines et humanités;2012;2011-12;2011;2011;129;82;47;540;330;210;72;46;26;;;;;8qKD9
474;École doctorale Interdisciplinaire européenne frontières du vivant;FDV;5;Biologie, médecine et santé;2012;2011-12;2011;2011;13;6;7;60;27;33;16;5;11;;;;;E727j
474;École doctorale Interdisciplinaire européenne frontières du vivant;FDV;6;Sciences humaines et humanités;2012;2011-12;2011;2011;0;0;0;1;0;1;0;0;0;;;;;E727j
475;École doctorale Mathématiques, informatique, télécommunications de Toulouse;MITT;1;Mathématiques et leurs interactions;2012;2011-12;2011;2011;26;15;11;134;45;89;35;13;22;;;;;xcp2r
476;École doctorale Neurosciences et cognition;NSCO;6;Sciences humaines et humanités;2012;2011-12;2011;2011;6;4;2;28;18;10;8;6;2;;;;;B1H0x
477;École doctorale Systèmes intégrés en biologie, agronomie, géosciences, hydrosciences, environnement;SIBAGHE;2;Physique;2012;2011-12;2011;2011;1;0;1;1;0;1;0;0;0;;;;;zfN3N
478;École doctorale Sciences de Gestion;;7;Sciences de la société;2012;2011-12;2011;2011;12;4;8;75;38;37;16;11;5;;;;;q34kB
481;École doctorale Sciences sociales et humanités;SSH;7;Sciences de la société;2012;2011-12;2011;2011;47;22;25;158;72;86;18;2;16;;;;;E3z5j
483;École doctorale Histoire, géographie, aménagement, urbanisme, archéologie, science politique, sociologie, anthropologie;SCSO;6;Sciences humaines et humanités;2012;2011-12;2011;2011;44;18;26;202;85;117;19;6;13;;;;;hc6u4
488;École doctorale Sciences, ingénierie, santé;SIS;3;Sciences de la terre et de l'univers, espace;2012;2011-12;2011;2011;6;1;5;33;7;26;10;4;6;;;;;Fy2lK
488;École doctorale Sciences, ingénierie, santé;SIS;8;Sciences pour l'ingénieur;2012;2011-12;2011;2011;25;10;15;113;42;71;27;12;15;;;;;Fy2lK
489;École doctorale Sciences et ingénierie des systèmes, de l'environnement et des organisations;SISEO;4;Chimie;2012;2011-12;2011;2011;2;0;2;10;5;5;4;3;1;;;;;6pT77
489;École doctorale Sciences et ingénierie des systèmes, de l'environnement et des organisations;SISEO;10;Sciences agronomiques et écologiques;2012;2011-12;2011;2011;1;1;0;11;3;8;4;1;3;;;;;6pT77
490;École doctorale Environnement - Santé/STIC;E2S;3;Sciences de la terre et de l'univers, espace;2012;2011-12;2011;2011;8;2;6;39;11;28;10;4;6;;;;;sYTua
490;École doctorale Environnement - Santé/STIC;E2S;10;Sciences agronomiques et écologiques;2012;2011-12;2011;2011;23;15;8;112;78;34;22;15;7;;;;;sYTua
493;École doctorale Erasme;;6;Sciences humaines et humanités;2012;2011-12;2011;2011;45;15;30;190;81;109;21;8;13;;;;;FPW4T
494;École doctorale Jean-Henri Lambert;;5;Biologie, médecine et santé;2012;2011-12;2011;2011;0;0;0;0;0;0;1;0;1;;;;;A3m51
494;École doctorale Jean-Henri Lambert;;8;Sciences pour l'ingénieur;2012;2011-12;2011;2011;7;1;6;40;9;31;6;1;5;;;;;A3m51
494;École doctorale Jean-Henri Lambert;;9;Sciences et technologies de l'information et de la communication;2012;2011-12;2011;2011;12;3;9;29;5;24;4;0;4;;;;;A3m51
498;École doctorale Sciences pour l'ingénieur, géosciences, architecture;SPIGA;3;Sciences de la terre et de l'univers, espace;2012;2011-12;2011;2011;1;0;1;3;0;3;0;0;0;;;;;0vlKH
500;École doctorale Matière, molécules, matériaux en Pays de Loire;3MPL;2;Physique;2012;2011-12;2011;2011;24;5;19;90;19;71;22;6;16;;;;;822tM
503;École doctorale Sciences et technologies de l'information et de mathématiques;STIM;8;Sciences pour l'ingénieur;2012;2011-12;2011;2011;11;1;10;28;4;24;4;0;4;;;;;JQevP
503;École doctorale Sciences et technologies de l'information et de mathématiques;STIM;9;Sciences et technologies de l'information et de la communication;2012;2011-12;2011;2011;59;10;49;231;54;177;61;11;50;;;;;JQevP
507;École doctorale Sciences humaines et sociales;;6;Sciences humaines et humanités;2012;2011-12;2011;2011;79;37;42;362;183;179;48;22;26;;;;;3e7VM
513;École doctorale Droit et sciences politiques, économiques et de gestion;DESPEG;7;Sciences de la société;2012;2011-12;2011;2011;107;46;61;444;235;209;52;23;29;;;;;aVHGU
515;École doctorale Complexité du vivant;CdV;5;Biologie, médecine et santé;2012;2011-12;2011;2011;73;44;29;269;163;106;59;32;27;;;;;CbV9s
516;École doctorale Biochimie, biothérapies, biologie moléculaire, infectiologie;B3MI;5;Biologie, médecine et santé;2012;2011-12;2011;2011;57;23;34;257;145;112;60;30;30;;;;;aQTO2
523;École doctorale Sciences pour l'environnement - Gay Lussac;;3;Sciences de la terre et de l'univers, espace;2012;2011-12;2011;2011;5;3;2;32;14;18;6;4;2;;;;;6xD69
525;"École doctorale Lettres, pensée, arts et histoire, ""Civilisation de l'antiquité à nos jours""";LPAH;6;Sciences humaines et humanités;2012;2011-12;2011;2011;58;32;26;280;159;121;37;21;16;;;;;19Rpr
529;École doctorale Cultures et sociétés;CS;6;Sciences humaines et humanités;2012;2011-12;2011;2011;38;24;14;195;103;92;30;17;13;;;;;XU9tb
531;École doctorale Sciences, ingénierie et environnement;SIE;3;Sciences de la terre et de l'univers, espace;2012;2011-12;2011;2011;11;6;5;44;19;25;7;3;4;;;;;b5BYq
531;École doctorale Sciences, ingénierie et environnement;SIE;5;Biologie, médecine et santé;2012;2011-12;2011;2011;2;1;1;4;3;1;4;1;3;;;;;b5BYq
532;École doctorale Mathématiques et sciences et technologies de l'information et de la communication;MSTIC;3;Sciences de la terre et de l'univers, espace;2012;2011-12;2011;2011;0;0;0;12;3;9;4;1;3;;;;;t43KM
532;École doctorale Mathématiques et sciences et technologies de l'information et de la communication;MSTIC;9;Sciences et technologies de l'information et de la communication;2012;2011-12;2011;2011;47;13;34;162;46;116;44;9;35;;;;;t43KM
536;École doctorale Sciences et agrosciences;;2;Physique;2012;2011-12;2011;2011;0;0;0;4;0;4;0;0;0;;;;;pHfqe
536;École doctorale Sciences et agrosciences;;4;Chimie;2012;2011-12;2011;2011;6;5;1;16;12;4;1;1;0;;;;;pHfqe
536;École doctorale Sciences et agrosciences;;5;Biologie, médecine et santé;2012;2011-12;2011;2011;7;2;5;17;9;8;2;1;1;;;;;pHfqe
537;École doctorale Culture et patrimoine;C&P;6;Sciences humaines et humanités;2012;2011-12;2011;2011;25;16;9;108;69;39;18;13;5;;;;;GxI4a
539;École doctorale Sciences et technologies de Versailles;;3;Sciences de la terre et de l'univers, espace;2012;2011-12;2011;2011;0;0;0;3;1;2;1;0;1;;;;;nv3h8
539;École doctorale Sciences et technologies de Versailles;;9;Sciences et technologies de l'information et de la communication;2012;2011-12;2011;2011;15;1;14;75;17;58;16;5;11;;;;;nv3h8
542;École doctorale de sciences de La Réunion;STS;10;Sciences agronomiques et écologiques;2012;2011-12;2011;2011;11;4;7;29;12;17;3;1;2;;;;;2pAql
543;École doctorale de Dauphine;;7;Sciences de la société;2012;2011-12;2011;2011;74;36;38;350;185;165;67;29;38;;;;;u8w6A
546;École doctorale Abbé Grégoire;;7;Sciences de la société;2012;2011-12;2011;2011;30;15;15;32;15;17;2;0;2;;;;;ZSn7q
31;École doctorale Pratiques et théories du sens;;6;Sciences humaines et humanités;2013;2012-13;2012;2012;160;90;70;584;341;243;73;29;44;;;;;1S466
37;École doctorale Sciences physiques pour l'ingénieur et microtechniques;SPIM;8;Sciences pour l'ingénieur;2013;2012-13;2012;2012;75;17;58;279;58;221;67;15;52;;;;;F7G1B
38;École doctorale Langages, espaces, temps, sociétés;;9;Sciences et technologies de l'information et de la communication;2013;2012-13;2012;2012;2;1;1;6;2;4;0;0;0;;;;;pGgDX
40;École doctorale Sciences chimiques;EDSC;4;Chimie;2013;2012-13;2012;2012;81;36;45;270;117;153;78;37;41;;;;;wde3D
52;École doctorale Physique et astrophysique de Lyon;PHAST;3;Sciences de la terre et de l'univers, espace;2013;2012-13;2012;2012;5;3;2;14;6;8;0;0;0;;;;;61XPb
58;École doctorale Langues, littératures, cultures, civilisations;LLCC;6;Sciences humaines et humanités;2013;2012-13;2012;2012;104;59;45;478;273;205;52;33;19;;;;;I9ATR
62;École doctorale Sciences de la vie et de la santé;;5;Biologie, médecine et santé;2013;2012-13;2012;2012;174;97;77;657;352;305;150;78;72;;;;;vZzE7
67;École doctorale Sciences juridiques et politiques;;7;Sciences de la société;2013;2012-13;2012;2012;141;76;65;695;366;329;65;37;28;;;;;qrOj1
71;École doctorale Sciences pour l'ingénieur;;7;Sciences de la société;2013;2012-13;2012;2012;2;0;2;20;7;13;2;0;2;;;;;H6UYp
73;École doctorale Sciences économiques, sociales, de l'aménagement et du management;SESAM;7;Sciences de la société;2013;2012-13;2012;2012;61;30;31;253;117;136;41;21;20;;;;;IQ0Hk
77;École doctorale Informatique, automatique, électronique, électrotechnique, mathématiques;IAEM;1;Mathématiques et leurs interactions;2013;2012-13;2012;2012;12;3;9;46;10;36;16;3;13;;;;;TCHTA
77;École doctorale Informatique, automatique, électronique, électrotechnique, mathématiques;IAEM;6;Sciences humaines et humanités;2013;2012-13;2012;2012;1;0;1;6;1;5;1;1;0;;;;;TCHTA
84;École doctorale Sciences et technologies de l'information et de la communication;STIC;9;Sciences et technologies de l'information et de la communication;2013;2012-13;2012;2012;56;11;45;222;47;175;53;5;48;;;;;9wS2W
86;École doctorale Sociétés, humanités, arts, lettres;LSHS;6;Sciences humaines et humanités;2013;2012-13;2012;2012;77;53;24;336;207;129;34;17;17;;;;;O8E6y
92;École doctorale Vie -  Agro - Santé;;10;Sciences agronomiques et écologiques;2013;2012-13;2012;2012;22;13;9;86;46;40;23;9;14;;;;;RjvXY
98;École doctorale Droit-Normandie;EDDN;7;Sciences de la société;2013;2012-13;2012;2012;36;16;20;155;72;83;14;9;5;;;;;9fYyW
131;École doctorale Langue, littérature, image, civilisations et sciences humaines (domaines francophone et anglophone);LLI;6;Sciences humaines et humanités;2013;2012-13;2012;2012;42;26;16;273;173;100;39;26;13;;;;;a47aW
138;École doctorale Lettres, langues, spectacles;LLS;6;Sciences humaines et humanités;2013;2012-13;2012;2012;68;44;24;290;163;127;43;27;16;;;;;y9O3k
139;École doctorale Connaissance, langage, modélisation;CLM;5;Biologie, médecine et santé;2013;2012-13;2012;2012;1;1;0;5;3;2;0;0;0;;;;;1lxGH
146;École doctorale Galilée;GALILEE;2;Physique;2013;2012-13;2012;2012;6;1;5;42;12;30;9;2;7;;;;;71hqm
156;École doctorale Sciences de la mer;;8;Sciences pour l'ingénieur;2013;2012-13;2012;2012;18;7;11;35;7;28;3;0;3;;;;;EGY9P
162;École doctorale Mécanique, énergétique, génie civil, acoustique;MEGA;1;Mathématiques et leurs interactions;2013;2012-13;2012;2012;0;0;0;0;0;0;1;0;1;;;;;7wCke
162;École doctorale Mécanique, énergétique, génie civil, acoustique;MEGA;2;Physique;2013;2012-13;2012;2012;3;0;3;3;0;3;3;0;3;;;;;7wCke
166;École doctorale Information, structures et systèmes;I2S;2;Physique;2013;2012-13;2012;2012;28;9;19;78;20;58;10;4;6;;;;;2uO68
180;École doctorale Sciences humaines et sociales : cultures, individus, sociétés;SHS;7;Sciences de la société;2013;2012-13;2012;2012;35;20;15;162;103;59;31;20;11;;;;;D2BT3
181;École doctorale Structure, informations, matière et matériaux;Simem;4;Chimie;2013;2012-13;2012;2012;12;7;5;31;15;16;6;2;4;;;;;c1D6f
211;École doctorale Sciences exactes et leurs applications;ED SEA;10;Sciences agronomiques et écologiques;2013;2012-13;2012;2012;2;2;0;11;6;5;3;1;2;;;;;1G1iC
217;École doctorale Mathématiques, sciences et technologies de l'information, informatique;MSTII;1;Mathématiques et leurs interactions;2013;2012-13;2012;2012;34;7;27;129;30;99;32;5;27;;;;;Ehx7v
218;École doctorale Chimie et sciences du vivant;EDCSV;10;Sciences agronomiques et écologiques;2013;2012-13;2012;2012;4;2;2;18;7;11;4;2;2;;;;;8bcJh
222;École doctorale Sciences chimiques;EDSC;5;Biologie, médecine et santé;2013;2012-13;2012;2012;0;0;0;4;2;2;0;0;0;;;;;AdU8Q
250;École doctorale Sciences chimiques;;4;Chimie;2013;2012-13;2012;2012;25;10;15;94;37;57;30;12;18;;;;;O0Fav
251;École doctorale Sciences de l'environnement;;4;Chimie;2013;2012-13;2012;2012;5;2;3;18;8;10;9;5;4;;;;;VR28y
251;École doctorale Sciences de l'environnement;;5;Biologie, médecine et santé;2013;2012-13;2012;2012;1;0;1;17;9;8;1;1;0;;;;;VR28y
251;École doctorale Sciences de l'environnement;;6;Sciences humaines et humanités;2013;2012-13;2012;2012;2;2;0;14;8;6;5;2;3;;;;;VR28y
260;École doctorale pluridisciplinaire;;2;Physique;2013;2012-13;2012;2012;1;1;0;3;1;2;0;0;0;;;;;sCk1f
262;École doctorale Sciences juridiques, politiques, économiques et de gestion;DEG;7;Sciences de la société;2013;2012-13;2012;2012;59;28;31;202;102;100;27;12;15;;;;;H7GyL
263;École doctorale Sciences juridiques, économiques et de gestion;;7;Sciences de la société;2013;2012-13;2012;2012;55;22;33;179;81;98;19;10;9;;;;;1nUr6
269;École doctorale Mathématiques, sciences de l'information et de l'ingénieur;MSII;4;Chimie;2013;2012-13;2012;2012;0;0;0;0;0;0;1;1;0;;;;;5E625
273;École doctorale Biologie et biotechnologie;B2T;5;Biologie, médecine et santé;2013;2012-13;2012;2012;45;29;16;223;144;79;55;36;19;;;;;Wtta6
281;École doctorale Droit public et droit fiscal;;7;Sciences de la société;2013;2012-13;2012;2012;60;24;36;442;190;252;13;4;9;;;;;jr1Nt
285;École doctorale Sciences pratiques;;2;Physique;2013;2012-13;2012;2012;5;2;3;28;12;16;8;5;3;;;;;Jd3t2
285;École doctorale Sciences pratiques;;4;Chimie;2013;2012-13;2012;2012;5;5;0;15;11;4;8;2;6;;;;;Jd3t2
285;École doctorale Sciences pratiques;;5;Biologie, médecine et santé;2013;2012-13;2012;2012;4;4;0;10;7;3;3;2;1;;;;;Jd3t2
306;École doctorale Sciences des procédés, sciences des aliments;;10;Sciences agronomiques et écologiques;2013;2012-13;2012;2012;4;2;2;33;23;10;13;7;6;;;;;adF7W
341;École doctorale Évolution, écosystèmes, microbiologie, modélisation;E2M2;3;Sciences de la terre et de l'univers, espace;2013;2012-13;2012;2012;4;0;4;15;6;9;2;0;2;;;;;J83I0
341;École doctorale Évolution, écosystèmes, microbiologie, modélisation;E2M2;5;Biologie, médecine et santé;2013;2012-13;2012;2012;19;11;8;50;27;23;9;6;3;;;;;J83I0
353;École doctorale Sciences pour l'ingénieur : mécanique, physique, micro et nanoélectronique;;1;Mathématiques et leurs interactions;2013;2012-13;2012;2012;0;0;0;2;0;2;0;0;0;;;;;vk5Kp
354;École doctorale Langues, lettres et arts;LLA;6;Sciences humaines et humanités;2013;2012-13;2012;2012;44;28;16;197;132;65;16;9;7;;;;;RwcSv
355;École doctorale Espaces, cultures, sociétés;;6;Sciences humaines et humanités;2013;2012-13;2012;2012;60;29;31;456;272;184;80;39;41;;;;;2kMf5
364;École doctorale Sciences fondamentales et appliquées;EDSFA;1;Mathématiques et leurs interactions;2013;2012-13;2012;2012;18;6;12;62;15;47;16;6;10;;;;;E483q
364;École doctorale Sciences fondamentales et appliquées;EDSFA;3;Sciences de la terre et de l'univers, espace;2013;2012-13;2012;2012;31;10;21;88;32;56;17;4;13;;;;;E483q
370;École doctorale Lettres, sciences humaines et sociales;LSHS;6;Sciences humaines et humanités;2013;2012-13;2012;2012;36;22;14;233;127;106;29;16;13;;;;;xAXXx
377;École doctorale Environnement et société;;3;Sciences de la terre et de l'univers, espace;2013;2012-13;2012;2012;5;2;3;13;6;7;3;2;1;;;;;ZMG5u
377;École doctorale Environnement et société;;7;Sciences de la société;2013;2012-13;2012;2012;8;5;3;30;9;21;6;2;4;;;;;ZMG5u
387;École doctorale Interdisciplinaire pour le vivant;I-ViV;4;Chimie;2013;2012-13;2012;2012;3;1;2;18;11;7;5;1;4;;;;;06uKM
387;École doctorale Interdisciplinaire pour le vivant;I-ViV;5;Biologie, médecine et santé;2013;2012-13;2012;2012;24;14;10;91;54;37;19;11;8;;;;;06uKM
390;École doctorale Génie des procédés et technologies avancées;;8;Sciences pour l'ingénieur;2013;2012-13;2012;2012;9;2;7;39;13;26;9;3;6;;;;;sK3wm
393;École doctorale Pierre Louis de Santé Publique : Épidémiologie et Sciences de l'information biomédicale;PLSP;9;Sciences et technologies de l'information et de la communication;2013;2012-13;2012;2012;5;2;3;20;6;14;1;1;0;;;;;69445
397;École doctorale Physique et chimie des matériaux;;4;Chimie;2013;2012-13;2012;2012;48;20;28;144;61;83;26;9;17;;;;;WxSt9
400;École doctorale Savoirs scientifiques : épistémologie, histoire des sciences, didactique des disciplines;;2;Physique;2013;2012-13;2012;2012;2;1;1;19;5;14;0;0;0;;;;;nRax3
409;École doctorale Énergie, mécanique, matériaux;EMMA;2;Physique;2013;2012-13;2012;2012;11;3;8;33;9;24;7;1;6;;;;;KXlbK
417;École doctorale Sciences et Ingénierie;S&I;2;Physique;2013;2012-13;2012;2012;1;0;1;5;0;5;2;0;2;;;;;SSBvE
417;École doctorale Sciences et Ingénierie;S&I;4;Chimie;2013;2012-13;2012;2012;6;3;3;29;14;15;5;2;3;;;;;SSBvE
418;École doctorale Cancérologie : Biologie, médecine, santé;;5;Biologie, médecine et santé;2013;2012-13;2012;2012;43;28;15;225;142;83;46;27;19;;;;;gYm19
420;École doctorale Santé publique Paris 11 - Paris 5;;7;Sciences de la société;2013;2012-13;2012;2012;4;2;2;14;11;3;4;3;1;;;;;3BNdi
423;École doctorale Des génomes aux organismes;;2;Physique;2013;2012-13;2012;2012;0;0;0;2;0;2;0;0;0;;;;;VguHK
427;École doctorale Informatique Paris-sud;;9;Sciences et technologies de l'information et de la communication;2013;2012-13;2012;2012;44;8;36;176;48;128;45;15;30;;;;;u0T33
432;École doctorale Sciences des métiers de l'ingénieur;SMI;8;Sciences pour l'ingénieur;2013;2012-13;2012;2012;139;31;108;464;106;358;132;30;102;;;;;nSsHB
434;École doctorale Géographie de Paris - Espaces, sociétés, aménagement;EDGP;6;Sciences humaines et humanités;2013;2012-13;2012;2012;59;30;29;323;176;147;45;22;23;;;;;1FmLX
435;École doctorale Agriculture, alimentation, biologie, environnement et santé;;2;Physique;2013;2012-13;2012;2012;0;0;0;1;0;1;0;0;0;;;;;mC35U
435;École doctorale Agriculture, alimentation, biologie, environnement et santé;;4;Chimie;2013;2012-13;2012;2012;4;1;3;18;9;9;3;2;1;;;;;mC35U
435;École doctorale Agriculture, alimentation, biologie, environnement et santé;;6;Sciences humaines et humanités;2013;2012-13;2012;2012;5;3;2;25;15;10;3;3;0;;;;;mC35U
435;École doctorale Agriculture, alimentation, biologie, environnement et santé;;7;Sciences de la société;2013;2012-13;2012;2012;12;8;4;41;22;19;4;0;4;;;;;mC35U
435;École doctorale Agriculture, alimentation, biologie, environnement et santé;;10;Sciences agronomiques et écologiques;2013;2012-13;2012;2012;35;21;14;127;66;61;23;15;8;;;;;mC35U
436;École doctorale Médicament, toxicologie, chimie, environnement;MTCE;5;Biologie, médecine et santé;2013;2012-13;2012;2012;33;19;14;114;65;49;42;28;14;;;;;dPsg3
447;École doctorale de l'école polytechnique;;3;Sciences de la terre et de l'univers, espace;2013;2012-13;2012;2012;2;1;1;11;5;6;5;4;1;;;;;zgCCh
447;École doctorale de l'école polytechnique;;4;Chimie;2013;2012-13;2012;2012;16;5;11;53;19;34;14;10;4;;;;;zgCCh
447;École doctorale de l'école polytechnique;;8;Sciences pour l'ingénieur;2013;2012-13;2012;2012;18;7;11;86;22;64;24;5;19;;;;;zgCCh
455;École doctorale Économie, Gestion, Information et Communication;EGIC;9;Sciences et technologies de l'information et de la communication;2013;2012-13;2012;2012;14;9;5;76;42;34;21;11;10;;;;;qCOg3
456;École doctorale Sciences du sport, de la motricité et du mouvement humain;;5;Biologie, médecine et santé;2013;2012-13;2012;2012;11;5;6;35;15;20;9;6;3;;;;;GqvEI
463;École doctorale Sciences du mouvement humain;SMH;5;Biologie, médecine et santé;2013;2012-13;2012;2012;13;3;10;66;16;50;11;2;9;;;;;UbtlY
463;École doctorale Sciences du mouvement humain;SMH;6;Sciences humaines et humanités;2013;2012-13;2012;2012;11;7;4;21;10;11;2;0;2;;;;;UbtlY
463;École doctorale Sciences du mouvement humain;SMH;7;Sciences de la société;2013;2012-13;2012;2012;2;0;2;2;0;2;0;0;0;;;;;UbtlY
469;École doctorale du Pacifique;EDP;4;Chimie;2013;2012-13;2012;2012;4;3;1;7;5;2;1;0;1;;;;;t9Z2n
472;École doctorale de l'EPHE;;6;Sciences humaines et humanités;2013;2012-13;2012;2012;97;45;52;548;274;274;50;27;23;;;;;27zK4
474;École doctorale Interdisciplinaire européenne frontières du vivant;FDV;7;Sciences de la société;2013;2012-13;2012;2012;1;0;1;1;0;1;0;0;0;;;;;E727j
475;École doctorale Mathématiques, informatique, télécommunications de Toulouse;MITT;9;Sciences et technologies de l'information et de la communication;2013;2012-13;2012;2012;73;17;56;357;84;273;73;17;56;;;;;xcp2r
477;École doctorale Systèmes intégrés en biologie, agronomie, géosciences, hydrosciences, environnement;SIBAGHE;3;Sciences de la terre et de l'univers, espace;2013;2012-13;2012;2012;28;12;16;91;39;52;28;11;17;;;;;zfN3N
477;École doctorale Systèmes intégrés en biologie, agronomie, géosciences, hydrosciences, environnement;SIBAGHE;5;Biologie, médecine et santé;2013;2012-13;2012;2012;24;12;12;82;43;39;37;20;17;;;;;zfN3N
478;École doctorale Sciences de Gestion;;7;Sciences de la société;2013;2012-13;2012;2012;12;5;7;67;31;36;16;7;9;;;;;q34kB
480;École doctorale Montaigne-humanités;;6;Sciences humaines et humanités;2013;2012-13;2012;2012;119;76;43;615;339;276;84;42;42;;;;;f3SeZ
482;École doctorale Sciences de la matière;SDM;2;Physique;2013;2012-13;2012;2012;35;13;22;126;36;90;32;10;22;;;;;kmeZ4
482;École doctorale Sciences de la matière;SDM;4;Chimie;2013;2012-13;2012;2012;61;28;33;260;108;152;76;34;42;;;;;kmeZ4
483;École doctorale Histoire, géographie, aménagement, urbanisme, archéologie, science politique, sociologie, anthropologie;SCSO;7;Sciences de la société;2013;2012-13;2012;2012;4;1;3;13;6;7;3;1;2;;;;;hc6u4
488;École doctorale Sciences, ingénierie, santé;SIS;4;Chimie;2013;2012-13;2012;2012;8;4;4;21;10;11;6;5;1;;;;;Fy2lK
488;École doctorale Sciences, ingénierie, santé;SIS;8;Sciences pour l'ingénieur;2013;2012-13;2012;2012;19;8;11;103;36;67;29;12;17;;;;;Fy2lK
488;École doctorale Sciences, ingénierie, santé;SIS;9;Sciences et technologies de l'information et de la communication;2013;2012-13;2012;2012;36;9;27;143;37;106;28;8;20;;;;;Fy2lK
489;École doctorale Sciences et ingénierie des systèmes, de l'environnement et des organisations;SISEO;3;Sciences de la terre et de l'univers, espace;2013;2012-13;2012;2012;8;4;4;29;16;13;6;0;6;;;;;6pT77
489;École doctorale Sciences et ingénierie des systèmes, de l'environnement et des organisations;SISEO;7;Sciences de la société;2013;2012-13;2012;2012;9;4;5;41;23;18;9;5;4;;;;;6pT77
491;École doctorale Langages, idées, sociétés, institutions, territoires;LISIT;6;Sciences humaines et humanités;2013;2012-13;2012;2012;77;42;35;352;191;161;40;18;22;;;;;iB25j
494;École doctorale Jean-Henri Lambert;;9;Sciences et technologies de l'information et de la communication;2013;2012-13;2012;2012;13;3;10;38;8;30;4;1;3;;;;;A3m51
495;École doctorale Végétal, environnement, nutrition, agroalimentaire, mer;VENAM;3;Sciences de la terre et de l'univers, espace;2013;2012-13;2012;2012;3;2;1;8;5;3;0;0;0;;;;;HL495
495;École doctorale Végétal, environnement, nutrition, agroalimentaire, mer;VENAM;6;Sciences humaines et humanités;2013;2012-13;2012;2012;0;0;0;1;1;0;0;0;0;;;;;HL495
497;École doctorale Normande de Biologie Intégrative, Santé, Environnement;Ed NBISE;5;Biologie, médecine et santé;2013;2012-13;2012;2012;76;37;39;247;130;117;68;36;32;;;;;0D9Je
497;École doctorale Normande de Biologie Intégrative, Santé, Environnement;Ed NBISE;6;Sciences humaines et humanités;2013;2012-13;2012;2012;0;0;0;3;1;2;0;0;0;;;;;0D9Je
500;École doctorale Matière, molécules, matériaux en Pays de Loire;3MPL;2;Physique;2013;2012-13;2012;2012;31;9;22;96;23;73;22;6;16;;;;;822tM
504;École doctorale Cognition, éducation, interactions;CEI;6;Sciences humaines et humanités;2013;2012-13;2012;2012;51;30;21;206;122;84;24;16;8;;;;;39naT
512;École doctorale Informatique et mathématiques;InfoMaths;9;Sciences et technologies de l'information et de la communication;2013;2012-13;2012;2012;67;17;50;247;69;178;63;22;41;;;;;t86bi
516;École doctorale Biochimie, biothérapies, biologie moléculaire, infectiologie;B3MI;5;Biologie, médecine et santé;2013;2012-13;2012;2012;64;38;26;270;150;120;67;42;25;;;;;aQTO2
518;École doctorale Matière condensée et interfaces;;2;Physique;2013;2012-13;2012;2012;35;13;22;118;35;83;29;11;18;;;;;Sg04R
519;École doctorale Sciences humaines et sociales - Perspectives européennes;SHS-PE;6;Sciences humaines et humanités;2013;2012-13;2012;2012;32;18;14;154;78;76;31;20;11;;;;;2f5qs
520;École doctorale Humanités;;9;Sciences et technologies de l'information et de la communication;2013;2012-13;2012;2012;1;1;0;3;2;1;0;0;0;;;;;rI175
523;École doctorale Sciences pour l'environnement - Gay Lussac;;6;Sciences humaines et humanités;2013;2012-13;2012;2012;3;1;2;5;2;3;2;1;1;;;;;6xD69
529;École doctorale Cultures et sociétés;CS;9;Sciences et technologies de l'information et de la communication;2013;2012-13;2012;2012;6;5;1;20;14;6;5;2;3;;;;;XU9tb
531;École doctorale Sciences, ingénierie et environnement;SIE;5;Biologie, médecine et santé;2013;2012-13;2012;2012;0;0;0;3;3;0;0;0;0;;;;;b5BYq
534;École doctorale Modélisation et instrumentation en physique, énergie, géosciences et environnement;MIPEGE;3;Sciences de la terre et de l'univers, espace;2013;2012-13;2012;2012;16;6;10;60;25;35;15;4;11;;;;;K93eR
534;École doctorale Modélisation et instrumentation en physique, énergie, géosciences et environnement;MIPEGE;4;Chimie;2013;2012-13;2012;2012;4;2;2;8;3;5;5;2;3;;;;;K93eR
535;École doctorale Sciences de la société;SDS;6;Sciences humaines et humanités;2013;2012-13;2012;2012;7;5;2;30;17;13;0;0;0;;;;;iEUOV
536;École doctorale Sciences et agrosciences;;5;Biologie, médecine et santé;2013;2012-13;2012;2012;2;1;1;17;13;4;5;2;3;;;;;pHfqe
540;"École doctorale École transdisciplinaire ""lettres/sciences""";;5;Biologie, médecine et santé;2013;2012-13;2012;2012;3;1;2;6;1;5;0;0;0;;;;;tWWw7
542;École doctorale de sciences de La Réunion;STS;8;Sciences pour l'ingénieur;2013;2012-13;2012;2012;8;2;6;30;9;21;7;4;3;;;;;2pAql
542;École doctorale de sciences de La Réunion;STS;10;Sciences agronomiques et écologiques;2013;2012-13;2012;2012;8;3;5;31;10;21;5;2;3;;;;;2pAql
545;École doctorale Sociétés, politique et santé publique;SP2;7;Sciences de la société;2013;2012-13;2012;2012;22;9;13;126;65;61;15;7;8;;;;;IAKR4
546;École doctorale Abbé Grégoire;;8;Sciences pour l'ingénieur;2013;2012-13;2012;2012;1;0;1;3;0;3;0;0;0;;;;;ZSn7q
547;École doctorale Sciences, Technologie, Santé;EDSTS;3;Sciences de la terre et de l'univers, espace;2013;2012-13;2012;2012;2;0;2;4;1;3;0;0;0;;;;;wEdn2
547;École doctorale Sciences, Technologie, Santé;EDSTS;8;Sciences pour l'ingénieur;2013;2012-13;2012;2012;20;3;17;87;21;66;5;0;5;;;;;wEdn2
547;École doctorale Sciences, Technologie, Santé;EDSTS;10;Sciences agronomiques et écologiques;2013;2012-13;2012;2012;17;9;8;51;27;24;11;5;6;;;;;wEdn2
548;École doctorale Mer et Sciences;;4;Chimie;2013;2012-13;2012;2012;5;2;3;17;8;9;0;0;0;;;;;QX0fS
551;École doctorale Mathématiques, Informatique, Physique Théorique et Ingénierie des Systèmes;MIPTIS;2;Physique;2013;2012-13;2012;2012;0;0;0;3;1;2;1;1;0;;;;;Mpudz
551;École doctorale Mathématiques, Informatique, Physique Théorique et Ingénierie des Systèmes;MIPTIS;5;Biologie, médecine et santé;2013;2012-13;2012;2012;0;0;0;1;0;1;0;0;0;;;;;Mpudz
552;École doctorale Énergie - Matériaux - Sciences de la Terre et de l'Univers;EMTSU;5;Biologie, médecine et santé;2013;2012-13;2012;2012;2;1;1;27;11;16;5;1;4;;;;;NTZhw
554;École doctorale Environnements - Santé;E-S;2;Physique;2013;2012-13;2012;2012;0;0;0;1;1;0;0;0;0;;;;;ElyFU
554;École doctorale Environnements - Santé;E-S;10;Sciences agronomiques et écologiques;2013;2012-13;2012;2012;11;6;5;51;20;31;13;9;4;;;;;ElyFU
558;École doctorale Histoire, Mémoire, Patrimoine, Langage;HMPL;6;Sciences humaines et humanités;2013;2012-13;2012;2012;72;41;31;372;215;157;35;20;15;;;;;uX3jT
6;École doctorale Droit privé;;7;Sciences de la société;2011;2010-11;2010;2010;57;24;33;309;148;161;34;21;13;;;;;UMnW1
8;École doctorale Histoire du droit, philosophie du droit et sociologie du droit;;7;Sciences de la société;2011;2010-11;2010;2010;12;6;6;71;30;41;7;5;2;;;;;pGSed
60;École doctorale Territoires, temps, sociétés et développement;TTSD;7;Sciences de la société;2011;2010-11;2010;2010;16;10;6;89;47;42;15;5;10;;;;;fkIh6
60;École doctorale Territoires, temps, sociétés et développement;TTSD;10;Sciences agronomiques et écologiques;2011;2010-11;2010;2010;2;0;2;3;1;2;0;0;0;;;;;fkIh6
62;École doctorale Sciences de la vie et de la santé;;5;Biologie, médecine et santé;2011;2010-11;2010;2010;188;96;92;727;380;347;129;63;66;;;;;vZzE7
68;École doctorale Littératures, cultures et sciences sociales;;6;Sciences humaines et humanités;2011;2010-11;2010;2010;68;36;32;333;175;158;37;18;19;;;;;NZuM2
71;École doctorale Sciences pour l'ingénieur;;7;Sciences de la société;2011;2010-11;2010;2010;4;3;1;19;8;11;3;1;2;;;;;H6UYp
77;École doctorale Informatique, automatique, électronique, électrotechnique, mathématiques;IAEM;9;Sciences et technologies de l'information et de la communication;2011;2010-11;2010;2010;69;17;52;265;60;205;55;13;42;;;;;TCHTA
78;École doctorale Sociétés, langages, temps, connaissances;STLC;6;Sciences humaines et humanités;2011;2010-11;2010;2010;46;27;19;238;108;130;29;17;12;;;;;vLU3i
86;École doctorale Sociétés, humanités, arts, lettres;LSHS;6;Sciences humaines et humanités;2011;2010-11;2010;2010;92;63;29;305;177;128;29;15;14;;;;;O8E6y
104;École doctorale Sciences de la matière, du rayonnement et de l'environnement;SMRE;3;Sciences de la terre et de l'univers, espace;2011;2010-11;2010;2010;20;8;12;56;29;27;9;4;5;;;;;Q5iFz
104;École doctorale Sciences de la matière, du rayonnement et de l'environnement;SMRE;5;Biologie, médecine et santé;2011;2010-11;2010;2010;1;1;0;3;3;0;1;1;0;;;;;Q5iFz
105;École doctorale Terre, univers, environnement;;3;Sciences de la terre et de l'univers, espace;2011;2010-11;2010;2010;58;25;33;202;79;123;35;11;24;;;;;lcWAf
129;École doctorale Sciences de l'environnement d'Ile de France;SEIF;3;Sciences de la terre et de l'univers, espace;2011;2010-11;2010;2010;58;32;26;202;91;111;52;19;33;;;;;TnAPh
139;École doctorale Connaissance, langage, modélisation;CLM;1;Mathématiques et leurs interactions;2011;2010-11;2010;2010;0;0;0;5;1;4;0;0;0;;;;;1lxGH
139;École doctorale Connaissance, langage, modélisation;CLM;8;Sciences pour l'ingénieur;2011;2010-11;2010;2010;9;4;5;33;6;27;8;1;7;;;;;1lxGH
145;École doctorale Sciences du végétal : du gène à l'écosystème;;5;Biologie, médecine et santé;2011;2010-11;2010;2010;35;22;13;144;78;66;32;16;16;;;;;ubDmM
146;École doctorale Galilée;GALILEE;4;Chimie;2011;2010-11;2010;2010;4;3;1;24;14;10;4;2;2;;;;;71hqm
146;École doctorale Galilée;GALILEE;9;Sciences et technologies de l'information et de la communication;2011;2010-11;2010;2010;23;6;17;68;24;44;9;1;8;;;;;71hqm
149;École doctorale Carnot;;1;Mathématiques et leurs interactions;2011;2010-11;2010;2010;5;1;4;29;8;21;6;1;5;;;;;zuThw
154;École doctorale Sciences de la vie et de la santé;SVS;5;Biologie, médecine et santé;2011;2010-11;2010;2010;110;57;53;316;163;153;80;31;49;;;;;hLn36
156;École doctorale Sciences de la mer;;8;Sciences pour l'ingénieur;2011;2010-11;2010;2010;8;1;7;22;4;18;1;0;1;;;;;EGY9P
160;École doctorale Électronique, électrotechnique, automatique;EEA;9;Sciences et technologies de l'information et de la communication;2011;2010-11;2010;2010;33;7;26;126;27;99;28;4;24;;;;;EgfMQ
177;École doctorale Sciences et technologies de l'université d'Orléans;;3;Sciences de la terre et de l'univers, espace;2011;2010-11;2010;2010;10;3;7;36;14;22;10;4;6;;;;;JI65m
177;École doctorale Sciences et technologies de l'université d'Orléans;;9;Sciences et technologies de l'information et de la communication;2011;2010-11;2010;2010;16;1;15;52;5;47;14;2;12;;;;;JI65m
181;École doctorale Structure, informations, matière et matériaux;Simem;1;Mathématiques et leurs interactions;2011;2010-11;2010;2010;5;0;5;17;3;14;1;1;0;;;;;c1D6f
209;École doctorale Sciences physiques et de L'ingénieur;SPI;2;Physique;2011;2010-11;2010;2010;18;4;14;71;19;52;21;6;15;;;;;tZcIZ
211;École doctorale Sciences exactes et leurs applications;ED SEA;4;Chimie;2011;2010-11;2010;2010;19;10;9;50;23;27;12;7;5;;;;;1G1iC
216;École doctorale Ingénierie pour la santé, la cognition, l'environnement;EDISCE;9;Sciences et technologies de l'information et de la communication;2011;2010-11;2010;2010;4;2;2;30;14;16;8;3;5;;;;;fPs1t
224;École doctorale Cognition, langage, interaction;;9;Sciences et technologies de l'information et de la communication;2011;2010-11;2010;2010;2;1;1;15;1;14;4;0;4;;;;;7v43e
227;École doctorale Sciences de la nature et de l'homme;;4;Chimie;2011;2010-11;2010;2010;0;0;0;1;1;0;1;0;1;;;;;xiDA5
227;École doctorale Sciences de la nature et de l'homme;;5;Biologie, médecine et santé;2011;2010-11;2010;2010;22;12;10;83;46;37;21;10;11;;;;;xiDA5
227;École doctorale Sciences de la nature et de l'homme;;7;Sciences de la société;2011;2010-11;2010;2010;0;0;0;1;0;1;1;0;1;;;;;xiDA5
242;École doctorale Économie - Gestion - Normandie;;7;Sciences de la société;2011;2010-11;2010;2010;19;9;10;57;20;37;14;3;11;;;;;z35ku
242;École doctorale Économie - Gestion - Normandie;;9;Sciences et technologies de l'information et de la communication;2011;2010-11;2010;2010;4;3;1;8;4;4;2;2;0;;;;;z35ku
251;École doctorale Sciences de l'environnement;;4;Chimie;2011;2010-11;2010;2010;3;1;2;13;7;6;3;2;1;;;;;VR28y
260;École doctorale pluridisciplinaire;;2;Physique;2011;2010-11;2010;2010;1;0;1;1;0;1;1;1;0;;;;;sCk1f
260;École doctorale pluridisciplinaire;;3;Sciences de la terre et de l'univers, espace;2011;2010-11;2010;2010;4;2;2;12;6;6;1;0;1;;;;;sCk1f
266;École doctorale Biologie, santé, environnement;BIOSE;5;Biologie, médecine et santé;2011;2010-11;2010;2010;41;21;20;186;107;79;31;16;15;;;;;386V9
269;École doctorale Mathématiques, sciences de l'information et de l'ingénieur;MSII;2;Physique;2011;2010-11;2010;2010;0;0;0;7;3;4;0;0;0;;;;;5E625
269;École doctorale Mathématiques, sciences de l'information et de l'ingénieur;MSII;9;Sciences et technologies de l'information et de la communication;2011;2010-11;2010;2010;27;3;24;92;13;79;28;2;26;;;;;5E625
270;École doctorale Théologie et sciences religieuses;;7;Sciences de la société;2011;2010-11;2010;2010;1;0;1;12;3;9;0;0;0;;;;;BRKC1
275;École doctorale Sciences de gestion;EDSG;7;Sciences de la société;2011;2010-11;2010;2010;18;8;10;102;61;41;17;10;7;;;;;6QC4I
281;École doctorale Droit public et droit fiscal;;7;Sciences de la société;2011;2010-11;2010;2010;49;20;29;406;181;225;14;1;13;;;;;jr1Nt
282;École doctorale Droit privé;;7;Sciences de la société;2011;2010-11;2010;2010;100;47;53;339;177;162;24;15;9;;;;;Gz5rp
285;École doctorale Sciences pratiques;;2;Physique;2011;2010-11;2010;2010;10;6;4;27;13;14;6;2;4;;;;;Jd3t2
285;École doctorale Sciences pratiques;;6;Sciences humaines et humanités;2011;2010-11;2010;2010;9;5;4;46;27;19;2;0;2;;;;;Jd3t2
287;École doctorale Sciences pour l'ingénieur;;1;Mathématiques et leurs interactions;2011;2010-11;2010;2010;11;6;5;59;20;39;10;3;7;;;;;48Q1j
287;École doctorale Sciences pour l'ingénieur;;8;Sciences pour l'ingénieur;2011;2010-11;2010;2010;41;17;24;194;68;126;31;6;25;;;;;48Q1j
304;École doctorale Sciences et environnements;;7;Sciences de la société;2011;2010-11;2010;2010;6;4;2;13;9;4;4;4;0;;;;;2ywZn
305;École doctorale Énergie et environnement;E2;5;Biologie, médecine et santé;2011;2010-11;2010;2010;3;1;2;17;6;11;8;3;5;;;;;Kbt8I
305;École doctorale Énergie et environnement;E2;8;Sciences pour l'ingénieur;2011;2010-11;2010;2010;12;5;7;47;7;40;11;1;10;;;;;Kbt8I
306;École doctorale Sciences des procédés, sciences des aliments;;1;Mathématiques et leurs interactions;2011;2010-11;2010;2010;0;0;0;1;0;1;1;0;1;;;;;adF7W
328;École doctorale Arts, lettres, langues, philosophie et communication;ALLPH@;6;Sciences humaines et humanités;2011;2010-11;2010;2010;69;41;28;303;169;134;29;20;9;;;;;xLxMh
351;École doctorale Sciences physiques, mathématiques et de l'information pour l'ingénieur;SPMII;8;Sciences pour l'ingénieur;2011;2010-11;2010;2010;38;9;29;147;34;113;29;6;23;;;;;rY4EP
352;École doctorale Physique et sciences de la matière;;2;Physique;2011;2010-11;2010;2010;71;16;55;256;71;185;64;16;48;;;;;fb5YC
353;École doctorale Sciences pour l'ingénieur : mécanique, physique, micro et nanoélectronique;;2;Physique;2011;2010-11;2010;2010;4;1;3;14;2;12;3;0;3;;;;;vk5Kp
358;École doctorale Sciences, technologies, santé;;1;Mathématiques et leurs interactions;2011;2010-11;2010;2010;2;0;2;4;0;4;1;0;1;;;;;OZA3U
358;École doctorale Sciences, technologies, santé;;4;Chimie;2011;2010-11;2010;2010;13;11;2;45;26;19;10;2;8;;;;;OZA3U
358;École doctorale Sciences, technologies, santé;;9;Sciences et technologies de l'information et de la communication;2011;2010-11;2010;2010;11;2;9;47;10;37;10;1;9;;;;;OZA3U
361;École doctorale Sciences et Technologies;ED ST;6;Sciences humaines et humanités;2011;2010-11;2010;2010;3;1;2;17;6;11;1;0;1;;;;;cOUmL
361;École doctorale Sciences et Technologies;ED ST;8;Sciences pour l'ingénieur;2011;2010-11;2010;2010;9;1;8;35;8;27;11;2;9;;;;;cOUmL
361;École doctorale Sciences et Technologies;ED ST;9;Sciences et technologies de l'information et de la communication;2011;2010-11;2010;2010;37;15;22;118;37;81;18;4;14;;;;;cOUmL
368;École doctorale Sciences et santé;;8;Sciences pour l'ingénieur;2011;2010-11;2010;2010;5;3;2;14;6;8;4;0;4;;;;;4L0a1
368;École doctorale Sciences et santé;;10;Sciences agronomiques et écologiques;2011;2010-11;2010;2010;4;0;4;18;8;10;9;7;2;;;;;4L0a1
369;École doctorale Homme, environnement, santé;;3;Sciences de la terre et de l'univers, espace;2011;2010-11;2010;2010;2;0;2;5;0;5;2;0;2;;;;;uZ8W7
369;École doctorale Homme, environnement, santé;;10;Sciences agronomiques et écologiques;2011;2010-11;2010;2010;14;7;7;42;25;17;13;7;6;;;;;uZ8W7
371;École doctorale Louis Pasteur;;3;Sciences de la terre et de l'univers, espace;2011;2010-11;2010;2010;2;0;2;2;0;2;0;0;0;;;;;2tr4F
377;École doctorale Environnement et société;;3;Sciences de la terre et de l'univers, espace;2011;2010-11;2010;2010;0;0;0;1;0;1;1;0;1;;;;;ZMG5u
377;École doctorale Environnement et société;;5;Biologie, médecine et santé;2011;2010-11;2010;2010;4;2;2;8;5;3;2;2;0;;;;;ZMG5u
377;École doctorale Environnement et société;;9;Sciences et technologies de l'information et de la communication;2011;2010-11;2010;2010;0;0;0;5;1;4;0;0;0;;;;;ZMG5u
395;École doctorale Milieux, cultures et sociétés du passé et du présent;MCSPP;6;Sciences humaines et humanités;2011;2010-11;2010;2010;93;55;38;471;308;163;42;21;21;;;;;2quEb
396;École doctorale Économie, organisations, société;EOS;1;Mathématiques et leurs interactions;2011;2010-11;2010;2010;0;0;0;3;1;2;1;0;1;;;;;Es5e7
397;École doctorale Physique et chimie des matériaux;;2;Physique;2011;2010-11;2010;2010;26;5;21;87;32;55;16;8;8;;;;;WxSt9
398;École doctorale Géosciences, ressources naturelles et environnement;GRNE;3;Sciences de la terre et de l'univers, espace;2011;2010-11;2010;2010;41;13;28;152;59;93;45;17;28;;;;;Zi4Zf
400;École doctorale Savoirs scientifiques : épistémologie, histoire des sciences, didactique des disciplines;;3;Sciences de la terre et de l'univers, espace;2011;2010-11;2010;2010;0;0;0;1;0;1;1;0;1;;;;;nRax3
409;École doctorale Énergie, mécanique, matériaux;EMMA;2;Physique;2011;2010-11;2010;2010;8;3;5;31;7;24;8;3;5;;;;;KXlbK
410;École doctorale Sciences et ingénierie des ressources, procédés, produits, environnement;RP2E;3;Sciences de la terre et de l'univers, espace;2011;2010-11;2010;2010;19;5;14;84;36;48;18;10;8;;;;;Q5fxV
411;École doctorale Humanités nouvelles : Fernand Braudel;;6;Sciences humaines et humanités;2011;2010-11;2010;2010;43;24;19;136;70;66;21;9;12;;;;;l2rFh
415;"École doctorale Interdisciplinaire ""Arts et métiers""";;2;Physique;2011;2010-11;2010;2010;4;1;3;4;1;3;0;0;0;;;;;B3z99
417;École doctorale Sciences et Ingénierie;S&I;2;Physique;2011;2010-11;2010;2010;2;1;1;10;3;7;2;0;2;;;;;SSBvE
417;École doctorale Sciences et Ingénierie;S&I;5;Biologie, médecine et santé;2011;2010-11;2010;2010;3;2;1;8;4;4;2;1;1;;;;;SSBvE
418;École doctorale Cancérologie : Biologie, médecine, santé;;5;Biologie, médecine et santé;2011;2010-11;2010;2010;53;35;18;208;130;78;36;24;12;;;;;gYm19
423;École doctorale Des génomes aux organismes;;5;Biologie, médecine et santé;2011;2010-11;2010;2010;36;14;22;142;66;76;36;16;20;;;;;VguHK
425;École doctorale Innovation thérapeutique : du fondamental à l'appliqué;;4;Chimie;2011;2010-11;2010;2010;6;2;4;32;14;18;13;11;2;;;;;DkgNy
435;École doctorale Agriculture, alimentation, biologie, environnement et santé;;3;Sciences de la terre et de l'univers, espace;2011;2010-11;2010;2010;1;0;1;19;8;11;2;1;1;;;;;mC35U
435;École doctorale Agriculture, alimentation, biologie, environnement et santé;;4;Chimie;2011;2010-11;2010;2010;3;1;2;17;12;5;1;0;1;;;;;mC35U
435;École doctorale Agriculture, alimentation, biologie, environnement et santé;;8;Sciences pour l'ingénieur;2011;2010-11;2010;2010;9;6;3;38;22;16;9;8;1;;;;;mC35U
435;École doctorale Agriculture, alimentation, biologie, environnement et santé;;10;Sciences agronomiques et écologiques;2011;2010-11;2010;2010;31;19;12;115;57;58;36;18;18;;;;;mC35U
441;École doctorale Histoire de l'art;;6;Sciences humaines et humanités;2011;2010-11;2010;2010;33;19;14;283;208;75;41;33;8;;;;;d5W3U
447;École doctorale de l'école polytechnique;;8;Sciences pour l'ingénieur;2011;2010-11;2010;2010;25;4;21;75;13;62;10;3;7;;;;;zgCCh
447;École doctorale de l'école polytechnique;;9;Sciences et technologies de l'information et de la communication;2011;2010-11;2010;2010;14;5;9;58;12;46;10;2;8;;;;;zgCCh
450;École doctorale Recherches en psychanalyse et psychopathologie;PSY²;6;Sciences humaines et humanités;2011;2010-11;2010;2010;71;51;20;281;204;77;20;15;5;;;;;8jI3f
454;École doctorale Sciences de l'homme, du politique et du territoire;SHPT;7;Sciences de la société;2011;2010-11;2010;2010;20;11;9;123;57;66;11;7;4;;;;;Opv31
455;École doctorale Économie, Gestion, Information et Communication;EGIC;9;Sciences et technologies de l'information et de la communication;2011;2010-11;2010;2010;32;18;14;108;62;46;15;12;3;;;;;qCOg3
463;École doctorale Sciences du mouvement humain;SMH;5;Biologie, médecine et santé;2011;2010-11;2010;2010;21;6;15;83;21;62;18;4;14;;;;;UbtlY
463;École doctorale Sciences du mouvement humain;SMH;6;Sciences humaines et humanités;2011;2010-11;2010;2010;2;0;2;10;4;6;2;2;0;;;;;UbtlY
467;École doctorale Aéronautique, astronautique;AA;4;Chimie;2011;2010-11;2010;2010;1;0;1;1;0;1;0;0;0;;;;;U7l45
467;École doctorale Aéronautique, astronautique;AA;7;Sciences de la société;2011;2010-11;2010;2010;0;0;0;6;3;3;1;1;0;;;;;U7l45
469;École doctorale du Pacifique;EDP;9;Sciences et technologies de l'information et de la communication;2011;2010-11;2010;2010;0;0;0;2;0;2;0;0;0;;;;;t9Z2n
472;École doctorale de l'EPHE;;10;Sciences agronomiques et écologiques;2011;2010-11;2010;2010;13;9;4;51;20;31;8;3;5;;;;;27zK4
474;École doctorale Interdisciplinaire européenne frontières du vivant;FDV;1;Mathématiques et leurs interactions;2011;2010-11;2010;2010;0;0;0;2;0;2;1;0;1;;;;;E727j
476;École doctorale Neurosciences et cognition;NSCO;6;Sciences humaines et humanités;2011;2010-11;2010;2010;7;5;2;38;24;14;11;8;3;;;;;B1H0x
477;École doctorale Systèmes intégrés en biologie, agronomie, géosciences, hydrosciences, environnement;SIBAGHE;3;Sciences de la terre et de l'univers, espace;2011;2010-11;2010;2010;21;9;12;85;39;46;22;8;14;;;;;zfN3N
477;École doctorale Systèmes intégrés en biologie, agronomie, géosciences, hydrosciences, environnement;SIBAGHE;10;Sciences agronomiques et écologiques;2011;2010-11;2010;2010;69;35;34;216;111;105;33;16;17;;;;;zfN3N
482;École doctorale Sciences de la matière;SDM;2;Physique;2011;2010-11;2010;2010;39;10;29;89;28;61;15;4;11;;;;;kmeZ4
483;École doctorale Histoire, géographie, aménagement, urbanisme, archéologie, science politique, sociologie, anthropologie;SCSO;6;Sciences humaines et humanités;2011;2010-11;2010;2010;16;4;12;64;23;41;4;2;2;;;;;hc6u4
488;École doctorale Sciences, ingénierie, santé;SIS;1;Mathématiques et leurs interactions;2011;2010-11;2010;2010;1;0;1;12;3;9;2;0;2;;;;;Fy2lK
488;École doctorale Sciences, ingénierie, santé;SIS;4;Chimie;2011;2010-11;2010;2010;2;0;2;17;7;10;1;1;0;;;;;Fy2lK
491;École doctorale Langages, idées, sociétés, institutions, territoires;LISIT;6;Sciences humaines et humanités;2011;2010-11;2010;2010;77;40;37;324;168;156;20;8;12;;;;;iB25j
497;École doctorale Normande de Biologie Intégrative, Santé, Environnement;Ed NBISE;10;Sciences agronomiques et écologiques;2011;2010-11;2010;2010;4;1;3;20;10;10;2;1;1;;;;;0D9Je
500;École doctorale Matière, molécules, matériaux en Pays de Loire;3MPL;4;Chimie;2011;2010-11;2010;2010;33;15;18;119;48;71;27;13;14;;;;;822tM
501;École doctorale Droit, économie-gestion, sociétés, territoires;;6;Sciences humaines et humanités;2011;2010-11;2010;2010;12;6;6;77;33;44;12;4;8;;;;;wE7WM
503;École doctorale Sciences et technologies de l'information et de mathématiques;STIM;8;Sciences pour l'ingénieur;2011;2010-11;2010;2010;5;0;5;19;4;15;4;1;3;;;;;JQevP
505;École doctorale Sciences de l'homme, des organisations et de la société;SHOS;6;Sciences humaines et humanités;2011;2010-11;2010;2010;4;2;2;17;5;12;5;2;3;;;;;qts78
508;École doctorale Normande de chimie;EDNC;4;Chimie;2011;2010-11;2010;2010;48;24;24;158;78;80;23;12;11;;;;;E52OO
509;École doctorale Civilisations et sociétés euro-méditerranéennes et comparées;;6;Sciences humaines et humanités;2011;2010-11;2010;2010;20;12;8;64;36;28;11;4;7;;;;;9tbyG
512;École doctorale Informatique et mathématiques;InfoMaths;9;Sciences et technologies de l'information et de la communication;2011;2010-11;2010;2010;55;17;38;296;78;218;61;17;44;;;;;t86bi
523;École doctorale Sciences pour l'environnement - Gay Lussac;;4;Chimie;2011;2010-11;2010;2010;27;13;14;114;48;66;43;18;25;;;;;6xD69
523;École doctorale Sciences pour l'environnement - Gay Lussac;;5;Biologie, médecine et santé;2011;2010-11;2010;2010;2;1;1;8;4;4;3;2;1;;;;;6xD69
526;École doctorale Sociétés et organisations;SORG;6;Sciences humaines et humanités;2011;2010-11;2010;2010;32;15;17;107;52;55;16;9;7;;;;;5F3Fd
526;École doctorale Sociétés et organisations;SORG;7;Sciences de la société;2011;2010-11;2010;2010;9;4;5;46;17;29;4;2;2;;;;;5F3Fd
528;École doctorale Ville, transports et territoires;VTT;6;Sciences humaines et humanités;2011;2010-11;2010;2010;50;27;23;226;132;94;25;13;12;;;;;68zCc
528;École doctorale Ville, transports et territoires;VTT;8;Sciences pour l'ingénieur;2011;2010-11;2010;2010;1;0;1;1;0;1;3;0;3;;;;;68zCc
531;École doctorale Sciences, ingénierie et environnement;SIE;2;Physique;2011;2010-11;2010;2010;7;3;4;26;6;20;4;2;2;;;;;b5BYq
532;École doctorale Mathématiques et sciences et technologies de l'information et de la communication;MSTIC;1;Mathématiques et leurs interactions;2011;2010-11;2010;2010;19;4;15;60;15;45;14;3;11;;;;;t43KM
534;École doctorale Modélisation et instrumentation en physique, énergie, géosciences et environnement;MIPEGE;2;Physique;2011;2010-11;2010;2010;20;3;17;77;23;54;19;7;12;;;;;K93eR
534;École doctorale Modélisation et instrumentation en physique, énergie, géosciences et environnement;MIPEGE;4;Chimie;2011;2010-11;2010;2010;2;0;2;15;5;10;7;4;3;;;;;K93eR
536;École doctorale Sciences et agrosciences;;8;Sciences pour l'ingénieur;2011;2010-11;2010;2010;0;0;0;1;0;1;0;0;0;;;;;pHfqe
536;École doctorale Sciences et agrosciences;;9;Sciences et technologies de l'information et de la communication;2011;2010-11;2010;2010;5;0;5;31;2;29;5;0;5;;;;;pHfqe
538;École doctorale Culture, régulation, institutions et territoire;CRIT;6;Sciences humaines et humanités;2011;2010-11;2010;2010;28;13;15;135;74;61;13;6;7;;;;;8T505
541;École doctorale de sciences humaines et sociales de La Réunion;SHS;6;Sciences humaines et humanités;2011;2010-11;2010;2010;32;20;12;187;110;77;21;14;7;;;;;21SpE
19;École doctorale Littératures françaises et comparée;;6;Sciences humaines et humanités;2024;2023-24;2023;2023;36;24;12;244;164;80;14;10;4;1;1;3;9;13M43
34;École doctorale Matériaux;;4;Chimie;2024;2023-24;2023;2023;0;0;0;29;16;13;5;2;3;1;3;1;0;1Iufh
37;École doctorale Sciences physiques pour l'ingénieur et microtechniques;SPIM;8;Sciences pour l'ingénieur;2024;2023-24;2023;2023;48;16;32;175;60;115;48;12;36;24;18;6;0;F7G1B
62;École doctorale Sciences de la vie et de la santé;;6;Sciences humaines et humanités;2024;2023-24;2023;2023;5;3;2;11;6;5;2;2;0;0;1;1;0;vZzE7
62;École doctorale Sciences de la vie et de la santé;;7;Sciences de la société;2024;2023-24;2023;2023;0;0;0;2;1;1;0;0;0;0;0;0;0;vZzE7
62;École doctorale Sciences de la vie et de la santé;;9;Sciences et technologies de l'information et de la communication;2024;2023-24;2023;2023;1;1;0;1;1;0;1;0;1;0;1;0;0;vZzE7
70;École doctorale Sciences pour l'ingénieur;EDSPI;9;Sciences et technologies de l'information et de la communication;2024;2023-24;2023;2023;5;2;3;32;9;23;13;4;9;2;10;1;0;G413P
71;École doctorale Sciences pour l'ingénieur;;4;Chimie;2024;2023-24;2023;2023;3;2;1;8;6;2;2;0;2;1;1;0;0;H6UYp
73;École doctorale Sciences économiques, sociales, de l'aménagement et du management;SESAM;7;Sciences de la société;2024;2023-24;2023;2023;24;12;12;143;71;72;26;12;14;4;5;7;10;IQ0Hk
78;École doctorale Sociétés, langages, temps, connaissances;STLC;6;Sciences humaines et humanités;2024;2023-24;2023;2023;34;24;10;178;107;71;25;17;8;4;5;10;6;vLU3i
86;École doctorale Sociétés, humanités, arts, lettres;LSHS;7;Sciences de la société;2024;2023-24;2023;2023;8;5;3;28;16;12;8;5;3;2;1;1;4;O8E6y
88;École doctorale Droit et science politique;DSP;7;Sciences de la société;2024;2023-24;2023;2023;17;7;10;103;47;56;18;11;7;0;0;3;15;elnAJ
104;École doctorale Sciences de la matière, du rayonnement et de l'environnement;SMRE;8;Sciences pour l'ingénieur;2024;2023-24;2023;2023;3;0;3;14;3;11;5;1;4;1;4;0;0;Q5iFz
112;École doctorale Archéologie;;6;Sciences humaines et humanités;2024;2023-24;2023;2023;31;20;11;172;108;64;24;14;10;1;2;4;17;EvU7R
129;École doctorale Sciences de l'environnement d'Ile de France;SEIF;2;Physique;2024;2023-24;2023;2023;0;0;0;1;1;0;2;1;1;0;2;0;0;TnAPh
130;École doctorale Informatique, télécommunications et électronique de Paris;EDITE;5;Biologie, médecine et santé;2024;2023-24;2023;2023;0;0;0;4;1;3;2;1;1;1;1;0;0;O5ysj
139;École doctorale Connaissance, langage, modélisation;CLM;1;Mathématiques et leurs interactions;2024;2023-24;2023;2023;3;1;2;5;2;3;3;1;2;1;1;1;0;1lxGH
160;École doctorale Électronique, électrotechnique, automatique;EEA;9;Sciences et technologies de l'information et de la communication;2024;2023-24;2023;2023;8;2;6;41;8;33;17;4;13;14;2;1;0;EgfMQ
173;École doctorale Sciences de l'univers, de l'environnement et de l'espace;SDU2E;4;Chimie;2024;2023-24;2023;2023;0;0;0;1;0;1;0;0;0;0;0;0;0;R0Z9c
173;École doctorale Sciences de l'univers, de l'environnement et de l'espace;SDU2E;10;Sciences agronomiques et écologiques;2024;2023-24;2023;2023;6;3;3;18;10;8;12;5;7;4;6;2;0;R0Z9c
178;École doctorale Sciences fondamentales;;1;Mathématiques et leurs interactions;2024;2023-24;2023;2023;5;1;4;19;4;15;6;2;4;3;1;2;0;1AiR7
182;École doctorale Physique et chimie-physique;;2;Physique;2024;2023-24;2023;2023;30;7;23;114;30;84;28;8;20;16;10;2;0;3My6I
182;École doctorale Physique et chimie-physique;;5;Biologie, médecine et santé;2024;2023-24;2023;2023;1;1;0;8;6;2;1;1;0;1;0;0;0;3My6I
184;École doctorale Mathématiques et informatique de Marseille;;9;Sciences et technologies de l'information et de la communication;2024;2023-24;2023;2023;16;6;10;61;22;39;15;3;12;6;5;3;1;DDObG
188;École doctorale Histoire moderne et contemporaine;;6;Sciences humaines et humanités;2024;2023-24;2023;2023;25;11;14;135;57;78;27;10;17;1;4;10;12;RSZ7F
205;École doctorale Interdisciplinaire Sciences-Santé;EDISS;8;Sciences pour l'ingénieur;2024;2023-24;2023;2023;0;0;0;0;0;0;1;1;0;0;1;0;0;69W38
211;École doctorale Sciences exactes et leurs applications;ED SEA;10;Sciences agronomiques et écologiques;2024;2023-24;2023;2023;7;7;0;25;17;8;12;5;7;6;5;1;0;1G1iC
216;École doctorale Ingénierie pour la santé, la cognition, l'environnement;EDISCE;6;Sciences humaines et humanités;2024;2023-24;2023;2023;1;1;0;6;6;0;1;1;0;0;1;0;0;fPs1t
216;École doctorale Ingénierie pour la santé, la cognition, l'environnement;EDISCE;8;Sciences pour l'ingénieur;2024;2023-24;2023;2023;0;0;0;1;0;1;0;0;0;0;0;0;0;fPs1t
222;École doctorale Sciences chimiques;EDSC;4;Chimie;2024;2023-24;2023;2023;81;40;41;271;119;152;92;41;51;56;36;0;0;AdU8Q
224;École doctorale Cognition, langage, interaction;;6;Sciences humaines et humanités;2024;2023-24;2023;2023;40;32;8;144;96;48;15;9;6;1;3;8;3;7v43e
227;École doctorale Sciences de la nature et de l'homme;;6;Sciences humaines et humanités;2024;2023-24;2023;2023;11;7;4;44;32;12;4;3;1;1;1;2;0;xiDA5
227;École doctorale Sciences de la nature et de l'homme;;10;Sciences agronomiques et écologiques;2024;2023-24;2023;2023;17;6;11;55;27;28;18;6;12;12;6;0;0;xiDA5
245;École doctorale Sciences économiques, juridiques, politiques et de gestion;;7;Sciences de la société;2024;2023-24;2023;2023;19;7;12;150;67;83;27;11;16;3;3;15;6;ShLUg
265;École doctorale Langues, littératures et sociétés du monde;;6;Sciences humaines et humanités;2024;2023-24;2023;2023;49;21;28;296;145;151;22;16;6;0;2;9;11;4YWGW
267;École doctorale Arts et médias;;6;Sciences humaines et humanités;2024;2023-24;2023;2023;27;19;8;141;86;55;31;18;13;1;3;6;21;eCF5C
267;École doctorale Arts et médias;;7;Sciences de la société;2024;2023-24;2023;2023;0;0;0;2;0;2;0;0;0;0;0;0;0;eCF5C
269;École doctorale Mathématiques, sciences de l'information et de l'ingénieur;MSII;2;Physique;2024;2023-24;2023;2023;2;1;1;7;2;5;2;1;1;1;1;0;0;5E625
275;École doctorale Sciences de gestion;EDSG;7;Sciences de la société;2024;2023-24;2023;2023;14;8;6;53;24;29;12;7;5;2;5;5;0;6QC4I
304;École doctorale Sciences et environnements;;3;Sciences de la terre et de l'univers, espace;2024;2023-24;2023;2023;9;3;6;26;12;14;4;2;2;0;4;0;0;2ywZn
304;École doctorale Sciences et environnements;;10;Sciences agronomiques et écologiques;2024;2023-24;2023;2023;19;12;7;50;32;18;16;8;8;11;5;0;0;2ywZn
305;École doctorale Énergie et environnement;E2;1;Mathématiques et leurs interactions;2024;2023-24;2023;2023;1;0;1;4;2;2;0;0;0;0;0;0;0;Kbt8I
305;École doctorale Énergie et environnement;E2;8;Sciences pour l'ingénieur;2024;2023-24;2023;2023;6;2;4;28;5;23;9;1;8;4;5;0;0;Kbt8I
323;École doctorale Génie électrique, électronique et télécommunications;GEET;8;Sciences pour l'ingénieur;2024;2023-24;2023;2023;36;18;18;167;45;122;38;6;32;15;15;5;3;arcz6
326;École doctorale Comportement, langage, éducation, socialisation, cognition;CLESCO;8;Sciences pour l'ingénieur;2024;2023-24;2023;2023;0;0;0;1;0;1;0;0;0;0;0;0;0;nWIlG
327;École doctorale Temps, espaces, sociétés, cultures;TESC;5;Biologie, médecine et santé;2024;2023-24;2023;2023;2;1;1;5;3;2;1;1;0;0;0;0;1;IjgiJ
327;École doctorale Temps, espaces, sociétés, cultures;TESC;6;Sciences humaines et humanités;2024;2023-24;2023;2023;35;24;11;255;163;92;18;7;11;2;2;2;12;IjgiJ
352;École doctorale Physique et sciences de la matière;;2;Physique;2024;2023-24;2023;2023;89;27;62;266;70;196;91;34;57;58;31;2;0;fb5YC
353;École doctorale Sciences pour l'ingénieur : mécanique, physique, micro et nanoélectronique;;8;Sciences pour l'ingénieur;2024;2023-24;2023;2023;63;19;44;205;58;147;62;11;51;34;27;1;0;vk5Kp
354;École doctorale Langues, lettres et arts;LLA;6;Sciences humaines et humanités;2024;2023-24;2023;2023;41;27;14;190;128;62;34;20;14;2;3;10;19;RwcSv
361;École doctorale Sciences et Technologies;ED ST;9;Sciences et technologies de l'information et de la communication;2024;2023-24;2023;2023;20;8;12;69;26;43;25;12;13;13;10;2;0;cOUmL
364;École doctorale Sciences fondamentales et appliquées;EDSFA;10;Sciences agronomiques et écologiques;2024;2023-24;2023;2023;2;0;2;8;3;5;2;1;1;0;2;0;0;E483q
370;École doctorale Lettres, sciences humaines et sociales;LSHS;6;Sciences humaines et humanités;2024;2023-24;2023;2023;37;25;12;221;125;96;15;9;6;0;7;5;3;xAXXx
370;École doctorale Lettres, sciences humaines et sociales;LSHS;7;Sciences de la société;2024;2023-24;2023;2023;1;0;1;1;0;1;0;0;0;0;0;0;0;xAXXx
377;École doctorale Environnement et société;;5;Biologie, médecine et santé;2024;2023-24;2023;2023;1;0;1;8;6;2;1;1;0;0;1;0;0;ZMG5u
377;École doctorale Environnement et société;;6;Sciences humaines et humanités;2024;2023-24;2023;2023;14;10;4;58;35;23;7;5;2;2;2;0;3;ZMG5u
377;École doctorale Environnement et société;;7;Sciences de la société;2024;2023-24;2023;2023;12;7;5;36;23;13;1;0;1;0;0;1;0;ZMG5u
377;École doctorale Environnement et société;;8;Sciences pour l'ingénieur;2024;2023-24;2023;2023;3;0;3;12;2;10;3;2;1;0;3;0;0;ZMG5u
397;École doctorale Physique et chimie des matériaux;;2;Physique;2024;2023-24;2023;2023;23;9;14;108;44;64;28;11;17;24;4;0;0;WxSt9
398;École doctorale Géosciences, ressources naturelles et environnement;GRNE;1;Mathématiques et leurs interactions;2024;2023-24;2023;2023;0;0;0;1;1;0;1;0;1;1;0;0;0;Zi4Zf
398;École doctorale Géosciences, ressources naturelles et environnement;GRNE;2;Physique;2024;2023-24;2023;2023;0;0;0;3;0;3;0;0;0;0;0;0;0;Zi4Zf
398;École doctorale Géosciences, ressources naturelles et environnement;GRNE;7;Sciences de la société;2024;2023-24;2023;2023;1;0;1;1;0;1;0;0;0;0;0;0;0;Zi4Zf
398;École doctorale Géosciences, ressources naturelles et environnement;GRNE;8;Sciences pour l'ingénieur;2024;2023-24;2023;2023;0;0;0;3;3;0;1;0;1;0;1;0;0;Zi4Zf
402;École doctorale Sciences de la vie et de la santé;SVS;5;Biologie, médecine et santé;2024;2023-24;2023;2023;37;23;14;132;85;47;41;24;17;11;21;8;1;YKgsU
402;École doctorale Sciences de la vie et de la santé;SVS;9;Sciences et technologies de l'information et de la communication;2024;2023-24;2023;2023;1;1;0;1;1;0;0;0;0;0;0;0;0;YKgsU
405;École doctorale Économie, management,mathématiques et physique de Cergy;EM2C;8;Sciences pour l'ingénieur;2024;2023-24;2023;2023;0;0;0;1;0;1;0;0;0;0;0;0;0;QbwSB
414;École doctorale Sciences de la vie et de la santé;;2;Physique;2024;2023-24;2023;2023;1;1;0;6;4;2;2;1;1;0;2;0;0;YI4xS
414;École doctorale Sciences de la vie et de la santé;;6;Sciences humaines et humanités;2024;2023-24;2023;2023;0;0;0;6;0;6;1;1;0;0;1;0;0;YI4xS
414;École doctorale Sciences de la vie et de la santé;;7;Sciences de la société;2024;2023-24;2023;2023;0;0;0;0;0;0;1;0;1;0;1;0;0;YI4xS
417;École doctorale Sciences et Ingénierie;S&I;5;Biologie, médecine et santé;2024;2023-24;2023;2023;6;3;3;11;6;5;5;3;2;1;3;1;0;SSBvE
417;École doctorale Sciences et Ingénierie;S&I;9;Sciences et technologies de l'information et de la communication;2024;2023-24;2023;2023;3;2;1;8;3;5;2;0;2;1;1;0;0;SSBvE
432;École doctorale Sciences des métiers de l'ingénieur;SMI;8;Sciences pour l'ingénieur;2024;2023-24;2023;2023;168;58;110;492;155;337;122;39;83;63;50;7;2;nSsHB
433;École doctorale Concepts et langages;;9;Sciences et technologies de l'information et de la communication;2024;2023-24;2023;2023;10;6;4;37;24;13;4;3;1;0;0;1;3;v8q34
446;École doctorale Biologie - Santé;EDBSL;5;Biologie, médecine et santé;2024;2023-24;2023;2023;93;50;43;351;198;153;100;59;41;49;40;9;2;4iEUF
458;École doctorale Sciences écologiques, vétérinaires, agronomiques et bioingénieries;SEVAB;10;Sciences agronomiques et écologiques;2024;2023-24;2023;2023;82;49;33;251;151;100;73;38;35;35;34;4;0;Yf3TI
460;École doctorale Sciences juridiques;SJ;7;Sciences de la société;2024;2023-24;2023;2023;18;9;9;94;53;41;19;11;8;0;3;8;8;ZB5I5
461;École doctorale Droit et science politique;;7;Sciences de la société;2024;2023-24;2023;2023;43;24;19;198;108;90;26;14;12;0;1;11;14;QGArN
465;École doctorale Économie Panthéon Sorbonne;EPS;1;Mathématiques et leurs interactions;2024;2023-24;2023;2023;0;0;0;12;5;7;4;0;4;1;2;1;0;MV68S
467;École doctorale Aéronautique, astronautique;AA;1;Mathématiques et leurs interactions;2024;2023-24;2023;2023;0;0;0;12;4;8;7;0;7;2;4;0;1;U7l45
469;École doctorale du Pacifique;EDP;1;Mathématiques et leurs interactions;2024;2023-24;2023;2023;1;1;0;3;2;1;1;0;1;0;1;0;0;t9Z2n
469;École doctorale du Pacifique;EDP;2;Physique;2024;2023-24;2023;2023;1;0;1;2;0;2;0;0;0;0;0;0;0;t9Z2n
469;École doctorale du Pacifique;EDP;9;Sciences et technologies de l'information et de la communication;2024;2023-24;2023;2023;1;0;1;5;1;4;1;1;0;0;1;0;0;t9Z2n
472;École doctorale de l'EPHE;;5;Biologie, médecine et santé;2024;2023-24;2023;2023;11;6;5;43;27;16;17;10;7;4;10;3;0;27zK4
472;École doctorale de l'EPHE;;6;Sciences humaines et humanités;2024;2023-24;2023;2023;83;50;33;466;247;219;67;35;32;3;18;20;26;27zK4
475;École doctorale Mathématiques, informatique, télécommunications de Toulouse;MITT;9;Sciences et technologies de l'information et de la communication;2024;2023-24;2023;2023;81;15;66;278;60;218;75;12;63;35;33;7;0;xcp2r
478;École doctorale Sciences de Gestion;;7;Sciences de la société;2024;2023-24;2023;2023;10;9;1;66;38;28;10;4;6;0;4;6;0;q34kB
480;École doctorale Montaigne-humanités;;6;Sciences humaines et humanités;2024;2023-24;2023;2023;96;57;39;501;276;225;74;44;30;3;13;26;32;f3SeZ
482;École doctorale Sciences de la matière;SDM;5;Biologie, médecine et santé;2024;2023-24;2023;2023;2;0;2;4;1;3;1;0;1;1;0;0;0;kmeZ4
484;École doctorale Lettres, langues, linguistique, arts;3LA;6;Sciences humaines et humanités;2024;2023-24;2023;2023;62;36;26;428;263;165;41;22;19;0;4;23;14;BlCQD
488;École doctorale Sciences, ingénierie, santé;SIS;8;Sciences pour l'ingénieur;2024;2023-24;2023;2023;17;5;12;106;39;67;24;10;14;8;11;4;1;Fy2lK
497;École doctorale Normande de Biologie Intégrative, Santé, Environnement;Ed NBISE;5;Biologie, médecine et santé;2024;2023-24;2023;2023;86;53;33;280;171;109;80;51;29;35;32;12;1;0D9Je
497;École doctorale Normande de Biologie Intégrative, Santé, Environnement;Ed NBISE;8;Sciences pour l'ingénieur;2024;2023-24;2023;2023;1;0;1;2;1;1;1;0;1;1;0;0;0;0D9Je
512;École doctorale Informatique et mathématiques;InfoMaths;5;Biologie, médecine et santé;2024;2023-24;2023;2023;0;0;0;3;1;2;1;0;1;0;1;0;0;t86bi
512;École doctorale Informatique et mathématiques;InfoMaths;8;Sciences pour l'ingénieur;2024;2023-24;2023;2023;4;3;1;7;3;4;1;0;1;1;0;0;0;t86bi
519;École doctorale Sciences humaines et sociales - Perspectives européennes;SHS-PE;7;Sciences de la société;2024;2023-24;2023;2023;24;13;11;157;91;66;18;7;11;1;3;7;7;2f5qs
530;École doctorale Organisations, marchés, institutions;OMI;5;Biologie, médecine et santé;2024;2023-24;2023;2023;0;0;0;2;1;1;1;0;1;0;0;0;1;4htv7
531;École doctorale Sciences, ingénierie et environnement;SIE;3;Sciences de la terre et de l'univers, espace;2024;2023-24;2023;2023;2;1;1;34;15;19;12;8;4;4;6;2;0;b5BYq
531;École doctorale Sciences, ingénierie et environnement;SIE;5;Biologie, médecine et santé;2024;2023-24;2023;2023;1;1;0;1;1;0;1;1;0;0;1;0;0;b5BYq
531;École doctorale Sciences, ingénierie et environnement;SIE;9;Sciences et technologies de l'information et de la communication;2024;2023-24;2023;2023;1;0;1;1;0;1;0;0;0;0;0;0;0;b5BYq
536;École doctorale Sciences et agrosciences;;2;Physique;2024;2023-24;2023;2023;0;0;0;0;0;0;1;0;1;0;1;0;0;pHfqe
536;École doctorale Sciences et agrosciences;;4;Chimie;2024;2023-24;2023;2023;4;4;0;8;6;2;3;2;1;1;2;0;0;pHfqe
537;École doctorale Culture et patrimoine;C&P;7;Sciences de la société;2024;2023-24;2023;2023;4;2;2;18;10;8;0;0;0;0;0;0;0;GxI4a
540;"École doctorale École transdisciplinaire ""lettres/sciences""";;8;Sciences pour l'ingénieur;2024;2023-24;2023;2023;0;0;0;4;1;3;2;2;0;0;2;0;0;tWWw7
541;École doctorale de sciences humaines et sociales de La Réunion;SHS;6;Sciences humaines et humanités;2024;2023-24;2023;2023;13;10;3;67;43;24;18;12;6;2;4;3;9;21SpE
541;École doctorale de sciences humaines et sociales de La Réunion;SHS;7;Sciences de la société;2024;2023-24;2023;2023;5;2;3;55;28;27;3;1;2;0;0;2;1;21SpE
542;École doctorale de sciences de La Réunion;STS;6;Sciences humaines et humanités;2024;2023-24;2023;2023;1;1;0;2;2;0;0;0;0;0;0;0;0;2pAql
542;École doctorale de sciences de La Réunion;STS;10;Sciences agronomiques et écologiques;2024;2023-24;2023;2023;5;4;1;15;11;4;5;4;1;1;3;1;0;2pAql
543;École doctorale de Dauphine;;7;Sciences de la société;2024;2023-24;2023;2023;57;27;30;275;125;150;52;27;25;7;19;19;7;u8w6A
544;École doctorale Inter-Med : Espaces, temps, cultures;INTER-MED;6;Sciences humaines et humanités;2024;2023-24;2023;2023;18;10;8;87;49;38;6;3;3;2;1;1;2;7VjtD
548;École doctorale Mer et Sciences;;1;Mathématiques et leurs interactions;2024;2023-24;2023;2023;3;0;3;13;3;10;1;0;1;0;1;0;0;QX0fS
548;École doctorale Mer et Sciences;;5;Biologie, médecine et santé;2024;2023-24;2023;2023;0;0;0;7;4;3;4;3;1;1;1;2;0;QX0fS
548;École doctorale Mer et Sciences;;8;Sciences pour l'ingénieur;2024;2023-24;2023;2023;1;0;1;8;3;5;1;0;1;0;1;0;0;QX0fS
552;École doctorale Énergie - Matériaux - Sciences de la Terre et de l'Univers;EMTSU;2;Physique;2024;2023-24;2023;2023;15;5;10;55;15;40;16;9;7;8;8;0;0;NTZhw
553;École doctorale Carnot - Pasteur;;3;Sciences de la terre et de l'univers, espace;2024;2023-24;2023;2023;0;0;0;3;1;2;0;0;0;0;0;0;0;6h4Z7
553;École doctorale Carnot - Pasteur;;4;Chimie;2024;2023-24;2023;2023;19;9;10;65;32;33;22;10;12;9;11;2;0;6h4Z7
554;École doctorale Environnements - Santé;E-S;3;Sciences de la terre et de l'univers, espace;2024;2023-24;2023;2023;6;3;3;27;9;18;5;2;3;1;3;1;0;ElyFU
555;École doctorale Sciences de l'Homme et de la Société;SHS;6;Sciences humaines et humanités;2024;2023-24;2023;2023;13;7;6;82;47;35;13;8;5;3;4;6;0;44G6m
558;École doctorale Histoire, Mémoire, Patrimoine, Langage;HMPL;6;Sciences humaines et humanités;2024;2023-24;2023;2023;57;31;26;326;176;150;26;13;13;3;5;10;8;uX3jT
560;École doctorale Sciences de la terre et de l'environnement et Physique de l'univers, Paris;STEP'UP;3;Sciences de la terre et de l'univers, espace;2024;2023-24;2023;2023;49;19;30;164;64;100;43;16;27;21;20;2;0;Z2VI9
568;École doctorale Signalisations et Réseaux Intégratifs en Biologie;BIOSIGNE;5;Biologie, médecine et santé;2024;2023-24;2023;2023;26;14;12;104;66;38;30;20;10;8;17;5;0;CGttG
569;École doctorale Innovation thérapeutique : du fondamental à l'appliqué;;4;Chimie;2024;2023-24;2023;2023;30;18;12;109;61;48;11;7;4;4;7;0;0;jx8ET
572;École doctorale Ondes et matière;EDOM;2;Physique;2024;2023-24;2023;2023;68;14;54;202;44;158;57;17;40;27;25;5;0;etSIi
573;École doctorale Interfaces : Approches Interdisciplinaires, Fondements, Applications et Innovation;ED INTERFACES;1;Mathématiques et leurs interactions;2024;2023-24;2023;2023;0;0;0;18;4;14;6;2;4;1;5;0;0;gG820
573;École doctorale Interfaces : Approches Interdisciplinaires, Fondements, Applications et Innovation;ED INTERFACES;6;Sciences humaines et humanités;2024;2023-24;2023;2023;0;0;0;4;2;2;0;0;0;0;0;0;0;gG820
575;École doctorale Electrical, Optical, Bio : Physics and Engineering;EOBE;4;Chimie;2024;2023-24;2023;2023;0;0;0;0;0;0;2;1;1;1;1;0;0;dfhyn
575;École doctorale Electrical, Optical, Bio : Physics and Engineering;EOBE;8;Sciences pour l'ingénieur;2024;2023-24;2023;2023;67;27;40;217;72;145;44;10;34;22;17;4;1;dfhyn
575;École doctorale Electrical, Optical, Bio : Physics and Engineering;EOBE;9;Sciences et technologies de l'information et de la communication;2024;2023-24;2023;2023;7;2;5;19;5;14;5;1;4;3;2;0;0;dfhyn
576;École doctorale Particules, Hadrons, Énergie, Noyau, Instrumentation, Imagerie, Cosmos et Simulation;PHENIICS;2;Physique;2024;2023-24;2023;2023;61;18;43;197;54;143;66;22;44;53;12;1;0;qC4rf
576;École doctorale Particules, Hadrons, Énergie, Noyau, Instrumentation, Imagerie, Cosmos et Simulation;PHENIICS;5;Biologie, médecine et santé;2024;2023-24;2023;2023;0;0;0;1;1;0;0;0;0;0;0;0;0;qC4rf
577;École doctorale Structure et dynamique des systèmes vivants;SDSV;5;Biologie, médecine et santé;2024;2023-24;2023;2023;66;38;28;241;135;106;85;57;28;33;44;8;0;4bsxJ
579;École doctorale Sciences mécaniques et energétiques, matériaux et géosciences;SMEMaG;2;Physique;2024;2023-24;2023;2023;2;0;2;5;0;5;3;1;2;2;1;0;0;atMj7
579;École doctorale Sciences mécaniques et energétiques, matériaux et géosciences;SMEMaG;4;Chimie;2024;2023-24;2023;2023;0;0;0;1;0;1;1;1;0;0;1;0;0;atMj7
582;École doctorale Cancérologie, Biologie, Médecine, Santé;CBMS;5;Biologie, médecine et santé;2024;2023-24;2023;2023;66;43;23;224;138;86;57;38;19;15;35;7;0;75bj4
587;École doctorale Diversites, santé et développement en Amazonie;;8;Sciences pour l'ingénieur;2024;2023-24;2023;2023;1;0;1;5;2;3;1;0;1;0;1;0;0;V14tj
591;École doctorale Physique, Sciences de l'Ingenieur, Materiaux, Énergie;PSIME;2;Physique;2024;2023-24;2023;2023;31;9;22;139;35;104;36;14;22;25;11;0;0;Hn5Om
592;École doctorale Lettres, Communication, Langues, Arts;LECLA;7;Sciences de la société;2024;2023-24;2023;2023;0;0;0;1;0;1;0;0;0;0;0;0;0;sY7f3
597;École doctorale Sciences économiques et sciences de Gestion;EDGE;7;Sciences de la société;2024;2023-24;2023;2023;17;8;9;85;37;48;21;7;14;6;9;6;0;d8Zuu
598;École doctorale Sciences de La Mer et du Littoral;SML;6;Sciences humaines et humanités;2024;2023-24;2023;2023;2;2;0;17;14;3;3;3;0;0;0;3;0;Smen6
598;École doctorale Sciences de La Mer et du Littoral;SML;7;Sciences de la société;2024;2023-24;2023;2023;6;2;4;22;10;12;1;1;0;0;1;0;0;Smen6
598;École doctorale Sciences de La Mer et du Littoral;SML;8;Sciences pour l'ingénieur;2024;2023-24;2023;2023;3;0;3;10;2;8;1;0;1;0;1;0;0;Smen6
602;École doctorale Sciences pour l'Ingénieur;SPI;6;Sciences humaines et humanités;2024;2023-24;2023;2023;0;0;0;10;5;5;2;1;1;0;2;0;0;8yWbu
602;École doctorale Sciences pour l'Ingénieur;SPI;9;Sciences et technologies de l'information et de la communication;2024;2023-24;2023;2023;7;3;4;33;16;17;3;0;3;3;0;0;0;8yWbu
606;École doctorale Chimie - Mécanique - Matériaux - Physique;C2MP;2;Physique;2024;2023-24;2023;2023;16;4;12;63;19;44;27;5;22;19;8;0;0;UkNR2
618;École doctorale EUCLIDE;;8;Sciences pour l'ingénieur;2024;2023-24;2023;2023;6;4;2;36;14;22;8;3;5;4;4;0;0;qveTN
619;École doctorale Sciences Fondamentales et Santé;SFS;1;Mathématiques et leurs interactions;2024;2023-24;2023;2023;2;1;1;7;2;5;2;1;1;2;0;0;0;JiZVW
619;École doctorale Sciences Fondamentales et Santé;SFS;2;Physique;2024;2023-24;2023;2023;2;1;1;8;3;5;0;0;0;0;0;0;0;JiZVW
619;École doctorale Sciences Fondamentales et Santé;SFS;4;Chimie;2024;2023-24;2023;2023;4;0;4;13;1;12;4;0;4;3;1;0;0;JiZVW
620;École doctorale Sciences du Numérique et de l'Ingénieur;SNI;3;Sciences de la terre et de l'univers, espace;2024;2023-24;2023;2023;1;0;1;1;0;1;0;0;0;0;0;0;0;Dr40w
623;École doctorale Savoir, Sciences, Éducation;SSE;7;Sciences de la société;2024;2023-24;2023;2023;3;3;0;19;10;9;1;1;0;0;1;0;0;98lMD
626;École doctorale de l’Institut Polytechnique de Paris;;2;Physique;2024;2023-24;2023;2023;64;16;48;177;55;122;51;10;41;32;16;3;0;DL5fO
626;École doctorale de l’Institut Polytechnique de Paris;;4;Chimie;2024;2023-24;2023;2023;18;10;8;42;25;17;10;6;4;6;4;0;0;DL5fO
632;École doctorale Science de l’ingénierie et des systèmes;ENGSYS;8;Sciences pour l'ingénieur;2024;2023-24;2023;2023;44;16;28;167;48;119;52;19;33;29;21;2;0;1jT2e
634;École doctorale Sciences, Ingénierie, Environnement;SIE;3;Sciences de la terre et de l'univers, espace;2024;2023-24;2023;2023;4;3;1;16;9;7;3;2;1;1;1;1;0;TOc8f
634;École doctorale Sciences, Ingénierie, Environnement;SIE;5;Biologie, médecine et santé;2024;2023-24;2023;2023;5;2;3;10;4;6;2;0;2;0;2;0;0;TOc8f
635;École doctorale Polytechnique Hauts-de-France;PHF;4;Chimie;2024;2023-24;2023;2023;5;0;5;10;3;7;0;0;0;0;0;0;0;p2m23
635;École doctorale Polytechnique Hauts-de-France;PHF;5;Biologie, médecine et santé;2024;2023-24;2023;2023;2;1;1;8;3;5;0;0;0;0;0;0;0;p2m23
636;École doctorale Dynamique des environnements dans l'espace Caraïbes-Amériques;;3;Sciences de la terre et de l'univers, espace;2024;2023-24;2023;2023;0;0;0;1;1;0;0;0;0;0;0;0;0;s0yax
636;École doctorale Dynamique des environnements dans l'espace Caraïbes-Amériques;;7;Sciences de la société;2024;2023-24;2023;2023;10;6;4;37;20;17;3;2;1;0;0;2;1;s0yax
644;École doctorale Mathématiques & Sciences et Technologies de l'Information et de la Communication en Bretagne Océane;MathSTIC;1;Mathématiques et leurs interactions;2024;2023-24;2023;2023;8;2;6;22;5;17;5;1;4;2;2;1;0;e23n9
647;École doctorale Sciences pour l’Ingénieur;;8;Sciences pour l'ingénieur;2024;2023-24;2023;2023;33;6;27;106;29;77;28;10;18;11;12;5;0;pg354
649;École doctorale Rosalind Franklin : Énergie, Environnement, Bio-santé;;5;Biologie, médecine et santé;2024;2023-24;2023;2023;21;10;11;70;32;38;16;7;9;7;4;4;1;jxkg9
649;École doctorale Rosalind Franklin : Énergie, Environnement, Bio-santé;;10;Sciences agronomiques et écologiques;2024;2023-24;2023;2023;4;2;2;16;8;8;1;1;0;0;1;0;0;jxkg9
651;École doctorale Mathématiques, Informatique, Matériaux, Mécanique, Énergétique;MIMME;1;Mathématiques et leurs interactions;2024;2023-24;2023;2023;3;2;1;14;8;6;7;3;4;7;0;0;0;6qq6f
651;École doctorale Mathématiques, Informatique, Matériaux, Mécanique, Énergétique;MIMME;2;Physique;2024;2023-24;2023;2023;5;3;2;18;7;11;7;0;7;4;3;0;0;6qq6f
652;École doctorale Biologie, Chimie, Santé;OMEGA-LIM;5;Biologie, médecine et santé;2024;2023-24;2023;2023;32;14;18;101;54;47;29;16;13;15;12;2;0;wh5hf
655;École doctorale Gouvernance des Institutions et des Organisations;;7;Sciences de la société;2024;2023-24;2023;2023;16;6;10;88;38;50;14;5;9;0;4;4;6;izw4r
656;École doctorale Cancérologie, Biologie, Santé de Lyon;;5;Biologie, médecine et santé;2024;2023-24;2023;2023;41;33;8;41;33;8;0;0;0;0;0;0;0;8y1sw
9;École doctorale Droit international, droit européen, relations internationales et droit comparé;;7;Sciences de la société;2024;2023-24;2023;2023;23;16;7;238;134;104;28;16;12;3;7;3;15;v1emR
20;École doctorale Civilisations, cultures, littératures et sociétés;;6;Sciences humaines et humanités;2024;2023-24;2023;2023;48;31;17;201;140;61;15;10;5;1;2;2;10;agjNi
34;École doctorale Matériaux;;2;Physique;2024;2023-24;2023;2023;0;0;0;35;13;22;4;3;1;0;4;0;0;1Iufh
40;École doctorale Sciences chimiques;EDSC;4;Chimie;2024;2023-24;2023;2023;79;27;52;290;131;159;80;39;41;48;29;3;0;wde3D
47;École doctorale Physique;;3;Sciences de la terre et de l'univers, espace;2024;2023-24;2023;2023;19;6;13;61;17;44;18;5;13;11;7;0;0;8kNpd
50;École doctorale Langues, littératures et sciences humaines;LLSH;6;Sciences humaines et humanités;2024;2023-24;2023;2023;32;20;12;167;119;48;29;23;6;1;7;9;12;8THzQ
52;École doctorale Physique et astrophysique de Lyon;PHAST;3;Sciences de la terre et de l'univers, espace;2024;2023-24;2023;2023;8;4;4;22;12;10;9;3;6;5;4;0;0;61XPb
70;École doctorale Sciences pour l'ingénieur;EDSPI;8;Sciences pour l'ingénieur;2024;2023-24;2023;2023;34;14;20;127;46;81;26;4;22;14;9;3;0;G413P
77;École doctorale Informatique, automatique, électronique, électrotechnique, mathématiques;IAEM;1;Mathématiques et leurs interactions;2024;2023-24;2023;2023;15;6;9;41;10;31;9;1;8;2;4;3;0;TCHTA
78;École doctorale Sociétés, langages, temps, connaissances;STLC;7;Sciences de la société;2024;2023-24;2023;2023;3;3;0;49;28;21;9;8;1;0;1;2;6;vLU3i
85;École doctorale Sciences de la vie et de la santé;SVS;5;Biologie, médecine et santé;2024;2023-24;2023;2023;65;39;26;228;146;82;57;39;18;20;29;6;2;YdiMF
85;École doctorale Sciences de la vie et de la santé;SVS;6;Sciences humaines et humanités;2024;2023-24;2023;2023;0;0;0;1;1;0;0;0;0;0;0;0;0;YdiMF
104;École doctorale Sciences de la matière, du rayonnement et de l'environnement;SMRE;3;Sciences de la terre et de l'univers, espace;2024;2023-24;2023;2023;8;5;3;36;20;16;10;5;5;7;3;0;0;Q5iFz
104;École doctorale Sciences de la matière, du rayonnement et de l'environnement;SMRE;5;Biologie, médecine et santé;2024;2023-24;2023;2023;1;0;1;8;4;4;0;0;0;0;0;0;0;Q5iFz
124;École doctorale Histoire de l'art et archéologie;;6;Sciences humaines et humanités;2024;2023-24;2023;2023;21;15;6;126;81;45;13;11;2;0;4;0;9;MBN4L
129;École doctorale Sciences de l'environnement d'Ile de France;SEIF;3;Sciences de la terre et de l'univers, espace;2024;2023-24;2023;2023;60;30;30;220;104;116;63;31;32;30;29;3;1;TnAPh
130;École doctorale Informatique, télécommunications et électronique de Paris;EDITE;1;Mathématiques et leurs interactions;2024;2023-24;2023;2023;0;0;0;11;2;9;9;0;9;9;0;0;0;O5ysj
130;École doctorale Informatique, télécommunications et électronique de Paris;EDITE;6;Sciences humaines et humanités;2024;2023-24;2023;2023;0;0;0;0;0;0;2;1;1;1;1;0;0;O5ysj
130;École doctorale Informatique, télécommunications et électronique de Paris;EDITE;9;Sciences et technologies de l'information et de la communication;2024;2023-24;2023;2023;111;29;82;349;91;258;90;13;77;50;32;8;0;O5ysj
139;École doctorale Connaissance, langage, modélisation;CLM;9;Sciences et technologies de l'information et de la communication;2024;2023-24;2023;2023;2;1;1;9;3;6;1;0;1;1;0;0;0;1lxGH
141;École doctorale Droit et science politique;DSP;7;Sciences de la société;2024;2023-24;2023;2023;36;9;27;281;131;150;28;16;12;4;4;5;15;CyNBf
158;École doctorale Cerveau, cognition, comportement;3C;2;Physique;2024;2023-24;2023;2023;0;0;0;0;0;0;1;0;1;0;1;0;0;Il62F
166;École doctorale Information, structures et systèmes;I2S;10;Sciences agronomiques et écologiques;2024;2023-24;2023;2023;0;0;0;3;0;3;0;0;0;0;0;0;0;2uO68
168;École doctorale Sciences chimiques et biologiques pour la santé;SCBS;2;Physique;2024;2023-24;2023;2023;0;0;0;3;0;3;0;0;0;0;0;0;0;8cEME
173;École doctorale Sciences de l'univers, de l'environnement et de l'espace;SDU2E;1;Mathématiques et leurs interactions;2024;2023-24;2023;2023;1;1;0;3;1;2;0;0;0;0;0;0;0;R0Z9c
173;École doctorale Sciences de l'univers, de l'environnement et de l'espace;SDU2E;2;Physique;2024;2023-24;2023;2023;13;5;8;31;12;19;4;2;2;4;0;0;0;R0Z9c
178;École doctorale Sciences fondamentales;;4;Chimie;2024;2023-24;2023;2023;20;9;11;54;24;30;17;7;10;10;7;0;0;1AiR7
182;École doctorale Physique et chimie-physique;;3;Sciences de la terre et de l'univers, espace;2024;2023-24;2023;2023;3;0;3;7;1;6;2;2;0;2;0;0;0;3My6I
184;École doctorale Mathématiques et informatique de Marseille;;5;Biologie, médecine et santé;2024;2023-24;2023;2023;2;0;2;5;0;5;1;1;0;1;0;0;0;DDObG
184;École doctorale Mathématiques et informatique de Marseille;;6;Sciences humaines et humanités;2024;2023-24;2023;2023;0;0;0;1;1;0;0;0;0;0;0;0;0;DDObG
205;École doctorale Interdisciplinaire Sciences-Santé;EDISS;6;Sciences humaines et humanités;2024;2023-24;2023;2023;0;0;0;12;2;10;3;1;2;1;1;1;0;69W38
218;École doctorale Chimie et sciences du vivant;EDCSV;4;Chimie;2024;2023-24;2023;2023;22;11;11;74;31;43;29;12;17;13;14;2;0;8bcJh
222;École doctorale Sciences chimiques;EDSC;2;Physique;2024;2023-24;2023;2023;7;1;6;15;3;12;4;2;2;3;1;0;0;AdU8Q
224;École doctorale Cognition, langage, interaction;;7;Sciences de la société;2024;2023-24;2023;2023;1;1;0;1;1;0;0;0;0;0;0;0;0;7v43e
224;École doctorale Cognition, langage, interaction;;9;Sciences et technologies de l'information et de la communication;2024;2023-24;2023;2023;11;6;5;43;18;25;10;6;4;0;4;3;3;7v43e
231;École doctorale Économie et gestion;EDEG;7;Sciences de la société;2024;2023-24;2023;2023;46;20;26;166;82;84;32;20;12;4;14;12;2;KT720
234;École doctorale de Sciences Po;;6;Sciences humaines et humanités;2024;2023-24;2023;2023;63;35;28;305;156;149;57;25;32;4;9;20;24;ux756
250;École doctorale Sciences chimiques;;4;Chimie;2024;2023-24;2023;2023;43;23;20;121;56;65;32;12;20;18;14;0;0;O0Fav
251;École doctorale Sciences de l'environnement;;3;Sciences de la terre et de l'univers, espace;2024;2023-24;2023;2023;30;17;13;95;55;40;26;14;12;10;14;2;0;VR28y
251;École doctorale Sciences de l'environnement;;4;Chimie;2024;2023-24;2023;2023;7;3;4;23;10;13;5;1;4;1;3;1;0;VR28y
251;École doctorale Sciences de l'environnement;;6;Sciences humaines et humanités;2024;2023-24;2023;2023;0;0;0;4;3;1;2;0;2;0;0;2;0;VR28y
269;École doctorale Mathématiques, sciences de l'information et de l'ingénieur;MSII;7;Sciences de la société;2024;2023-24;2023;2023;0;0;0;1;1;0;1;1;0;0;0;1;0;5E625
279;École doctorale Arts plastiques, esthétique et sciences de l'art;APESA;6;Sciences humaines et humanités;2024;2023-24;2023;2023;26;14;12;159;113;46;16;9;7;1;3;4;8;BpW1j
284;École doctorale Droit et Science Politique;DSP;7;Sciences de la société;2024;2023-24;2023;2023;7;3;4;48;27;21;3;2;1;0;0;0;3;ahH92
286;École doctorale de l'Ehess;;7;Sciences de la société;2024;2023-24;2023;2023;115;61;54;872;480;392;120;62;58;9;12;39;60;2S146
300;École doctorale Sciences Économiques;ED SE;7;Sciences de la société;2024;2023-24;2023;2023;8;3;5;41;13;28;8;4;4;4;2;2;0;5x3fM
309;École doctorale Systèmes;EDSYS;9;Sciences et technologies de l'information et de la communication;2024;2023-24;2023;2023;18;6;12;62;18;44;30;5;25;17;12;1;0;8TT4b
323;École doctorale Génie électrique, électronique et télécommunications;GEET;4;Chimie;2024;2023-24;2023;2023;1;1;0;1;1;0;0;0;0;0;0;0;0;arcz6
326;École doctorale Comportement, langage, éducation, socialisation, cognition;CLESCO;6;Sciences humaines et humanités;2024;2023-24;2023;2023;44;29;15;221;154;67;46;26;20;2;13;15;16;nWIlG
340;École doctorale Biologie moléculaire, intégrative et cellulaire;BMIC;5;Biologie, médecine et santé;2024;2023-24;2023;2023;40;29;11;295;194;101;70;44;26;36;27;7;0;db7xq
341;École doctorale Évolution, écosystèmes, microbiologie, modélisation;E2M2;5;Biologie, médecine et santé;2024;2023-24;2023;2023;24;13;11;115;61;54;38;17;21;21;14;2;1;J83I0
341;École doctorale Évolution, écosystèmes, microbiologie, modélisation;E2M2;10;Sciences agronomiques et écologiques;2024;2023-24;2023;2023;27;14;13;79;45;34;22;14;8;8;12;2;0;J83I0
356;École doctorale Cognition, langage, éducation;;6;Sciences humaines et humanités;2024;2023-24;2023;2023;52;33;19;232;146;86;44;28;16;9;15;16;4;55Cpz
361;École doctorale Sciences et Technologies;ED ST;7;Sciences de la société;2024;2023-24;2023;2023;1;1;0;14;7;7;1;0;1;0;1;0;0;cOUmL
372;École doctorale Sciences économiques et de gestion;;7;Sciences de la société;2024;2023-24;2023;2023;27;14;13;150;79;71;23;15;8;2;11;7;3;JK63A
377;École doctorale Environnement et société;;1;Mathématiques et leurs interactions;2024;2023-24;2023;2023;0;0;0;1;1;0;0;0;0;0;0;0;0;ZMG5u
393;École doctorale Pierre Louis de Santé Publique : Épidémiologie et Sciences de l'information biomédicale;PLSP;5;Biologie, médecine et santé;2024;2023-24;2023;2023;71;34;37;238;120;118;58;28;30;29;21;8;0;69445
395;École doctorale Milieux, cultures et sociétés du passé et du présent;MCSPP;7;Sciences de la société;2024;2023-24;2023;2023;12;4;8;91;57;34;6;5;1;0;0;1;5;2quEb
398;École doctorale Géosciences, ressources naturelles et environnement;GRNE;3;Sciences de la terre et de l'univers, espace;2024;2023-24;2023;2023;28;17;11;90;47;43;29;10;19;16;13;0;0;Zi4Zf
401;École doctorale Sciences sociales;;6;Sciences humaines et humanités;2024;2023-24;2023;2023;19;9;10;127;69;58;20;12;8;0;3;2;15;raQ7K
402;École doctorale Sciences de la vie et de la santé;SVS;4;Chimie;2024;2023-24;2023;2023;0;0;0;1;0;1;0;0;0;0;0;0;0;YKgsU
405;École doctorale Économie, management,mathématiques et physique de Cergy;EM2C;1;Mathématiques et leurs interactions;2024;2023-24;2023;2023;3;2;1;13;3;10;4;1;3;1;1;1;1;QbwSB
405;École doctorale Économie, management,mathématiques et physique de Cergy;EM2C;7;Sciences de la société;2024;2023-24;2023;2023;8;2;6;55;18;37;26;13;13;4;9;12;1;QbwSB
411;École doctorale Humanités nouvelles : Fernand Braudel;;7;Sciences de la société;2024;2023-24;2023;2023;0;0;0;3;0;3;0;0;0;0;0;0;0;l2rFh
413;École doctorale Sciences de la terre et de l'environnement;STE;7;Sciences de la société;2024;2023-24;2023;2023;0;0;0;9;3;6;3;0;3;1;0;2;0;u9BA9
414;École doctorale Sciences de la vie et de la santé;;1;Mathématiques et leurs interactions;2024;2023-24;2023;2023;0;0;0;1;1;0;0;0;0;0;0;0;0;YI4xS
433;École doctorale Concepts et langages;;6;Sciences humaines et humanités;2024;2023-24;2023;2023;52;32;20;316;187;129;30;17;13;1;9;7;13;v8q34
441;École doctorale Histoire de l'art;;6;Sciences humaines et humanités;2024;2023-24;2023;2023;19;14;5;144;101;43;25;19;6;0;2;10;13;d5W3U
454;École doctorale Sciences de l'homme, du politique et du territoire;SHPT;7;Sciences de la société;2024;2023-24;2023;2023;8;1;7;78;33;45;9;8;1;2;2;3;2;Opv31
455;École doctorale Économie, Gestion, Information et Communication;EGIC;6;Sciences humaines et humanités;2024;2023-24;2023;2023;7;5;2;50;28;22;7;5;2;1;1;1;4;qCOg3
459;École doctorale Sciences chimiques Balard;;2;Physique;2024;2023-24;2023;2023;0;0;0;3;2;1;1;1;0;1;0;0;0;YFs2W
459;École doctorale Sciences chimiques Balard;;5;Biologie, médecine et santé;2024;2023-24;2023;2023;0;0;0;2;2;0;0;0;0;0;0;0;0;YFs2W
459;École doctorale Sciences chimiques Balard;;7;Sciences de la société;2024;2023-24;2023;2023;1;1;0;1;1;0;0;0;0;0;0;0;0;YFs2W
463;École doctorale Sciences du mouvement humain;SMH;6;Sciences humaines et humanités;2024;2023-24;2023;2023;5;1;4;21;12;9;14;7;7;3;6;5;0;UbtlY
465;École doctorale Économie Panthéon Sorbonne;EPS;7;Sciences de la société;2024;2023-24;2023;2023;53;23;30;274;117;157;63;27;36;7;21;26;9;MV68S
468;École doctorale Mécanique, énergétique, génie civil, procédés;MEGEP;5;Biologie, médecine et santé;2024;2023-24;2023;2023;0;0;0;1;0;1;0;0;0;0;0;0;0;4XUTB
468;École doctorale Mécanique, énergétique, génie civil, procédés;MEGEP;7;Sciences de la société;2024;2023-24;2023;2023;0;0;0;1;0;1;0;0;0;0;0;0;0;4XUTB
468;École doctorale Mécanique, énergétique, génie civil, procédés;MEGEP;8;Sciences pour l'ingénieur;2024;2023-24;2023;2023;136;36;100;470;131;339;125;34;91;53;63;9;0;4XUTB
468;École doctorale Mécanique, énergétique, génie civil, procédés;MEGEP;9;Sciences et technologies de l'information et de la communication;2024;2023-24;2023;2023;0;0;0;0;0;0;1;0;1;0;0;1;0;4XUTB
469;École doctorale du Pacifique;EDP;3;Sciences de la terre et de l'univers, espace;2024;2023-24;2023;2023;4;1;3;7;3;4;2;1;1;0;1;1;0;t9Z2n
469;École doctorale du Pacifique;EDP;8;Sciences pour l'ingénieur;2024;2023-24;2023;2023;0;0;0;3;0;3;2;1;1;0;2;0;0;t9Z2n
472;École doctorale de l'EPHE;;10;Sciences agronomiques et écologiques;2024;2023-24;2023;2023;5;2;3;21;11;10;3;2;1;1;2;0;0;27zK4
474;École doctorale Interdisciplinaire européenne frontières du vivant;FDV;5;Biologie, médecine et santé;2024;2023-24;2023;2023;7;3;4;49;25;24;15;8;7;1;9;5;0;E727j
474;École doctorale Interdisciplinaire européenne frontières du vivant;FDV;6;Sciences humaines et humanités;2024;2023-24;2023;2023;5;4;1;19;11;8;7;5;2;0;2;5;0;E727j
474;École doctorale Interdisciplinaire européenne frontières du vivant;FDV;7;Sciences de la société;2024;2023-24;2023;2023;2;2;0;13;9;4;3;2;1;0;1;2;0;E727j
474;École doctorale Interdisciplinaire européenne frontières du vivant;FDV;9;Sciences et technologies de l'information et de la communication;2024;2023-24;2023;2023;1;0;1;3;2;1;3;1;2;0;1;2;0;E727j
476;École doctorale Neurosciences et cognition;NSCO;5;Biologie, médecine et santé;2024;2023-24;2023;2023;25;13;12;126;71;55;28;19;9;9;13;4;2;B1H0x
476;École doctorale Neurosciences et cognition;NSCO;6;Sciences humaines et humanités;2024;2023-24;2023;2023;5;2;3;36;21;15;6;1;5;3;3;0;0;B1H0x
481;École doctorale Sciences sociales et humanités;SSH;7;Sciences de la société;2024;2023-24;2023;2023;13;8;5;125;64;61;27;11;16;2;6;5;14;E3z5j
482;École doctorale Sciences de la matière;SDM;2;Physique;2024;2023-24;2023;2023;29;7;22;89;24;65;26;6;20;16;10;0;0;kmeZ4
486;École doctorale Sciences économiques et de gestion;SEG;7;Sciences de la société;2024;2023-24;2023;2023;31;11;20;142;67;75;29;11;18;6;11;11;1;h1GZ3
488;École doctorale Sciences, ingénierie, santé;SIS;1;Mathématiques et leurs interactions;2024;2023-24;2023;2023;3;1;2;15;2;13;6;0;6;5;1;0;0;Fy2lK
497;École doctorale Normande de Biologie Intégrative, Santé, Environnement;Ed NBISE;4;Chimie;2024;2023-24;2023;2023;0;0;0;3;0;3;1;0;1;1;0;0;0;0D9Je
508;École doctorale Normande de chimie;EDNC;4;Chimie;2024;2023-24;2023;2023;45;21;24;170;75;95;52;26;26;41;11;0;0;E52OO
508;École doctorale Normande de chimie;EDNC;5;Biologie, médecine et santé;2024;2023-24;2023;2023;0;0;0;1;1;0;0;0;0;0;0;0;0;E52OO
510;École doctorale Ingénierie - Matériaux, mécanique, environnement, énergétique, procédés, production;IMEP2;8;Sciences pour l'ingénieur;2024;2023-24;2023;2023;120;43;77;397;124;273;134;49;85;69;58;6;1;Ce7NF
515;École doctorale Complexité du vivant;CdV;10;Sciences agronomiques et écologiques;2024;2023-24;2023;2023;0;0;0;0;0;0;1;1;0;0;1;0;0;CbV9s
519;École doctorale Sciences humaines et sociales - Perspectives européennes;SHS-PE;6;Sciences humaines et humanités;2024;2023-24;2023;2023;28;16;12;158;91;67;29;18;11;2;7;8;12;2f5qs
519;École doctorale Sciences humaines et sociales - Perspectives européennes;SHS-PE;9;Sciences et technologies de l'information et de la communication;2024;2023-24;2023;2023;4;0;4;10;3;7;1;0;1;0;0;0;1;2f5qs
520;École doctorale Humanités;;6;Sciences humaines et humanités;2024;2023-24;2023;2023;54;34;20;235;151;84;36;18;18;2;2;12;20;rI175
530;École doctorale Organisations, marchés, institutions;OMI;6;Sciences humaines et humanités;2024;2023-24;2023;2023;19;11;8;137;71;66;12;2;10;0;4;4;4;4htv7
530;École doctorale Organisations, marchés, institutions;OMI;7;Sciences de la société;2024;2023-24;2023;2023;16;4;12;73;34;39;15;11;4;1;2;3;9;4htv7
530;École doctorale Organisations, marchés, institutions;OMI;9;Sciences et technologies de l'information et de la communication;2024;2023-24;2023;2023;0;0;0;4;3;1;2;2;0;0;0;2;0;4htv7
530;École doctorale Organisations, marchés, institutions;OMI;10;Sciences agronomiques et écologiques;2024;2023-24;2023;2023;0;0;0;1;0;1;0;0;0;0;0;0;0;4htv7
531;École doctorale Sciences, ingénierie et environnement;SIE;4;Chimie;2024;2023-24;2023;2023;19;5;14;43;22;21;9;5;4;6;3;0;0;b5BYq
531;École doctorale Sciences, ingénierie et environnement;SIE;8;Sciences pour l'ingénieur;2024;2023-24;2023;2023;61;19;42;175;48;127;46;17;29;23;15;7;1;b5BYq
532;École doctorale Mathématiques et sciences et technologies de l'information et de la communication;MSTIC;9;Sciences et technologies de l'information et de la communication;2024;2023-24;2023;2023;34;10;24;146;36;110;38;11;27;19;16;2;1;t43KM
542;École doctorale de sciences de La Réunion;STS;2;Physique;2024;2023-24;2023;2023;1;0;1;15;7;8;6;3;3;0;3;3;0;2pAql
545;École doctorale Sociétés, politique et santé publique;SP2;5;Biologie, médecine et santé;2024;2023-24;2023;2023;24;12;12;92;57;35;26;16;10;15;9;0;2;IAKR4
548;École doctorale Mer et Sciences;;2;Physique;2024;2023-24;2023;2023;1;1;0;2;1;1;0;0;0;0;0;0;0;QX0fS
548;École doctorale Mer et Sciences;;6;Sciences humaines et humanités;2024;2023-24;2023;2023;0;0;0;9;4;5;2;0;2;1;1;0;0;QX0fS
551;École doctorale Mathématiques, Informatique, Physique Théorique et Ingénierie des Systèmes;MIPTIS;1;Mathématiques et leurs interactions;2024;2023-24;2023;2023;5;3;2;21;6;15;10;3;7;5;3;2;0;Mpudz
551;École doctorale Mathématiques, Informatique, Physique Théorique et Ingénierie des Systèmes;MIPTIS;9;Sciences et technologies de l'information et de la communication;2024;2023-24;2023;2023;29;10;19;88;20;68;19;6;13;9;7;3;0;Mpudz
552;École doctorale Énergie - Matériaux - Sciences de la Terre et de l'Univers;EMTSU;4;Chimie;2024;2023-24;2023;2023;8;3;5;34;18;16;9;5;4;3;4;2;0;NTZhw
556;École doctorale Homme, Sociétés, Risques, Territoire;HSRT;5;Biologie, médecine et santé;2024;2023-24;2023;2023;11;10;1;26;23;3;2;1;1;0;2;0;0;5QEaX
559;École doctorale Management Panthéon-Sorbonne;;1;Mathématiques et leurs interactions;2024;2023-24;2023;2023;3;1;2;8;4;4;4;2;2;0;2;0;2;4SP7k
560;École doctorale Sciences de la terre et de l'environnement et Physique de l'univers, Paris;STEP'UP;2;Physique;2024;2023-24;2023;2023;10;4;6;37;11;26;11;3;8;9;2;0;0;Z2VI9
562;École doctorale Bio Sorbonne Paris Cité;BioSPC;5;Biologie, médecine et santé;2024;2023-24;2023;2023;169;95;74;596;364;232;148;99;49;50;92;6;0;4Yju6
564;École doctorale Physique en Ile de France;PIF;2;Physique;2024;2023-24;2023;2023;200;60;140;712;184;528;212;46;166;137;68;6;1;39AcN
566;École doctorale Sciences du Sport, de la Motricité et du Mouvement Humain;SMMH;8;Sciences pour l'ingénieur;2024;2023-24;2023;2023;1;0;1;6;1;5;0;0;0;0;0;0;0;3iv8y
569;École doctorale Innovation thérapeutique : du fondamental à l'appliqué;;5;Biologie, médecine et santé;2024;2023-24;2023;2023;53;33;20;172;101;71;70;47;23;20;47;2;1;jx8ET
570;École doctorale Santé Publique;EDSP;5;Biologie, médecine et santé;2024;2023-24;2023;2023;43;27;16;144;93;51;50;33;17;23;19;5;3;9lgE4
571;École doctorale Sciences Chimiques : Molécules, Matériaux, Instrumentation et Biosystemes;2MIB;4;Chimie;2024;2023-24;2023;2023;85;37;48;295;132;163;91;53;38;52;35;4;0;zbi37
573;École doctorale Interfaces : Approches Interdisciplinaires, Fondements, Applications et Innovation;ED INTERFACES;9;Sciences et technologies de l'information et de la communication;2024;2023-24;2023;2023;1;0;1;7;1;6;5;0;5;2;2;1;0;gG820
575;École doctorale Electrical, Optical, Bio : Physics and Engineering;EOBE;1;Mathématiques et leurs interactions;2024;2023-24;2023;2023;0;0;0;1;0;1;1;0;1;0;1;0;0;dfhyn
579;École doctorale Sciences mécaniques et energétiques, matériaux et géosciences;SMEMaG;1;Mathématiques et leurs interactions;2024;2023-24;2023;2023;3;1;2;4;1;3;0;0;0;0;0;0;0;atMj7
581;École doctorale Agriculture, alimentation, biologie, environnement, santé;ABIES;5;Biologie, médecine et santé;2024;2023-24;2023;2023;30;16;14;81;50;31;25;13;12;16;7;2;0;c1x56
581;École doctorale Agriculture, alimentation, biologie, environnement, santé;ABIES;8;Sciences pour l'ingénieur;2024;2023-24;2023;2023;8;4;4;27;17;10;6;2;4;3;3;0;0;c1x56
583;École doctorale Risques et Société;;6;Sciences humaines et humanités;2024;2023-24;2023;2023;8;5;3;23;14;9;9;5;4;0;5;3;1;wUBi9
585;École doctorale Sciences, Technologie,  Sante;EDSTS;4;Chimie;2024;2023-24;2023;2023;24;7;17;91;40;51;22;10;12;15;7;0;0;NM3Dl
585;École doctorale Sciences, Technologie,  Sante;EDSTS;9;Sciences et technologies de l'information et de la communication;2024;2023-24;2023;2023;27;8;19;67;20;47;17;6;11;9;6;2;0;NM3Dl
586;École doctorale Sciences Humaines et Sociales;EDSHS;7;Sciences de la société;2024;2023-24;2023;2023;22;11;11;131;69;62;14;7;7;0;4;2;8;0RKVX
587;École doctorale Diversites, santé et développement en Amazonie;;7;Sciences de la société;2024;2023-24;2023;2023;6;2;4;20;9;11;3;2;1;1;0;2;0;V14tj
587;École doctorale Diversites, santé et développement en Amazonie;;9;Sciences et technologies de l'information et de la communication;2024;2023-24;2023;2023;0;0;0;0;0;0;1;0;1;0;0;1;0;V14tj
587;École doctorale Diversites, santé et développement en Amazonie;;10;Sciences agronomiques et écologiques;2024;2023-24;2023;2023;4;1;3;14;2;12;2;2;0;1;1;0;0;V14tj
594;École doctorale Sociétés, Espaces, Pratiques, Temps;ED SEPT;6;Sciences humaines et humanités;2024;2023-24;2023;2023;55;25;30;245;119;126;47;28;19;11;7;15;14;N85H3
594;École doctorale Sociétés, Espaces, Pratiques, Temps;ED SEPT;7;Sciences de la société;2024;2023-24;2023;2023;5;1;4;28;12;16;7;4;3;2;2;2;1;N85H3
596;École doctorale Matière, Molécules et Matériaux;ED 3M;2;Physique;2024;2023-24;2023;2023;24;17;7;92;38;54;14;7;7;6;6;2;0;77947
596;École doctorale Matière, Molécules et Matériaux;ED 3M;3;Sciences de la terre et de l'univers, espace;2024;2023-24;2023;2023;10;5;5;31;15;16;10;6;4;3;7;0;0;77947
596;École doctorale Matière, Molécules et Matériaux;ED 3M;4;Chimie;2024;2023-24;2023;2023;26;11;15;109;50;59;36;16;20;20;15;1;0;77947
598;École doctorale Sciences de La Mer et du Littoral;SML;10;Sciences agronomiques et écologiques;2024;2023-24;2023;2023;15;11;4;67;36;31;10;6;4;4;6;0;0;Smen6
600;École doctorale Écologie, Géosciences, Agronomie et Alimentation;EGAAL;10;Sciences agronomiques et écologiques;2024;2023-24;2023;2023;35;17;18;116;63;53;26;15;11;18;7;0;1;urS33
606;École doctorale Chimie - Mécanique - Matériaux - Physique;C2MP;4;Chimie;2024;2023-24;2023;2023;14;4;10;39;12;27;15;8;7;9;6;0;0;UkNR2
607;École doctorale Sciences et Ingénierie des Ressources Naturelles;SIReNA;10;Sciences agronomiques et écologiques;2024;2023-24;2023;2023;27;18;9;102;66;36;29;14;15;9;18;2;0;vi9w2
608;École doctorale Sciences et Ingénierie des Molécules, des Produits, des Procédés et de l'Énergie;SIMPPÉ;8;Sciences pour l'ingénieur;2024;2023-24;2023;2023;63;25;38;188;68;120;62;26;36;33;25;4;0;TyNjM
617;École doctorale Sciences de la Société : Territoires, Economie et Droit;SSTED;9;Sciences et technologies de l'information et de la communication;2024;2023-24;2023;2023;0;0;0;4;0;4;2;0;2;0;0;1;1;Kl9ZX
618;École doctorale EUCLIDE;;1;Mathématiques et leurs interactions;2024;2023-24;2023;2023;2;1;1;6;2;4;3;0;3;2;1;0;0;qveTN
618;École doctorale EUCLIDE;;3;Sciences de la terre et de l'univers, espace;2024;2023-24;2023;2023;7;4;3;14;6;8;2;0;2;1;1;0;0;qveTN
619;École doctorale Sciences Fondamentales et Santé;SFS;5;Biologie, médecine et santé;2024;2023-24;2023;2023;22;14;8;76;46;30;24;13;11;10;9;5;0;JiZVW
620;École doctorale Sciences du Numérique et de l'Ingénieur;SNI;1;Mathématiques et leurs interactions;2024;2023-24;2023;2023;2;1;1;8;5;3;2;0;2;2;0;0;0;Dr40w
620;École doctorale Sciences du Numérique et de l'Ingénieur;SNI;2;Physique;2024;2023-24;2023;2023;3;0;3;11;1;10;4;0;4;1;2;0;1;Dr40w
620;École doctorale Sciences du Numérique et de l'Ingénieur;SNI;5;Biologie, médecine et santé;2024;2023-24;2023;2023;0;0;0;2;0;2;1;0;1;0;1;0;0;Dr40w
621;École doctorale Ingénierie des Systèmes, Matériaux, Mécanique, Énergétique;ISMME;8;Sciences pour l'ingénieur;2024;2023-24;2023;2023;50;13;37;218;58;160;70;17;53;30;30;9;1;B2549
623;École doctorale Savoir, Sciences, Éducation;SSE;2;Physique;2024;2023-24;2023;2023;1;1;0;3;2;1;1;1;0;0;0;0;1;98lMD
626;École doctorale de l’Institut Polytechnique de Paris;;1;Mathématiques et leurs interactions;2024;2023-24;2023;2023;18;3;15;53;9;44;11;1;10;5;5;1;0;DL5fO
626;École doctorale de l’Institut Polytechnique de Paris;;5;Biologie, médecine et santé;2024;2023-24;2023;2023;7;5;2;29;15;14;7;2;5;3;3;0;1;DL5fO
628;École doctorale Arts Humanités et Sciences sociales;AHSS;6;Sciences humaines et humanités;2024;2023-24;2023;2023;35;20;15;197;111;86;25;12;13;7;4;6;8;vwwRK
629;École doctorale Sciences sociales et Humanités;SSH;7;Sciences de la société;2024;2023-24;2023;2023;12;8;4;85;44;41;7;3;4;0;0;3;4;nnSns
630;École doctorale Droit, Economie et Management;DEM;7;Sciences de la société;2024;2023-24;2023;2023;44;17;27;247;115;132;38;17;21;2;4;21;11;78n8c
633;École doctorale Cultures, Sociétés, Territoires;CST;3;Sciences de la terre et de l'univers, espace;2024;2023-24;2023;2023;1;0;1;8;2;6;0;0;0;0;0;0;0;54818
633;École doctorale Cultures, Sociétés, Territoires;CST;9;Sciences et technologies de l'information et de la communication;2024;2023-24;2023;2023;0;0;0;3;2;1;1;1;0;0;1;0;0;54818
634;École doctorale Sciences, Ingénierie, Environnement;SIE;8;Sciences pour l'ingénieur;2024;2023-24;2023;2023;13;6;7;58;25;33;10;4;6;5;5;0;0;TOc8f
635;École doctorale Polytechnique Hauts-de-France;PHF;6;Sciences humaines et humanités;2024;2023-24;2023;2023;16;8;8;87;49;38;9;2;7;6;2;1;0;p2m23
636;École doctorale Dynamique des environnements dans l'espace Caraïbes-Amériques;;1;Mathématiques et leurs interactions;2024;2023-24;2023;2023;0;0;0;11;0;11;4;0;4;3;1;0;0;s0yax
638;École doctorale Science de la Matière, des Molécules et Matériaux;S3M;4;Chimie;2024;2023-24;2023;2023;52;14;38;142;53;89;55;26;29;37;18;0;0;7artx
639;École doctorale Droit et Science politique - Pays de la Loire;DSP PDL;7;Sciences de la société;2024;2023-24;2023;2023;26;10;16;167;75;92;20;8;12;1;1;4;14;obljx
641;École doctorale Mathématiques et Sciences et Technologies du numérique, de l’Information et de la Communication;MaSTIC;9;Sciences et technologies de l'information et de la communication;2024;2023-24;2023;2023;29;6;23;126;24;102;31;7;24;16;13;2;0;4kq8w
645;École doctorale Espaces, Sociétés, Civilisations;ESC;7;Sciences de la société;2024;2023-24;2023;2023;10;4;6;59;28;31;8;2;6;1;1;5;1;3wapo
648;École doctorale Sciences pour l'ingénieur et le Numérique;SPIN;9;Sciences et technologies de l'information et de la communication;2024;2023-24;2023;2023;54;6;48;209;40;169;35;7;28;21;13;1;0;nz3qg
649;École doctorale Rosalind Franklin : Énergie, Environnement, Bio-santé;;3;Sciences de la terre et de l'univers, espace;2024;2023-24;2023;2023;3;1;2;12;5;7;6;4;2;5;1;0;0;jxkg9
651;École doctorale Mathématiques, Informatique, Matériaux, Mécanique, Énergétique;MIMME;8;Sciences pour l'ingénieur;2024;2023-24;2023;2023;39;8;31;183;39;144;28;6;22;11;14;3;0;6qq6f
652;École doctorale Biologie, Chimie, Santé;OMEGA-LIM;4;Chimie;2024;2023-24;2023;2023;2;1;1;9;5;4;0;0;0;0;0;0;0;wh5hf
657;École doctorale Sciences du vivant;;5;Biologie, médecine et santé;2024;2023-24;2023;2023;3;3;0;3;3;0;0;0;0;0;0;0;0;8kygb
6;École doctorale Droit privé;;7;Sciences de la société;2024;2023-24;2023;2023;19;9;10;210;100;110;18;8;10;2;4;4;8;UMnW1
8;École doctorale Histoire du droit, philosophie du droit et sociologie du droit;;7;Sciences de la société;2024;2023-24;2023;2023;9;1;8;83;38;45;11;3;8;2;1;1;7;pGSed
31;École doctorale Pratiques et théories du sens;;6;Sciences humaines et humanités;2024;2023-24;2023;2023;12;10;2;282;141;141;38;25;13;4;5;11;18;1S466
41;École doctorale Droit;;7;Sciences de la société;2024;2023-24;2023;2023;41;21;20;283;134;149;28;14;14;1;3;8;16;KnOQK
42;École doctorale Entreprise, économie, société;EES;7;Sciences de la société;2024;2023-24;2023;2023;15;5;10;102;45;57;24;13;11;2;8;10;4;uO01d
60;École doctorale Territoires, temps, sociétés et développement;TTSD;6;Sciences humaines et humanités;2024;2023-24;2023;2023;32;20;12;158;102;56;30;14;16;3;12;9;6;fkIh6
60;École doctorale Territoires, temps, sociétés et développement;TTSD;10;Sciences agronomiques et écologiques;2024;2023-24;2023;2023;2;1;1;5;3;2;0;0;0;0;0;0;0;fkIh6
62;École doctorale Sciences de la vie et de la santé;;3;Sciences de la terre et de l'univers, espace;2024;2023-24;2023;2023;1;0;1;2;1;1;0;0;0;0;0;0;0;vZzE7
62;École doctorale Sciences de la vie et de la santé;;4;Chimie;2024;2023-24;2023;2023;0;0;0;2;1;1;0;0;0;0;0;0;0;vZzE7
62;École doctorale Sciences de la vie et de la santé;;5;Biologie, médecine et santé;2024;2023-24;2023;2023;196;118;78;673;415;258;184;98;86;52;87;39;6;vZzE7
62;École doctorale Sciences de la vie et de la santé;;8;Sciences pour l'ingénieur;2024;2023-24;2023;2023;3;1;2;6;2;4;0;0;0;0;0;0;0;vZzE7
67;École doctorale Sciences juridiques et politiques;;7;Sciences de la société;2024;2023-24;2023;2023;56;26;30;367;186;181;71;32;39;3;6;20;42;qrOj1
71;École doctorale Sciences pour l'ingénieur;;1;Mathématiques et leurs interactions;2024;2023-24;2023;2023;4;2;2;9;4;5;4;1;3;3;0;1;0;H6UYp
71;École doctorale Sciences pour l'ingénieur;;5;Biologie, médecine et santé;2024;2023-24;2023;2023;1;1;0;8;3;5;4;2;2;1;3;0;0;H6UYp
73;École doctorale Sciences économiques, sociales, de l'aménagement et du management;SESAM;6;Sciences humaines et humanités;2024;2023-24;2023;2023;6;3;3;35;11;24;8;3;5;0;2;5;1;IQ0Hk
79;École doctorale Sciences juridiques, politiques, économiques et de gestion;SJPEG;7;Sciences de la société;2024;2023-24;2023;2023;39;25;14;191;96;95;25;11;14;5;7;5;8;ea4x6
84;École doctorale Sciences et technologies de l'information et de la communication;STIC;9;Sciences et technologies de l'information et de la communication;2024;2023-24;2023;2023;59;16;43;213;48;165;55;22;33;31;19;5;0;9wS2W
104;École doctorale Sciences de la matière, du rayonnement et de l'environnement;SMRE;2;Physique;2024;2023-24;2023;2023;9;2;7;43;10;33;17;5;12;10;7;0;0;Q5iFz
104;École doctorale Sciences de la matière, du rayonnement et de l'environnement;SMRE;10;Sciences agronomiques et écologiques;2024;2023-24;2023;2023;21;12;9;65;39;26;20;12;8;9;9;2;0;Q5iFz
127;École doctorale Astronomie et astrophysique d'Ile de France;A&A;3;Sciences de la terre et de l'univers, espace;2024;2023-24;2023;2023;55;21;34;183;66;117;55;18;37;44;10;0;1;cPXrq
129;École doctorale Sciences de l'environnement d'Ile de France;SEIF;7;Sciences de la société;2024;2023-24;2023;2023;0;0;0;1;0;1;0;0;0;0;0;0;0;TnAPh
130;École doctorale Informatique, télécommunications et électronique de Paris;EDITE;8;Sciences pour l'ingénieur;2024;2023-24;2023;2023;14;2;12;83;24;59;33;10;23;16;16;1;0;O5ysj
146;École doctorale Galilée;GALILEE;4;Chimie;2024;2023-24;2023;2023;3;2;1;5;4;1;3;3;0;1;2;0;0;71hqm
146;École doctorale Galilée;GALILEE;8;Sciences pour l'ingénieur;2024;2023-24;2023;2023;6;2;4;16;3;13;5;3;2;3;1;1;0;71hqm
160;École doctorale Électronique, électrotechnique, automatique;EEA;5;Biologie, médecine et santé;2024;2023-24;2023;2023;10;2;8;46;9;37;5;2;3;2;2;1;0;EgfMQ
160;École doctorale Électronique, électrotechnique, automatique;EEA;8;Sciences pour l'ingénieur;2024;2023-24;2023;2023;28;8;20;98;33;65;32;6;26;11;18;3;0;EgfMQ
162;École doctorale Mécanique, énergétique, génie civil, acoustique;MEGA;5;Biologie, médecine et santé;2024;2023-24;2023;2023;6;2;4;20;7;13;6;2;4;4;2;0;0;7wCke
166;École doctorale Information, structures et systèmes;I2S;1;Mathématiques et leurs interactions;2024;2023-24;2023;2023;17;4;13;69;23;46;13;6;7;6;4;2;1;2uO68
166;École doctorale Information, structures et systèmes;I2S;4;Chimie;2024;2023-24;2023;2023;0;0;0;0;0;0;3;2;1;2;1;0;0;2uO68
166;École doctorale Information, structures et systèmes;I2S;5;Biologie, médecine et santé;2024;2023-24;2023;2023;0;0;0;2;1;1;5;1;4;3;1;1;0;2uO68
166;École doctorale Information, structures et systèmes;I2S;9;Sciences et technologies de l'information et de la communication;2024;2023-24;2023;2023;60;16;44;152;45;107;23;7;16;18;4;1;0;2uO68
178;École doctorale Sciences fondamentales;;2;Physique;2024;2023-24;2023;2023;11;4;7;28;7;21;6;4;2;4;2;0;0;1AiR7
178;École doctorale Sciences fondamentales;;3;Sciences de la terre et de l'univers, espace;2024;2023-24;2023;2023;8;4;4;44;17;27;9;3;6;3;6;0;0;1AiR7
182;École doctorale Physique et chimie-physique;;4;Chimie;2024;2023-24;2023;2023;29;16;13;89;42;47;31;12;19;20;10;1;0;3My6I
184;École doctorale Mathématiques et informatique de Marseille;;1;Mathématiques et leurs interactions;2024;2023-24;2023;2023;29;8;21;115;30;85;20;4;16;6;10;4;0;DDObG
205;École doctorale Interdisciplinaire Sciences-Santé;EDISS;9;Sciences et technologies de l'information et de la communication;2024;2023-24;2023;2023;1;0;1;9;4;5;4;2;2;2;2;0;0;69W38
209;École doctorale Sciences physiques et de L'ingénieur;SPI;2;Physique;2024;2023-24;2023;2023;42;10;32;111;26;85;33;10;23;17;15;1;0;tZcIZ
211;École doctorale Sciences exactes et leurs applications;ED SEA;1;Mathématiques et leurs interactions;2024;2023-24;2023;2023;4;2;2;25;8;17;13;5;8;8;4;0;1;1G1iC
211;École doctorale Sciences exactes et leurs applications;ED SEA;3;Sciences de la terre et de l'univers, espace;2024;2023-24;2023;2023;5;3;2;19;7;12;6;5;1;5;1;0;0;1G1iC
211;École doctorale Sciences exactes et leurs applications;ED SEA;5;Biologie, médecine et santé;2024;2023-24;2023;2023;2;1;1;3;2;1;1;0;1;1;0;0;0;1G1iC
220;École doctorale Électronique, électrotechnique, automatique, traitement du signal;EEATS;9;Sciences et technologies de l'information et de la communication;2024;2023-24;2023;2023;88;18;70;321;65;256;76;21;55;33;36;7;0;IxEaw
224;École doctorale Cognition, langage, interaction;;8;Sciences pour l'ingénieur;2024;2023-24;2023;2023;0;0;0;5;5;0;5;2;3;0;3;1;1;7v43e
227;École doctorale Sciences de la nature et de l'homme;;5;Biologie, médecine et santé;2024;2023-24;2023;2023;31;15;16;109;57;52;28;15;13;14;13;1;0;xiDA5
242;École doctorale Économie - Gestion - Normandie;;7;Sciences de la société;2024;2023-24;2023;2023;10;6;4;61;28;33;11;4;7;3;2;4;2;z35ku
251;École doctorale Sciences de l'environnement;;8;Sciences pour l'ingénieur;2024;2023-24;2023;2023;0;0;0;0;0;0;2;2;0;1;1;0;0;VR28y
262;École doctorale Sciences juridiques, politiques, économiques et de gestion;DEG;7;Sciences de la société;2024;2023-24;2023;2023;20;9;11;135;65;70;20;8;12;2;3;4;11;H7GyL
269;École doctorale Mathématiques, sciences de l'information et de l'ingénieur;MSII;5;Biologie, médecine et santé;2024;2023-24;2023;2023;2;0;2;5;2;3;2;1;1;2;0;0;0;5E625
269;École doctorale Mathématiques, sciences de l'information et de l'ingénieur;MSII;9;Sciences et technologies de l'information et de la communication;2024;2023-24;2023;2023;14;2;12;46;8;38;13;4;9;5;8;0;0;5E625
270;École doctorale Théologie et sciences religieuses;;6;Sciences humaines et humanités;2024;2023-24;2023;2023;14;3;11;65;25;40;11;3;8;0;3;4;4;BRKC1
280;École doctorale Philosophie;;6;Sciences humaines et humanités;2024;2023-24;2023;2023;43;15;28;262;102;160;20;9;11;1;6;8;5;kJxnm
304;École doctorale Sciences et environnements;;6;Sciences humaines et humanités;2024;2023-24;2023;2023;2;1;1;21;14;7;5;4;1;1;3;1;0;2ywZn
323;École doctorale Génie électrique, électronique et télécommunications;GEET;2;Physique;2024;2023-24;2023;2023;19;9;10;36;14;22;5;1;4;3;2;0;0;arcz6
323;École doctorale Génie électrique, électronique et télécommunications;GEET;9;Sciences et technologies de l'information et de la communication;2024;2023-24;2023;2023;7;4;3;18;10;8;11;3;8;3;7;1;0;arcz6
326;École doctorale Comportement, langage, éducation, socialisation, cognition;CLESCO;7;Sciences de la société;2024;2023-24;2023;2023;1;1;0;8;6;2;1;1;0;0;1;0;0;nWIlG
326;École doctorale Comportement, langage, éducation, socialisation, cognition;CLESCO;9;Sciences et technologies de l'information et de la communication;2024;2023-24;2023;2023;2;1;1;2;1;1;0;0;0;0;0;0;0;nWIlG
327;École doctorale Temps, espaces, sociétés, cultures;TESC;7;Sciences de la société;2024;2023-24;2023;2023;25;10;15;91;54;37;12;7;5;1;1;5;5;IjgiJ
327;École doctorale Temps, espaces, sociétés, cultures;TESC;8;Sciences pour l'ingénieur;2024;2023-24;2023;2023;0;0;0;3;2;1;0;0;0;0;0;0;0;IjgiJ
355;École doctorale Espaces, cultures, sociétés;;7;Sciences de la société;2024;2023-24;2023;2023;9;5;4;65;34;31;10;7;3;0;3;5;2;2kMf5
361;École doctorale Sciences et Technologies;ED ST;2;Physique;2024;2023-24;2023;2023;5;1;4;33;13;20;11;4;7;1;4;5;1;cOUmL
364;École doctorale Sciences fondamentales et appliquées;EDSFA;1;Mathématiques et leurs interactions;2024;2023-24;2023;2023;25;5;20;76;12;64;26;6;20;18;7;1;0;E483q
377;École doctorale Environnement et société;;3;Sciences de la terre et de l'univers, espace;2024;2023-24;2023;2023;2;2;0;5;3;2;1;1;0;0;1;0;0;ZMG5u
377;École doctorale Environnement et société;;9;Sciences et technologies de l'information et de la communication;2024;2023-24;2023;2023;3;1;2;7;2;5;1;0;1;0;0;0;1;ZMG5u
388;École doctorale Chimie physique et chimie analytique de Paris centre;CPCA;4;Chimie;2024;2023-24;2023;2023;96;39;57;282;130;152;101;45;56;72;26;3;0;M0Hnd
398;École doctorale Géosciences, ressources naturelles et environnement;GRNE;9;Sciences et technologies de l'information et de la communication;2024;2023-24;2023;2023;0;0;0;1;0;1;0;0;0;0;0;0;0;Zi4Zf
401;École doctorale Sciences sociales;;7;Sciences de la société;2024;2023-24;2023;2023;28;16;12;148;79;69;12;6;6;4;0;5;3;raQ7K
405;École doctorale Économie, management,mathématiques et physique de Cergy;EM2C;9;Sciences et technologies de l'information et de la communication;2024;2023-24;2023;2023;23;9;14;63;22;41;13;1;12;6;4;3;0;QbwSB
406;École doctorale Chimie moléculaire de Paris centre;;4;Chimie;2024;2023-24;2023;2023;45;19;26;155;72;83;35;22;13;24;9;2;0;a5dKy
411;École doctorale Humanités nouvelles : Fernand Braudel;;6;Sciences humaines et humanités;2024;2023-24;2023;2023;39;22;17;211;111;100;36;14;22;1;9;15;11;l2rFh
413;École doctorale Sciences de la terre et de l'environnement;STE;10;Sciences agronomiques et écologiques;2024;2023-24;2023;2023;0;0;0;0;0;0;1;0;1;1;0;0;0;u9BA9
414;École doctorale Sciences de la vie et de la santé;;4;Chimie;2024;2023-24;2023;2023;0;0;0;2;2;0;2;2;0;0;2;0;0;YI4xS
414;École doctorale Sciences de la vie et de la santé;;5;Biologie, médecine et santé;2024;2023-24;2023;2023;134;83;51;469;271;198;139;79;60;49;77;13;0;YI4xS
417;École doctorale Sciences et Ingénierie;S&I;3;Sciences de la terre et de l'univers, espace;2024;2023-24;2023;2023;2;1;1;10;4;6;2;1;1;1;1;0;0;SSBvE
434;École doctorale Géographie de Paris - Espaces, sociétés, aménagement;EDGP;6;Sciences humaines et humanités;2024;2023-24;2023;2023;28;18;10;192;109;83;26;19;7;0;6;6;14;1FmLX
446;École doctorale Biologie - Santé;EDBSL;4;Chimie;2024;2023-24;2023;2023;4;1;3;6;1;5;5;3;2;2;2;1;0;4iEUF
450;École doctorale Recherches en psychanalyse et psychopathologie;PSY²;6;Sciences humaines et humanités;2024;2023-24;2023;2023;7;3;4;95;63;32;22;16;6;1;4;11;6;8jI3f
454;École doctorale Sciences de l'homme, du politique et du territoire;SHPT;6;Sciences humaines et humanités;2024;2023-24;2023;2023;22;12;10;170;91;79;28;16;12;1;4;12;11;Opv31
459;École doctorale Sciences chimiques Balard;;4;Chimie;2024;2023-24;2023;2023;81;43;38;242;119;123;78;38;40;55;20;3;0;YFs2W
459;École doctorale Sciences chimiques Balard;;8;Sciences pour l'ingénieur;2024;2023-24;2023;2023;2;2;0;9;3;6;1;0;1;0;1;0;0;YFs2W
463;École doctorale Sciences du mouvement humain;SMH;5;Biologie, médecine et santé;2024;2023-24;2023;2023;17;5;12;94;35;59;22;11;11;2;16;3;1;UbtlY
467;École doctorale Aéronautique, astronautique;AA;4;Chimie;2024;2023-24;2023;2023;0;0;0;1;0;1;0;0;0;0;0;0;0;U7l45
467;École doctorale Aéronautique, astronautique;AA;5;Biologie, médecine et santé;2024;2023-24;2023;2023;0;0;0;1;0;1;1;0;1;0;1;0;0;U7l45
467;École doctorale Aéronautique, astronautique;AA;6;Sciences humaines et humanités;2024;2023-24;2023;2023;0;0;0;2;1;1;2;1;1;2;0;0;0;U7l45
467;École doctorale Aéronautique, astronautique;AA;7;Sciences de la société;2024;2023-24;2023;2023;0;0;0;2;1;1;0;0;0;0;0;0;0;U7l45
468;École doctorale Mécanique, énergétique, génie civil, procédés;MEGEP;1;Mathématiques et leurs interactions;2024;2023-24;2023;2023;0;0;0;1;0;1;0;0;0;0;0;0;0;4XUTB
468;École doctorale Mécanique, énergétique, génie civil, procédés;MEGEP;2;Physique;2024;2023-24;2023;2023;0;0;0;3;1;2;0;0;0;0;0;0;0;4XUTB
468;École doctorale Mécanique, énergétique, génie civil, procédés;MEGEP;4;Chimie;2024;2023-24;2023;2023;1;1;0;1;1;0;0;0;0;0;0;0;0;4XUTB
469;École doctorale du Pacifique;EDP;5;Biologie, médecine et santé;2024;2023-24;2023;2023;3;2;1;13;10;3;1;1;0;1;0;0;0;t9Z2n
469;École doctorale du Pacifique;EDP;6;Sciences humaines et humanités;2024;2023-24;2023;2023;21;14;7;48;29;19;5;4;1;0;3;1;1;t9Z2n
472;École doctorale de l'EPHE;;7;Sciences de la société;2024;2023-24;2023;2023;9;4;5;39;18;21;0;0;0;0;0;0;0;27zK4
474;École doctorale Interdisciplinaire européenne frontières du vivant;FDV;3;Sciences de la terre et de l'univers, espace;2024;2023-24;2023;2023;3;2;1;15;8;7;5;3;2;0;2;3;0;E727j
482;École doctorale Sciences de la matière;SDM;8;Sciences pour l'ingénieur;2024;2023-24;2023;2023;8;3;5;33;14;19;10;5;5;5;5;0;0;kmeZ4
485;École doctorale Éducation, Psychologie, Information et Communication;EPIC;6;Sciences humaines et humanités;2024;2023-24;2023;2023;45;31;14;246;161;85;33;22;11;6;5;13;9;O82eL
488;École doctorale Sciences, ingénierie, santé;SIS;2;Physique;2024;2023-24;2023;2023;1;0;1;1;0;1;0;0;0;0;0;0;0;Fy2lK
488;École doctorale Sciences, ingénierie, santé;SIS;9;Sciences et technologies de l'information et de la communication;2024;2023-24;2023;2023;32;11;21;154;34;120;42;14;28;14;25;3;0;Fy2lK
493;École doctorale Erasme;;9;Sciences et technologies de l'information et de la communication;2024;2023-24;2023;2023;2;2;0;25;16;9;2;2;0;0;0;1;1;FPW4T
497;École doctorale Normande de Biologie Intégrative, Santé, Environnement;Ed NBISE;6;Sciences humaines et humanités;2024;2023-24;2023;2023;0;0;0;0;0;0;1;1;0;1;0;0;0;0D9Je
497;École doctorale Normande de Biologie Intégrative, Santé, Environnement;Ed NBISE;9;Sciences et technologies de l'information et de la communication;2024;2023-24;2023;2023;1;1;0;2;1;1;0;0;0;0;0;0;0;0D9Je
508;École doctorale Normande de chimie;EDNC;8;Sciences pour l'ingénieur;2024;2023-24;2023;2023;0;0;0;1;0;1;0;0;0;0;0;0;0;E52OO
510;École doctorale Ingénierie - Matériaux, mécanique, environnement, énergétique, procédés, production;IMEP2;2;Physique;2024;2023-24;2023;2023;1;0;1;1;0;1;0;0;0;0;0;0;0;Ce7NF
510;École doctorale Ingénierie - Matériaux, mécanique, environnement, énergétique, procédés, production;IMEP2;5;Biologie, médecine et santé;2024;2023-24;2023;2023;7;3;4;7;3;4;0;0;0;0;0;0;0;Ce7NF
512;École doctorale Informatique et mathématiques;InfoMaths;9;Sciences et technologies de l'information et de la communication;2024;2023-24;2023;2023;56;15;41;223;56;167;49;9;40;32;15;2;0;t86bi
513;École doctorale Droit et sciences politiques, économiques et de gestion;DESPEG;7;Sciences de la société;2024;2023-24;2023;2023;29;15;14;201;94;107;33;14;19;2;11;14;6;aVHGU
515;École doctorale Complexité du vivant;CdV;5;Biologie, médecine et santé;2024;2023-24;2023;2023;83;49;34;295;173;122;93;51;42;36;55;1;1;CbV9s
528;École doctorale Ville, transports et territoires;VTT;6;Sciences humaines et humanités;2024;2023-24;2023;2023;5;3;2;40;23;17;27;13;14;5;4;7;11;68zCc
531;École doctorale Sciences, ingénierie et environnement;SIE;6;Sciences humaines et humanités;2024;2023-24;2023;2023;2;0;2;2;0;2;0;0;0;0;0;0;0;b5BYq
532;École doctorale Mathématiques et sciences et technologies de l'information et de la communication;MSTIC;5;Biologie, médecine et santé;2024;2023-24;2023;2023;1;1;0;1;1;0;0;0;0;0;0;0;0;t43KM
536;École doctorale Sciences et agrosciences;;3;Sciences de la terre et de l'univers, espace;2024;2023-24;2023;2023;5;3;2;7;4;3;3;2;1;0;0;3;0;pHfqe
536;École doctorale Sciences et agrosciences;;5;Biologie, médecine et santé;2024;2023-24;2023;2023;4;2;2;15;9;6;4;1;3;4;0;0;0;pHfqe
536;École doctorale Sciences et agrosciences;;9;Sciences et technologies de l'information et de la communication;2024;2023-24;2023;2023;12;2;10;41;9;32;10;4;6;2;5;3;0;pHfqe
540;"École doctorale École transdisciplinaire ""lettres/sciences""";;7;Sciences de la société;2024;2023-24;2023;2023;2;1;1;14;6;8;3;2;1;0;1;1;1;tWWw7
540;"École doctorale École transdisciplinaire ""lettres/sciences""";;9;Sciences et technologies de l'information et de la communication;2024;2023-24;2023;2023;0;0;0;5;3;2;2;0;2;0;1;1;0;tWWw7
542;École doctorale de sciences de La Réunion;STS;3;Sciences de la terre et de l'univers, espace;2024;2023-24;2023;2023;1;0;1;5;2;3;0;0;0;0;0;0;0;2pAql
542;École doctorale de sciences de La Réunion;STS;4;Chimie;2024;2023-24;2023;2023;2;2;0;6;4;2;0;0;0;0;0;0;0;2pAql
545;École doctorale Sociétés, politique et santé publique;SP2;6;Sciences humaines et humanités;2024;2023-24;2023;2023;24;16;8;139;91;48;33;17;16;6;12;12;3;IAKR4
545;École doctorale Sociétés, politique et santé publique;SP2;7;Sciences de la société;2024;2023-24;2023;2023;16;7;9;120;58;62;14;7;7;1;3;7;3;IAKR4
546;École doctorale Abbé Grégoire;;6;Sciences humaines et humanités;2024;2023-24;2023;2023;60;34;26;266;156;110;43;24;19;8;5;11;19;ZSn7q
549;École doctorale Santé, Sciences Biologiques et Chimie du Vivant;SSBCV;2;Physique;2024;2023-24;2023;2023;0;0;0;1;0;1;1;1;0;1;0;0;0;B9ggO
549;École doctorale Santé, Sciences Biologiques et Chimie du Vivant;SSBCV;4;Chimie;2024;2023-24;2023;2023;8;5;3;38;21;17;12;5;7;8;4;0;0;B9ggO
549;École doctorale Santé, Sciences Biologiques et Chimie du Vivant;SSBCV;5;Biologie, médecine et santé;2024;2023-24;2023;2023;57;34;23;194;112;82;59;36;23;30;23;6;0;B9ggO
549;École doctorale Santé, Sciences Biologiques et Chimie du Vivant;SSBCV;6;Sciences humaines et humanités;2024;2023-24;2023;2023;1;1;0;6;5;1;3;3;0;2;0;1;0;B9ggO
554;École doctorale Environnements - Santé;E-S;10;Sciences agronomiques et écologiques;2024;2023-24;2023;2023;25;7;18;92;50;42;21;14;7;9;8;4;0;ElyFU
561;École doctorale Hématologie, Oncogenèse et Biothérapies;HOB;5;Biologie, médecine et santé;2024;2023-24;2023;2023;57;37;20;192;123;69;59;35;24;18;30;11;0;7Klb2
563;École doctorale Médicament - Toxicologie - Chimie - Imageries;MTCI;5;Biologie, médecine et santé;2024;2023-24;2023;2023;64;32;32;178;96;82;51;32;19;21;26;4;0;j8uk1
565;École doctorale Droit de la Sorbonne;DS;7;Sciences de la société;2024;2023-24;2023;2023;90;51;39;651;353;298;52;24;28;2;10;6;34;aXJ7L
566;École doctorale Sciences du Sport, de la Motricité et du Mouvement Humain;SMMH;7;Sciences de la société;2024;2023-24;2023;2023;0;0;0;4;3;1;1;0;1;0;0;1;0;3iv8y
567;École doctorale Sciences du Végétal : du gène à l'écosystème;;5;Biologie, médecine et santé;2024;2023-24;2023;2023;33;12;21;77;40;37;12;4;8;4;6;2;0;tuDkA
570;École doctorale Santé Publique;EDSP;1;Mathématiques et leurs interactions;2024;2023-24;2023;2023;0;0;0;4;1;3;0;0;0;0;0;0;0;9lgE4
573;École doctorale Interfaces : Approches Interdisciplinaires, Fondements, Applications et Innovation;ED INTERFACES;5;Biologie, médecine et santé;2024;2023-24;2023;2023;1;0;1;7;1;6;4;1;3;1;2;1;0;gG820
574;École doctorale de Mathématiques Hadamard;EDMH;1;Mathématiques et leurs interactions;2024;2023-24;2023;2023;101;26;75;349;71;278;91;20;71;63;24;3;1;4pqal
576;École doctorale Particules, Hadrons, Énergie, Noyau, Instrumentation, Imagerie, Cosmos et Simulation;PHENIICS;4;Chimie;2024;2023-24;2023;2023;0;0;0;0;0;0;1;1;0;0;1;0;0;qC4rf
580;École doctorale Sciences et technologies de l'information et de la communication;STIC;9;Sciences et technologies de l'information et de la communication;2024;2023-24;2023;2023;139;32;107;546;134;412;142;35;107;72;62;8;0;AzCC0
581;École doctorale Agriculture, alimentation, biologie, environnement, santé;ABIES;10;Sciences agronomiques et écologiques;2024;2023-24;2023;2023;32;17;15;121;68;53;37;19;18;21;16;0;0;c1x56
582;École doctorale Cancérologie, Biologie, Médecine, Santé;CBMS;8;Sciences pour l'ingénieur;2024;2023-24;2023;2023;0;0;0;1;1;0;0;0;0;0;0;0;0;75bj4
583;École doctorale Risques et Société;;3;Sciences de la terre et de l'univers, espace;2024;2023-24;2023;2023;2;2;0;7;4;3;0;0;0;0;0;0;0;wUBi9
583;École doctorale Risques et Société;;5;Biologie, médecine et santé;2024;2023-24;2023;2023;0;0;0;5;3;2;1;1;0;0;1;0;0;wUBi9
583;École doctorale Risques et Société;;7;Sciences de la société;2024;2023-24;2023;2023;5;2;3;15;6;9;0;0;0;0;0;0;0;wUBi9
583;École doctorale Risques et Société;;8;Sciences pour l'ingénieur;2024;2023-24;2023;2023;1;0;1;4;0;4;0;0;0;0;0;0;0;wUBi9
583;École doctorale Risques et Société;;9;Sciences et technologies de l'information et de la communication;2024;2023-24;2023;2023;0;0;0;2;0;2;0;0;0;0;0;0;0;wUBi9
584;École doctorale Biodiversité, Agriculture, Alimentation, Environnement, Terre, Eau;GAIA;5;Biologie, médecine et santé;2024;2023-24;2023;2023;51;22;29;163;97;66;20;12;8;12;8;0;0;F1h5f
584;École doctorale Biodiversité, Agriculture, Alimentation, Environnement, Terre, Eau;GAIA;8;Sciences pour l'ingénieur;2024;2023-24;2023;2023;0;0;0;1;1;0;1;0;1;0;1;0;0;F1h5f
586;École doctorale Sciences Humaines et Sociales;EDSHS;6;Sciences humaines et humanités;2024;2023-24;2023;2023;49;27;22;322;179;143;30;19;11;6;5;8;11;0RKVX
587;École doctorale Diversites, santé et développement en Amazonie;;1;Mathématiques et leurs interactions;2024;2023-24;2023;2023;0;0;0;1;1;0;0;0;0;0;0;0;0;V14tj
591;École doctorale Physique, Sciences de l'Ingenieur, Materiaux, Énergie;PSIME;3;Sciences de la terre et de l'univers, espace;2024;2023-24;2023;2023;3;0;3;11;3;8;1;1;0;0;1;0;0;Hn5Om
593;École doctorale Droit, Gestion, sciences Économiques et Politique;DGEP;7;Sciences de la société;2024;2023-24;2023;2023;42;27;15;219;98;121;35;10;25;5;5;10;15;41pAm
598;École doctorale Sciences de La Mer et du Littoral;SML;4;Chimie;2024;2023-24;2023;2023;1;1;0;2;2;0;0;0;0;0;0;0;0;Smen6
600;École doctorale Écologie, Géosciences, Agronomie et Alimentation;EGAAL;3;Sciences de la terre et de l'univers, espace;2024;2023-24;2023;2023;9;3;6;33;14;19;20;9;11;9;10;1;0;urS33
600;École doctorale Écologie, Géosciences, Agronomie et Alimentation;EGAAL;5;Biologie, médecine et santé;2024;2023-24;2023;2023;2;2;0;13;8;5;5;4;1;1;4;0;0;urS33
601;École doctorale Mathématiques et Sciences et Technologies de l'information et de la Communication;MathSTIC;1;Mathématiques et leurs interactions;2024;2023-24;2023;2023;17;3;14;64;10;54;17;3;14;13;4;0;0;3Ue20
601;École doctorale Mathématiques et Sciences et Technologies de l'information et de la Communication;MathSTIC;9;Sciences et technologies de l'information et de la communication;2024;2023-24;2023;2023;130;28;102;458;97;361;125;25;100;85;32;8;0;3Ue20
604;École doctorale Sociétés, Temps, Territoires;STT;6;Sciences humaines et humanités;2024;2023-24;2023;2023;14;5;9;85;44;41;19;10;9;3;7;7;2;SZI5T
604;École doctorale Sociétés, Temps, Territoires;STT;7;Sciences de la société;2024;2023-24;2023;2023;25;14;11;106;53;53;15;8;7;0;1;7;7;SZI5T
607;École doctorale Sciences et Ingénierie des Ressources Naturelles;SIReNA;3;Sciences de la terre et de l'univers, espace;2024;2023-24;2023;2023;22;10;12;73;28;45;21;9;12;8;10;3;0;vi9w2
608;École doctorale Sciences et Ingénierie des Molécules, des Produits, des Procédés et de l'Énergie;SIMPPÉ;4;Chimie;2024;2023-24;2023;2023;3;2;1;12;8;4;1;1;0;0;1;0;0;TyNjM
608;École doctorale Sciences et Ingénierie des Molécules, des Produits, des Procédés et de l'Énergie;SIMPPÉ;10;Sciences agronomiques et écologiques;2024;2023-24;2023;2023;3;2;1;13;4;9;2;2;0;1;1;0;0;TyNjM
617;École doctorale Sciences de la Société : Territoires, Economie et Droit;SSTED;7;Sciences de la société;2024;2023-24;2023;2023;36;20;16;185;86;99;26;15;11;1;9;11;5;Kl9ZX
618;École doctorale EUCLIDE;;5;Biologie, médecine et santé;2024;2023-24;2023;2023;0;0;0;5;3;2;2;1;1;1;1;0;0;qveTN
618;École doctorale EUCLIDE;;7;Sciences de la société;2024;2023-24;2023;2023;8;4;4;29;12;17;4;1;3;1;0;0;3;qveTN
618;École doctorale EUCLIDE;;10;Sciences agronomiques et écologiques;2024;2023-24;2023;2023;16;12;4;42;28;14;14;12;2;10;4;0;0;qveTN
620;École doctorale Sciences du Numérique et de l'Ingénieur;SNI;4;Chimie;2024;2023-24;2023;2023;0;0;0;1;1;0;0;0;0;0;0;0;0;Dr40w
622;École doctorale Sciences du langage;SDL;6;Sciences humaines et humanités;2024;2023-24;2023;2023;43;33;10;238;171;67;37;31;6;2;11;11;13;9DsG2
623;École doctorale Savoir, Sciences, Éducation;SSE;1;Mathématiques et leurs interactions;2024;2023-24;2023;2023;6;6;0;13;8;5;2;0;2;0;1;1;0;98lMD
625;École doctorale Mondes Anglophones, Germanophones, Iraniens, Indiens, et Études Européennes;MAGIIE;6;Sciences humaines et humanités;2024;2023-24;2023;2023;38;23;15;157;96;61;12;7;5;0;0;5;7;JiOMD
626;École doctorale de l’Institut Polytechnique de Paris;;3;Sciences de la terre et de l'univers, espace;2024;2023-24;2023;2023;2;1;1;10;6;4;4;2;2;0;4;0;0;DL5fO
626;École doctorale de l’Institut Polytechnique de Paris;;6;Sciences humaines et humanités;2024;2023-24;2023;2023;9;5;4;36;13;23;2;2;0;1;0;1;0;DL5fO
626;École doctorale de l’Institut Polytechnique de Paris;;8;Sciences pour l'ingénieur;2024;2023-24;2023;2023;48;5;43;130;26;104;33;13;20;17;16;0;0;DL5fO
626;École doctorale de l’Institut Polytechnique de Paris;;9;Sciences et technologies de l'information et de la communication;2024;2023-24;2023;2023;92;27;65;322;87;235;89;31;58;39;42;6;2;DL5fO
626;École doctorale de l’Institut Polytechnique de Paris;;10;Sciences agronomiques et écologiques;2024;2023-24;2023;2023;0;0;0;0;0;0;1;1;0;1;0;0;0;DL5fO
627;École doctorale Éducation, Didactiques, Cognition;EDC;6;Sciences humaines et humanités;2024;2023-24;2023;2023;6;4;2;16;10;6;1;1;0;0;1;0;0;dE3nH
627;École doctorale Éducation, Didactiques, Cognition;EDC;7;Sciences de la société;2024;2023-24;2023;2023;11;8;3;54;36;18;18;12;6;2;4;9;3;dE3nH
627;École doctorale Éducation, Didactiques, Cognition;EDC;9;Sciences et technologies de l'information et de la communication;2024;2023-24;2023;2023;1;0;1;2;1;1;0;0;0;0;0;0;0;dE3nH
631;École doctorale Mathématiques, sciences du numérique et de leurs interactions;MADIS;1;Mathématiques et leurs interactions;2024;2023-24;2023;2023;12;4;8;38;9;29;13;5;8;9;4;0;0;OImap
631;École doctorale Mathématiques, sciences du numérique et de leurs interactions;MADIS;9;Sciences et technologies de l'information et de la communication;2024;2023-24;2023;2023;60;22;38;209;56;153;52;17;35;31;16;5;0;OImap
632;École doctorale Science de l’ingénierie et des systèmes;ENGSYS;9;Sciences et technologies de l'information et de la communication;2024;2023-24;2023;2023;30;10;20;106;30;76;40;9;31;19;18;3;0;1jT2e
634;École doctorale Sciences, Ingénierie, Environnement;SIE;4;Chimie;2024;2023-24;2023;2023;2;1;1;8;5;3;1;0;1;0;1;0;0;TOc8f
635;École doctorale Polytechnique Hauts-de-France;PHF;8;Sciences pour l'ingénieur;2024;2023-24;2023;2023;10;4;6;51;14;37;8;2;6;2;5;1;0;p2m23
636;École doctorale Dynamique des environnements dans l'espace Caraïbes-Amériques;;4;Chimie;2024;2023-24;2023;2023;3;1;2;16;9;7;5;4;1;2;2;1;0;s0yax
640;École doctorale Sciences économiques et sciences de gestion - Pays de la Loire;EDGE;7;Sciences de la société;2024;2023-24;2023;2023;15;10;5;68;41;27;16;6;10;4;7;2;3;3sae7
642;École doctorale Végétal, Animal, Aliment, Mer, Environnement;VAAME;10;Sciences agronomiques et écologiques;2024;2023-24;2023;2023;26;15;11;67;40;27;29;16;13;16;12;1;0;jcs9y
643;École doctorale Arts, Lettres, Langues;;6;Sciences humaines et humanités;2024;2023-24;2023;2023;23;19;4;100;74;26;25;17;8;5;6;5;9;fjau4
645;École doctorale Espaces, Sociétés, Civilisations;ESC;6;Sciences humaines et humanités;2024;2023-24;2023;2023;28;12;16;175;81;94;25;12;13;5;5;11;4;3wapo
649;École doctorale Rosalind Franklin : Énergie, Environnement, Bio-santé;;4;Chimie;2024;2023-24;2023;2023;23;9;14;67;25;42;14;8;6;11;2;1;0;jxkg9
650;École doctorale Humains en Société;;6;Sciences humaines et humanités;2024;2023-24;2023;2023;11;6;5;102;61;41;18;10;8;6;6;4;2;llpbd
651;École doctorale Mathématiques, Informatique, Matériaux, Mécanique, Énergétique;MIMME;9;Sciences et technologies de l'information et de la communication;2024;2023-24;2023;2023;15;1;14;41;6;35;12;4;8;4;4;4;0;6qq6f
653;École doctorale Sciences et Ingénierie;S&I;8;Sciences pour l'ingénieur;2024;2023-24;2023;2023;2;1;1;5;3;2;3;1;2;2;1;0;0;vpw2d
653;École doctorale Sciences et Ingénierie;S&I;9;Sciences et technologies de l'information et de la communication;2024;2023-24;2023;2023;33;13;20;120;38;82;29;12;17;14;11;4;0;vpw2d
654;École doctorale Littératures, Sciences Humaines et Sociales;SHS;6;Sciences humaines et humanités;2024;2023-24;2023;2023;20;9;11;120;69;51;14;9;5;2;6;3;3;k2ywn
31;École doctorale Pratiques et théories du sens;;7;Sciences de la société;2024;2023-24;2023;2023;53;34;19;118;78;40;15;8;7;1;0;2;12;1S466
34;École doctorale Matériaux;;8;Sciences pour l'ingénieur;2024;2023-24;2023;2023;48;17;31;131;43;88;38;12;26;16;19;2;1;1Iufh
37;École doctorale Sciences physiques pour l'ingénieur et microtechniques;SPIM;9;Sciences et technologies de l'information et de la communication;2024;2023-24;2023;2023;40;9;31;197;46;151;51;19;32;19;23;9;0;F7G1B
40;École doctorale Sciences chimiques;EDSC;8;Sciences pour l'ingénieur;2024;2023-24;2023;2023;2;1;1;2;1;1;0;0;0;0;0;0;0;wde3D
47;École doctorale Physique;;2;Physique;2024;2023-24;2023;2023;110;36;74;347;87;260;98;24;74;44;43;11;0;8kNpd
60;École doctorale Territoires, temps, sociétés et développement;TTSD;7;Sciences de la société;2024;2023-24;2023;2023;21;14;7;97;62;35;16;9;7;2;0;5;9;fkIh6
71;École doctorale Sciences pour l'ingénieur;;7;Sciences de la société;2024;2023-24;2023;2023;3;2;1;8;6;2;2;1;1;1;0;0;1;H6UYp
71;École doctorale Sciences pour l'ingénieur;;8;Sciences pour l'ingénieur;2024;2023-24;2023;2023;44;19;25;176;70;106;44;11;33;18;22;4;0;H6UYp
73;École doctorale Sciences économiques, sociales, de l'aménagement et du management;SESAM;1;Mathématiques et leurs interactions;2024;2023-24;2023;2023;0;0;0;1;0;1;0;0;0;0;0;0;0;IQ0Hk
77;École doctorale Informatique, automatique, électronique, électrotechnique, mathématiques;IAEM;8;Sciences pour l'ingénieur;2024;2023-24;2023;2023;8;2;6;28;4;24;8;3;5;5;2;1;0;TCHTA
77;École doctorale Informatique, automatique, électronique, électrotechnique, mathématiques;IAEM;9;Sciences et technologies de l'information et de la communication;2024;2023-24;2023;2023;72;21;51;250;77;173;77;22;55;33;32;12;0;TCHTA
86;École doctorale Sociétés, humanités, arts, lettres;LSHS;6;Sciences humaines et humanités;2024;2023-24;2023;2023;49;27;22;277;167;110;44;31;13;4;10;19;11;O8E6y
98;École doctorale Droit-Normandie;EDDN;7;Sciences de la société;2024;2023-24;2023;2023;26;14;12;111;47;64;9;3;6;0;0;4;5;9fYyW
101;École doctorale de Sciences juridiques;;7;Sciences de la société;2024;2023-24;2023;2023;21;17;4;160;79;81;18;12;6;0;2;7;9;569G2
104;École doctorale Sciences de la matière, du rayonnement et de l'environnement;SMRE;4;Chimie;2024;2023-24;2023;2023;61;35;26;185;80;105;61;30;31;33;20;7;1;Q5iFz
113;École doctorale Histoire;;6;Sciences humaines et humanités;2024;2023-24;2023;2023;43;20;23;256;113;143;38;21;17;1;7;8;22;G5wHs
129;École doctorale Sciences de l'environnement d'Ile de France;SEIF;1;Mathématiques et leurs interactions;2024;2023-24;2023;2023;0;0;0;1;0;1;0;0;0;0;0;0;0;TnAPh
129;École doctorale Sciences de l'environnement d'Ile de France;SEIF;4;Chimie;2024;2023-24;2023;2023;0;0;0;0;0;0;1;1;0;0;1;0;0;TnAPh
130;École doctorale Informatique, télécommunications et électronique de Paris;EDITE;3;Sciences de la terre et de l'univers, espace;2024;2023-24;2023;2023;0;0;0;1;0;1;0;0;0;0;0;0;0;O5ysj
131;École doctorale Langue, littérature, image, civilisations et sciences humaines (domaines francophone et anglophone);LLI;6;Sciences humaines et humanités;2024;2023-24;2023;2023;23;13;10;153;104;49;16;8;8;0;5;2;9;a47aW
138;École doctorale Lettres, langues, spectacles;LLS;6;Sciences humaines et humanités;2024;2023-24;2023;2023;34;20;14;216;129;87;19;15;4;2;3;8;6;y9O3k
139;École doctorale Connaissance, langage, modélisation;CLM;6;Sciences humaines et humanités;2024;2023-24;2023;2023;57;35;22;251;143;108;44;30;14;5;16;10;13;1lxGH
146;École doctorale Galilée;GALILEE;1;Mathématiques et leurs interactions;2024;2023-24;2023;2023;8;2;6;33;9;24;10;2;8;6;3;1;0;71hqm
146;École doctorale Galilée;GALILEE;2;Physique;2024;2023-24;2023;2023;21;8;13;66;26;40;13;1;12;4;6;3;0;71hqm
151;École doctorale Biologie, santé, biotechnologies;;5;Biologie, médecine et santé;2024;2023-24;2023;2023;105;73;32;418;285;133;101;70;31;30;57;13;1;yP8w4
154;École doctorale Sciences de la vie et de la santé;SVS;5;Biologie, médecine et santé;2024;2023-24;2023;2023;119;76;43;414;263;151;109;54;55;43;59;7;0;hLn36
158;École doctorale Cerveau, cognition, comportement;3C;6;Sciences humaines et humanités;2024;2023-24;2023;2023;0;0;0;3;3;0;4;2;2;3;1;0;0;Il62F
159;École doctorale Esthétique, sciences et technologies des arts;EDESTA;6;Sciences humaines et humanités;2024;2023-24;2023;2023;31;17;14;201;127;74;26;14;12;0;3;8;15;zj1Vj
166;École doctorale Information, structures et systèmes;I2S;8;Sciences pour l'ingénieur;2024;2023-24;2023;2023;29;8;21;111;28;83;30;8;22;17;11;1;1;2uO68
173;École doctorale Sciences de l'univers, de l'environnement et de l'espace;SDU2E;3;Sciences de la terre et de l'univers, espace;2024;2023-24;2023;2023;65;29;36;228;94;134;75;31;44;43;31;1;0;R0Z9c
173;École doctorale Sciences de l'univers, de l'environnement et de l'espace;SDU2E;5;Biologie, médecine et santé;2024;2023-24;2023;2023;1;1;0;3;2;1;0;0;0;0;0;0;0;R0Z9c
173;École doctorale Sciences de l'univers, de l'environnement et de l'espace;SDU2E;8;Sciences pour l'ingénieur;2024;2023-24;2023;2023;5;2;3;12;4;8;0;0;0;0;0;0;0;R0Z9c
206;École doctorale Chimie : chimie, procédés, environnement;;4;Chimie;2024;2023-24;2023;2023;95;46;49;331;154;177;71;29;42;51;16;4;0;m0UhD
209;École doctorale Sciences physiques et de L'ingénieur;SPI;3;Sciences de la terre et de l'univers, espace;2024;2023-24;2023;2023;2;1;1;11;5;6;3;1;2;3;0;0;0;tZcIZ
209;École doctorale Sciences physiques et de L'ingénieur;SPI;8;Sciences pour l'ingénieur;2024;2023-24;2023;2023;24;7;17;84;23;61;20;7;13;11;8;0;1;tZcIZ
211;École doctorale Sciences exactes et leurs applications;ED SEA;2;Physique;2024;2023-24;2023;2023;3;2;1;17;4;13;5;0;5;3;2;0;0;1G1iC
211;École doctorale Sciences exactes et leurs applications;ED SEA;8;Sciences pour l'ingénieur;2024;2023-24;2023;2023;15;5;10;70;18;52;22;10;12;11;9;2;0;1G1iC
216;École doctorale Ingénierie pour la santé, la cognition, l'environnement;EDISCE;2;Physique;2024;2023-24;2023;2023;0;0;0;1;1;0;0;0;0;0;0;0;0;fPs1t
217;École doctorale Mathématiques, sciences et technologies de l'information, informatique;MSTII;1;Mathématiques et leurs interactions;2024;2023-24;2023;2023;35;7;28;110;24;86;26;7;19;15;11;0;0;Ehx7v
217;École doctorale Mathématiques, sciences et technologies de l'information, informatique;MSTII;9;Sciences et technologies de l'information et de la communication;2024;2023-24;2023;2023;63;9;54;235;43;192;72;18;54;31;35;6;0;Ehx7v
218;École doctorale Chimie et sciences du vivant;EDCSV;5;Biologie, médecine et santé;2024;2023-24;2023;2023;58;31;27;214;138;76;72;46;26;32;33;6;1;8bcJh
220;École doctorale Électronique, électrotechnique, automatique, traitement du signal;EEATS;2;Physique;2024;2023-24;2023;2023;0;0;0;1;0;1;0;0;0;0;0;0;0;IxEaw
220;École doctorale Électronique, électrotechnique, automatique, traitement du signal;EEATS;8;Sciences pour l'ingénieur;2024;2023-24;2023;2023;24;5;19;86;17;69;23;4;19;13;8;2;0;IxEaw
227;École doctorale Sciences de la nature et de l'homme;;4;Chimie;2024;2023-24;2023;2023;2;2;0;7;4;3;4;1;3;4;0;0;0;xiDA5
227;École doctorale Sciences de la nature et de l'homme;;7;Sciences de la société;2024;2023-24;2023;2023;0;0;0;8;5;3;1;1;0;0;0;0;1;xiDA5
251;École doctorale Sciences de l'environnement;;10;Sciences agronomiques et écologiques;2024;2023-24;2023;2023;9;6;3;47;27;20;15;8;7;4;9;2;0;VR28y
266;École doctorale Biologie, santé, environnement;BIOSE;5;Biologie, médecine et santé;2024;2023-24;2023;2023;39;24;15;158;87;71;33;19;14;20;13;0;0;386V9
269;École doctorale Mathématiques, sciences de l'information et de l'ingénieur;MSII;1;Mathématiques et leurs interactions;2024;2023-24;2023;2023;32;10;22;107;22;85;26;6;20;15;10;1;0;5E625
305;École doctorale Énergie et environnement;E2;4;Chimie;2024;2023-24;2023;2023;3;0;3;10;4;6;4;3;1;0;2;2;0;Kbt8I
305;École doctorale Énergie et environnement;E2;5;Biologie, médecine et santé;2024;2023-24;2023;2023;8;5;3;36;18;18;11;3;8;6;5;0;0;Kbt8I
327;École doctorale Temps, espaces, sociétés, cultures;TESC;1;Mathématiques et leurs interactions;2024;2023-24;2023;2023;1;0;1;1;0;1;0;0;0;0;0;0;0;IjgiJ
327;École doctorale Temps, espaces, sociétés, cultures;TESC;9;Sciences et technologies de l'information et de la communication;2024;2023-24;2023;2023;0;0;0;1;1;0;0;0;0;0;0;0;0;IjgiJ
327;École doctorale Temps, espaces, sociétés, cultures;TESC;10;Sciences agronomiques et écologiques;2024;2023-24;2023;2023;0;0;0;4;3;1;2;2;0;0;1;1;0;IjgiJ
328;École doctorale Arts, lettres, langues, philosophie et communication;ALLPH@;6;Sciences humaines et humanités;2024;2023-24;2023;2023;48;28;20;330;210;120;40;27;13;1;4;17;18;xLxMh
328;École doctorale Arts, lettres, langues, philosophie et communication;ALLPH@;7;Sciences de la société;2024;2023-24;2023;2023;2;1;1;11;7;4;0;0;0;0;0;0;0;xLxMh
328;École doctorale Arts, lettres, langues, philosophie et communication;ALLPH@;9;Sciences et technologies de l'information et de la communication;2024;2023-24;2023;2023;8;6;2;34;20;14;4;2;2;0;1;2;1;xLxMh
361;École doctorale Sciences et Technologies;ED ST;10;Sciences agronomiques et écologiques;2024;2023-24;2023;2023;2;0;2;13;8;5;2;1;1;1;1;0;0;cOUmL
364;École doctorale Sciences fondamentales et appliquées;EDSFA;4;Chimie;2024;2023-24;2023;2023;15;10;5;64;35;29;15;7;8;7;8;0;0;E483q
391;École doctorale Sciences mécaniques, acoustique et électronique et robotique de Paris;SMAER;8;Sciences pour l'ingénieur;2024;2023-24;2023;2023;49;12;37;169;35;134;55;22;33;28;24;2;1;k0eue
405;École doctorale Économie, management,mathématiques et physique de Cergy;EM2C;2;Physique;2024;2023-24;2023;2023;8;4;4;24;9;15;0;0;0;0;0;0;0;QbwSB
413;École doctorale Sciences de la terre et de l'environnement;STE;8;Sciences pour l'ingénieur;2024;2023-24;2023;2023;1;0;1;2;0;2;0;0;0;0;0;0;0;u9BA9
414;École doctorale Sciences de la vie et de la santé;;10;Sciences agronomiques et écologiques;2024;2023-24;2023;2023;3;2;1;9;8;1;4;3;1;2;2;0;0;YI4xS
417;École doctorale Sciences et Ingénierie;S&I;4;Chimie;2024;2023-24;2023;2023;9;5;4;33;15;18;8;2;6;2;5;1;0;SSBvE
433;École doctorale Concepts et langages;;7;Sciences de la société;2024;2023-24;2023;2023;5;3;2;22;10;12;0;0;0;0;0;0;0;v8q34
455;École doctorale Économie, Gestion, Information et Communication;EGIC;7;Sciences de la société;2024;2023-24;2023;2023;22;13;9;84;32;52;14;6;8;6;5;3;0;qCOg3
455;École doctorale Économie, Gestion, Information et Communication;EGIC;9;Sciences et technologies de l'information et de la communication;2024;2023-24;2023;2023;7;4;3;16;9;7;2;0;2;1;0;0;1;qCOg3
467;École doctorale Aéronautique, astronautique;AA;2;Physique;2024;2023-24;2023;2023;0;0;0;1;1;0;1;1;0;1;0;0;0;U7l45
467;École doctorale Aéronautique, astronautique;AA;3;Sciences de la terre et de l'univers, espace;2024;2023-24;2023;2023;0;0;0;2;1;1;1;0;1;1;0;0;0;U7l45
467;École doctorale Aéronautique, astronautique;AA;8;Sciences pour l'ingénieur;2024;2023-24;2023;2023;0;0;0;14;3;11;4;1;3;3;1;0;0;U7l45
468;École doctorale Mécanique, énergétique, génie civil, procédés;MEGEP;10;Sciences agronomiques et écologiques;2024;2023-24;2023;2023;1;0;1;1;0;1;2;1;1;0;2;0;0;4XUTB
469;École doctorale du Pacifique;EDP;4;Chimie;2024;2023-24;2023;2023;2;1;1;6;3;3;1;1;0;0;0;1;0;t9Z2n
469;École doctorale du Pacifique;EDP;10;Sciences agronomiques et écologiques;2024;2023-24;2023;2023;3;2;1;15;8;7;5;4;1;0;4;1;0;t9Z2n
472;École doctorale de l'EPHE;;3;Sciences de la terre et de l'univers, espace;2024;2023-24;2023;2023;1;0;1;9;7;2;0;0;0;0;0;0;0;27zK4
472;École doctorale de l'EPHE;;9;Sciences et technologies de l'information et de la communication;2024;2023-24;2023;2023;0;0;0;4;2;2;2;0;2;0;0;2;0;27zK4
473;École doctorale Sciences de l'homme et de la société;SHS;6;Sciences humaines et humanités;2024;2023-24;2023;2023;107;70;37;518;314;204;66;38;28;3;11;29;23;8qKD9
474;École doctorale Interdisciplinaire européenne frontières du vivant;FDV;2;Physique;2024;2023-24;2023;2023;1;0;1;6;1;5;1;0;1;0;1;0;0;E727j
474;École doctorale Interdisciplinaire européenne frontières du vivant;FDV;10;Sciences agronomiques et écologiques;2024;2023-24;2023;2023;0;0;0;5;2;3;1;1;0;0;1;0;0;E727j
475;École doctorale Mathématiques, informatique, télécommunications de Toulouse;MITT;1;Mathématiques et leurs interactions;2024;2023-24;2023;2023;49;9;40;148;25;123;46;7;39;28;14;3;1;xcp2r
479;École doctorale Sciences juridiques et politiques;;7;Sciences de la société;2024;2023-24;2023;2023;42;21;21;291;156;135;35;22;13;1;2;7;25;34mid
480;École doctorale Montaigne-humanités;;3;Sciences de la terre et de l'univers, espace;2024;2023-24;2023;2023;0;0;0;4;2;2;2;0;2;0;2;0;0;f3SeZ
482;École doctorale Sciences de la matière;SDM;3;Sciences de la terre et de l'univers, espace;2024;2023-24;2023;2023;1;0;1;1;0;1;0;0;0;0;0;0;0;kmeZ4
482;École doctorale Sciences de la matière;SDM;10;Sciences agronomiques et écologiques;2024;2023-24;2023;2023;1;1;0;1;1;0;0;0;0;0;0;0;0;kmeZ4
483;École doctorale Histoire, géographie, aménagement, urbanisme, archéologie, science politique, sociologie, anthropologie;SCSO;7;Sciences de la société;2024;2023-24;2023;2023;23;12;11;196;116;80;46;26;20;0;3;15;28;hc6u4
485;École doctorale Éducation, Psychologie, Information et Communication;EPIC;9;Sciences et technologies de l'information et de la communication;2024;2023-24;2023;2023;0;0;0;2;0;2;0;0;0;0;0;0;0;O82eL
492;École doctorale Droit;;7;Sciences de la société;2024;2023-24;2023;2023;35;18;17;265;140;125;34;15;19;2;2;13;17;kOQsX
493;École doctorale Erasme;;6;Sciences humaines et humanités;2024;2023-24;2023;2023;15;10;5;87;60;27;12;9;3;1;3;3;5;FPW4T
497;École doctorale Normande de Biologie Intégrative, Santé, Environnement;Ed NBISE;3;Sciences de la terre et de l'univers, espace;2024;2023-24;2023;2023;3;0;3;7;0;7;1;1;0;0;1;0;0;0D9Je
509;École doctorale Civilisations et sociétés euro-méditerranéennes et comparées;;6;Sciences humaines et humanités;2024;2023-24;2023;2023;12;7;5;47;29;18;5;0;5;0;2;1;2;9tbyG
512;École doctorale Informatique et mathématiques;InfoMaths;1;Mathématiques et leurs interactions;2024;2023-24;2023;2023;26;5;21;99;17;82;20;3;17;13;6;1;0;t86bi
515;École doctorale Complexité du vivant;CdV;9;Sciences et technologies de l'information et de la communication;2024;2023-24;2023;2023;0;0;0;0;0;0;1;0;1;1;0;0;0;CbV9s
528;École doctorale Ville, transports et territoires;VTT;7;Sciences de la société;2024;2023-24;2023;2023;24;13;11;118;63;55;12;8;4;1;6;4;1;68zCc
531;École doctorale Sciences, ingénierie et environnement;SIE;1;Mathématiques et leurs interactions;2024;2023-24;2023;2023;1;0;1;1;0;1;0;0;0;0;0;0;0;b5BYq
531;École doctorale Sciences, ingénierie et environnement;SIE;2;Physique;2024;2023-24;2023;2023;10;3;7;28;10;18;4;1;3;3;1;0;0;b5BYq
531;École doctorale Sciences, ingénierie et environnement;SIE;10;Sciences agronomiques et écologiques;2024;2023-24;2023;2023;1;0;1;23;10;13;6;4;2;3;3;0;0;b5BYq
532;École doctorale Mathématiques et sciences et technologies de l'information et de la communication;MSTIC;1;Mathématiques et leurs interactions;2024;2023-24;2023;2023;28;12;16;92;27;65;21;4;17;14;6;1;0;t43KM
536;École doctorale Sciences et agrosciences;;10;Sciences agronomiques et écologiques;2024;2023-24;2023;2023;8;6;2;36;22;14;11;5;6;1;9;1;0;pHfqe
540;"École doctorale École transdisciplinaire ""lettres/sciences""";;1;Mathématiques et leurs interactions;2024;2023-24;2023;2023;0;0;0;0;0;0;1;0;1;0;0;1;0;tWWw7
540;"École doctorale École transdisciplinaire ""lettres/sciences""";;3;Sciences de la terre et de l'univers, espace;2024;2023-24;2023;2023;0;0;0;2;1;1;0;0;0;0;0;0;0;tWWw7
540;"École doctorale École transdisciplinaire ""lettres/sciences""";;5;Biologie, médecine et santé;2024;2023-24;2023;2023;1;1;0;6;4;2;0;0;0;0;0;0;0;tWWw7
540;"École doctorale École transdisciplinaire ""lettres/sciences""";;6;Sciences humaines et humanités;2024;2023-24;2023;2023;44;17;27;209;95;114;26;10;16;1;4;4;17;tWWw7
542;École doctorale de sciences de La Réunion;STS;1;Mathématiques et leurs interactions;2024;2023-24;2023;2023;1;0;1;4;2;2;0;0;0;0;0;0;0;2pAql
542;École doctorale de sciences de La Réunion;STS;5;Biologie, médecine et santé;2024;2023-24;2023;2023;17;9;8;67;38;29;18;9;9;4;11;3;0;2pAql
542;École doctorale de sciences de La Réunion;STS;8;Sciences pour l'ingénieur;2024;2023-24;2023;2023;1;1;0;9;1;8;3;2;1;0;2;1;0;2pAql
548;École doctorale Mer et Sciences;;4;Chimie;2024;2023-24;2023;2023;5;1;4;18;7;11;2;1;1;1;1;0;0;QX0fS
549;École doctorale Santé, Sciences Biologiques et Chimie du Vivant;SSBCV;10;Sciences agronomiques et écologiques;2024;2023-24;2023;2023;0;0;0;5;4;1;2;2;0;1;1;0;0;B9ggO
551;École doctorale Mathématiques, Informatique, Physique Théorique et Ingénierie des Systèmes;MIPTIS;2;Physique;2024;2023-24;2023;2023;1;0;1;5;2;3;6;0;6;1;1;3;1;Mpudz
552;École doctorale Énergie - Matériaux - Sciences de la Terre et de l'Univers;EMTSU;3;Sciences de la terre et de l'univers, espace;2024;2023-24;2023;2023;12;2;10;55;19;36;16;5;11;4;10;2;0;NTZhw
553;École doctorale Carnot - Pasteur;;1;Mathématiques et leurs interactions;2024;2023-24;2023;2023;15;3;12;44;10;34;24;5;19;12;10;1;1;6h4Z7
554;École doctorale Environnements - Santé;E-S;5;Biologie, médecine et santé;2024;2023-24;2023;2023;58;29;29;246;134;112;83;41;42;34;39;10;0;ElyFU
555;École doctorale Sciences de l'Homme et de la Société;SHS;5;Biologie, médecine et santé;2024;2023-24;2023;2023;0;0;0;0;0;0;3;1;2;0;1;1;1;44G6m
555;École doctorale Sciences de l'Homme et de la Société;SHS;7;Sciences de la société;2024;2023-24;2023;2023;10;2;8;95;39;56;21;11;10;3;8;7;3;44G6m
556;École doctorale Homme, Sociétés, Risques, Territoire;HSRT;6;Sciences humaines et humanités;2024;2023-24;2023;2023;5;2;3;45;25;20;8;4;4;0;0;4;4;5QEaX
566;École doctorale Sciences du Sport, de la Motricité et du Mouvement Humain;SMMH;1;Mathématiques et leurs interactions;2024;2023-24;2023;2023;1;0;1;1;0;1;0;0;0;0;0;0;0;3iv8y
566;École doctorale Sciences du Sport, de la Motricité et du Mouvement Humain;SMMH;5;Biologie, médecine et santé;2024;2023-24;2023;2023;24;17;7;68;42;26;10;2;8;3;2;4;1;3iv8y
567;École doctorale Sciences du Végétal : du gène à l'écosystème;;10;Sciences agronomiques et écologiques;2024;2023-24;2023;2023;0;0;0;38;23;15;18;11;7;11;7;0;0;tuDkA
573;École doctorale Interfaces : Approches Interdisciplinaires, Fondements, Applications et Innovation;ED INTERFACES;4;Chimie;2024;2023-24;2023;2023;3;0;3;7;2;5;7;4;3;3;4;0;0;gG820
575;École doctorale Electrical, Optical, Bio : Physics and Engineering;EOBE;3;Sciences de la terre et de l'univers, espace;2024;2023-24;2023;2023;0;0;0;1;0;1;0;0;0;0;0;0;0;dfhyn
575;École doctorale Electrical, Optical, Bio : Physics and Engineering;EOBE;5;Biologie, médecine et santé;2024;2023-24;2023;2023;0;0;0;9;4;5;3;3;0;1;2;0;0;dfhyn
576;École doctorale Particules, Hadrons, Énergie, Noyau, Instrumentation, Imagerie, Cosmos et Simulation;PHENIICS;8;Sciences pour l'ingénieur;2024;2023-24;2023;2023;2;1;1;3;2;1;0;0;0;0;0;0;0;qC4rf
579;École doctorale Sciences mécaniques et energétiques, matériaux et géosciences;SMEMaG;5;Biologie, médecine et santé;2024;2023-24;2023;2023;2;0;2;9;1;8;2;0;2;1;0;1;0;atMj7
581;École doctorale Agriculture, alimentation, biologie, environnement, santé;ABIES;3;Sciences de la terre et de l'univers, espace;2024;2023-24;2023;2023;1;0;1;2;0;2;1;0;1;1;0;0;0;c1x56
581;École doctorale Agriculture, alimentation, biologie, environnement, santé;ABIES;4;Chimie;2024;2023-24;2023;2023;7;2;5;21;9;12;9;5;4;6;3;0;0;c1x56
581;École doctorale Agriculture, alimentation, biologie, environnement, santé;ABIES;7;Sciences de la société;2024;2023-24;2023;2023;7;2;5;43;20;23;5;4;1;1;4;0;0;c1x56
582;École doctorale Cancérologie, Biologie, Médecine, Santé;CBMS;1;Mathématiques et leurs interactions;2024;2023-24;2023;2023;0;0;0;2;1;1;0;0;0;0;0;0;0;75bj4
583;École doctorale Risques et Société;;1;Mathématiques et leurs interactions;2024;2023-24;2023;2023;0;0;0;1;0;1;0;0;0;0;0;0;0;wUBi9
583;École doctorale Risques et Société;;4;Chimie;2024;2023-24;2023;2023;0;0;0;3;1;2;1;0;1;1;0;0;0;wUBi9
584;École doctorale Biodiversité, Agriculture, Alimentation, Environnement, Terre, Eau;GAIA;3;Sciences de la terre et de l'univers, espace;2024;2023-24;2023;2023;34;21;13;98;53;45;16;8;8;6;10;0;0;F1h5f
585;École doctorale Sciences, Technologie,  Sante;EDSTS;3;Sciences de la terre et de l'univers, espace;2024;2023-24;2023;2023;5;2;3;6;3;3;2;2;0;2;0;0;0;NM3Dl
585;École doctorale Sciences, Technologie,  Sante;EDSTS;8;Sciences pour l'ingénieur;2024;2023-24;2023;2023;18;3;15;60;22;38;16;6;10;7;5;3;1;NM3Dl
585;École doctorale Sciences, Technologie,  Sante;EDSTS;10;Sciences agronomiques et écologiques;2024;2023-24;2023;2023;20;9;11;68;35;33;14;9;5;6;7;1;0;NM3Dl
592;École doctorale Lettres, Communication, Langues, Arts;LECLA;6;Sciences humaines et humanités;2024;2023-24;2023;2023;36;20;16;166;105;61;32;19;13;4;7;11;10;sY7f3
598;École doctorale Sciences de La Mer et du Littoral;SML;5;Biologie, médecine et santé;2024;2023-24;2023;2023;8;6;2;30;21;9;5;3;2;0;4;1;0;Smen6
599;École doctorale Droit et Science Politique;DSP;7;Sciences de la société;2024;2023-24;2023;2023;22;9;13;148;70;78;20;10;10;0;3;7;10;6rwtT
603;École doctorale Éducation, Langages, Interactions, Cognition, Clinique, Expertise - ED 603;ELICCE;6;Sciences humaines et humanités;2024;2023-24;2023;2023;31;18;13;137;80;57;36;16;20;4;10;12;10;1Mzw7
605;École doctorale Biologie Santé;ED BS;5;Biologie, médecine et santé;2024;2023-24;2023;2023;71;45;26;280;162;118;75;44;31;35;26;12;2;w8CxU
606;École doctorale Chimie - Mécanique - Matériaux - Physique;C2MP;8;Sciences pour l'ingénieur;2024;2023-24;2023;2023;36;14;22;132;37;95;33;10;23;16;10;7;0;UkNR2
607;École doctorale Sciences et Ingénierie des Ressources Naturelles;SIReNA;8;Sciences pour l'ingénieur;2024;2023-24;2023;2023;1;0;1;6;1;5;4;0;4;0;4;0;0;vi9w2
616;École doctorale Humanités et Langues;H&L;5;Biologie, médecine et santé;2024;2023-24;2023;2023;5;2;3;9;4;5;2;0;2;0;0;1;1;FYOlf
617;École doctorale Sciences de la Société : Territoires, Economie et Droit;SSTED;6;Sciences humaines et humanités;2024;2023-24;2023;2023;5;2;3;59;28;31;9;5;4;0;4;3;2;Kl9ZX
618;École doctorale EUCLIDE;;2;Physique;2024;2023-24;2023;2023;0;0;0;1;1;0;0;0;0;0;0;0;0;qveTN
618;École doctorale EUCLIDE;;6;Sciences humaines et humanités;2024;2023-24;2023;2023;10;6;4;21;15;6;3;1;2;0;2;0;1;qveTN
618;École doctorale EUCLIDE;;9;Sciences et technologies de l'information et de la communication;2024;2023-24;2023;2023;8;2;6;34;14;20;7;0;7;3;4;0;0;qveTN
619;École doctorale Sciences Fondamentales et Santé;SFS;3;Sciences de la terre et de l'univers, espace;2024;2023-24;2023;2023;0;0;0;2;0;2;0;0;0;0;0;0;0;JiZVW
619;École doctorale Sciences Fondamentales et Santé;SFS;6;Sciences humaines et humanités;2024;2023-24;2023;2023;0;0;0;0;0;0;1;0;1;0;0;1;0;JiZVW
619;École doctorale Sciences Fondamentales et Santé;SFS;7;Sciences de la société;2024;2023-24;2023;2023;0;0;0;1;0;1;0;0;0;0;0;0;0;JiZVW
619;École doctorale Sciences Fondamentales et Santé;SFS;8;Sciences pour l'ingénieur;2024;2023-24;2023;2023;0;0;0;2;0;2;0;0;0;0;0;0;0;JiZVW
620;École doctorale Sciences du Numérique et de l'Ingénieur;SNI;7;Sciences de la société;2024;2023-24;2023;2023;0;0;0;1;1;0;0;0;0;0;0;0;0;Dr40w
620;École doctorale Sciences du Numérique et de l'Ingénieur;SNI;8;Sciences pour l'ingénieur;2024;2023-24;2023;2023;10;2;8;35;8;27;11;6;5;4;7;0;0;Dr40w
623;École doctorale Savoir, Sciences, Éducation;SSE;6;Sciences humaines et humanités;2024;2023-24;2023;2023;10;5;5;59;33;26;17;14;3;1;4;7;5;98lMD
626;École doctorale de l’Institut Polytechnique de Paris;;7;Sciences de la société;2024;2023-24;2023;2023;26;11;15;100;46;54;23;8;15;1;9;11;2;DL5fO
634;École doctorale Sciences, Ingénierie, Environnement;SIE;10;Sciences agronomiques et écologiques;2024;2023-24;2023;2023;5;4;1;12;8;4;3;2;1;0;3;0;0;TOc8f
635;École doctorale Polytechnique Hauts-de-France;PHF;7;Sciences de la société;2024;2023-24;2023;2023;13;8;5;32;19;13;5;3;2;2;2;0;1;p2m23
635;École doctorale Polytechnique Hauts-de-France;PHF;9;Sciences et technologies de l'information et de la communication;2024;2023-24;2023;2023;18;6;12;83;29;54;20;8;12;10;6;3;1;p2m23
636;École doctorale Dynamique des environnements dans l'espace Caraïbes-Amériques;;2;Physique;2024;2023-24;2023;2023;0;0;0;1;1;0;1;0;1;0;0;1;0;s0yax
636;École doctorale Dynamique des environnements dans l'espace Caraïbes-Amériques;;5;Biologie, médecine et santé;2024;2023-24;2023;2023;14;8;6;37;19;18;15;8;7;4;5;6;0;s0yax
636;École doctorale Dynamique des environnements dans l'espace Caraïbes-Amériques;;8;Sciences pour l'ingénieur;2024;2023-24;2023;2023;0;0;0;3;1;2;0;0;0;0;0;0;0;s0yax
637;École doctorale Sciences de la vie et de la santé;SVS;5;Biologie, médecine et santé;2024;2023-24;2023;2023;85;47;38;264;134;130;75;42;33;38;25;8;4;3byga
638;École doctorale Science de la Matière, des Molécules et Matériaux;S3M;2;Physique;2024;2023-24;2023;2023;19;6;13;74;27;47;11;1;10;7;4;0;0;7artx
642;École doctorale Végétal, Animal, Aliment, Mer, Environnement;VAAME;3;Sciences de la terre et de l'univers, espace;2024;2023-24;2023;2023;4;0;4;13;4;9;3;1;2;1;2;0;0;jcs9y
642;École doctorale Végétal, Animal, Aliment, Mer, Environnement;VAAME;4;Chimie;2024;2023-24;2023;2023;0;0;0;0;0;0;2;0;2;1;1;0;0;jcs9y
642;École doctorale Végétal, Animal, Aliment, Mer, Environnement;VAAME;5;Biologie, médecine et santé;2024;2023-24;2023;2023;8;5;3;40;21;19;6;1;5;3;3;0;0;jcs9y
644;École doctorale Mathématiques & Sciences et Technologies de l'Information et de la Communication en Bretagne Océane;MathSTIC;9;Sciences et technologies de l'information et de la communication;2024;2023-24;2023;2023;23;2;21;96;25;71;24;9;15;14;9;1;0;e23n9
646;École doctorale Éducation, Langages, Interactions, Cognition, Clinique, Expertise;ELICCE;6;Sciences humaines et humanités;2024;2023-24;2023;2023;45;28;17;200;110;90;31;17;14;5;9;12;5;sdk5n
648;École doctorale Sciences pour l'ingénieur et le Numérique;SPIN;1;Mathématiques et leurs interactions;2024;2023-24;2023;2023;3;1;2;6;1;5;1;0;1;0;1;0;0;nz3qg
648;École doctorale Sciences pour l'ingénieur et le Numérique;SPIN;2;Physique;2024;2023-24;2023;2023;2;0;2;13;1;12;1;0;1;1;0;0;0;nz3qg
648;École doctorale Sciences pour l'ingénieur et le Numérique;SPIN;7;Sciences de la société;2024;2023-24;2023;2023;3;2;1;7;2;5;1;0;1;0;1;0;0;nz3qg
648;École doctorale Sciences pour l'ingénieur et le Numérique;SPIN;8;Sciences pour l'ingénieur;2024;2023-24;2023;2023;22;15;7;82;30;52;23;14;9;13;9;1;0;nz3qg
653;École doctorale Sciences et Ingénierie;S&I;1;Mathématiques et leurs interactions;2024;2023-24;2023;2023;6;2;4;11;3;8;2;1;1;1;0;1;0;vpw2d
653;École doctorale Sciences et Ingénierie;S&I;4;Chimie;2024;2023-24;2023;2023;25;8;17;86;28;58;15;5;10;10;5;0;0;vpw2d
653;École doctorale Sciences et Ingénierie;S&I;10;Sciences agronomiques et écologiques;2024;2023-24;2023;2023;0;0;0;1;0;1;1;0;1;1;0;0;0;vpw2d
654;École doctorale Littératures, Sciences Humaines et Sociales;SHS;7;Sciences de la société;2024;2023-24;2023;2023;1;0;1;9;6;3;0;0;0;0;0;0;0;k2ywn
655;École doctorale Gouvernance des Institutions et des Organisations;;6;Sciences humaines et humanités;2024;2023-24;2023;2023;0;0;0;2;0;2;1;0;1;0;0;1;0;izw4r
7;École doctorale Georges Vedel - Droit public interne, science administrative et science politique;;7;Sciences de la société;2024;2023-24;2023;2023;20;8;12;137;60;77;9;2;7;1;3;1;4;Dw881
22;École doctorale Mondes anciens et médiévaux;;6;Sciences humaines et humanités;2024;2023-24;2023;2023;19;11;8;148;90;58;12;4;8;2;4;2;4;fqCbl
39;École doctorale Mathématiques et Informatique;EDMIB;1;Mathématiques et leurs interactions;2024;2023-24;2023;2023;26;3;23;102;19;83;29;7;22;15;12;2;0;TBj2X
39;École doctorale Mathématiques et Informatique;EDMIB;8;Sciences pour l'ingénieur;2024;2023-24;2023;2023;0;0;0;1;0;1;0;0;0;0;0;0;0;TBj2X
39;École doctorale Mathématiques et Informatique;EDMIB;9;Sciences et technologies de l'information et de la communication;2024;2023-24;2023;2023;37;7;30;129;34;95;29;8;21;12;15;2;0;TBj2X
40;École doctorale Sciences chimiques;EDSC;5;Biologie, médecine et santé;2024;2023-24;2023;2023;2;0;2;5;2;3;6;4;2;2;3;1;0;wde3D
50;École doctorale Langues, littératures et sciences humaines;LLSH;9;Sciences et technologies de l'information et de la communication;2024;2023-24;2023;2023;0;0;0;26;14;12;2;1;1;0;0;1;1;8THzQ
52;École doctorale Physique et astrophysique de Lyon;PHAST;2;Physique;2024;2023-24;2023;2023;46;11;35;180;46;134;45;8;37;35;10;0;0;61XPb
58;École doctorale Langues, littératures, cultures, civilisations;LLCC;6;Sciences humaines et humanités;2024;2023-24;2023;2023;73;44;29;427;251;176;61;33;28;6;15;14;26;I9ATR
62;École doctorale Sciences de la vie et de la santé;;2;Physique;2024;2023-24;2023;2023;0;0;0;2;1;1;0;0;0;0;0;0;0;vZzE7
62;École doctorale Sciences de la vie et de la santé;;10;Sciences agronomiques et écologiques;2024;2023-24;2023;2023;0;0;0;0;0;0;4;1;3;2;2;0;0;vZzE7
65;École doctorale Sciences de la Vie, Santé, Agronomie, Environnement;;5;Biologie, médecine et santé;2024;2023-24;2023;2023;60;44;16;242;160;82;58;33;25;21;30;7;0;MAOG4
71;École doctorale Sciences pour l'ingénieur;;6;Sciences humaines et humanités;2024;2023-24;2023;2023;3;2;1;10;6;4;1;1;0;0;0;0;1;H6UYp
71;École doctorale Sciences pour l'ingénieur;;9;Sciences et technologies de l'information et de la communication;2024;2023-24;2023;2023;4;1;3;11;3;8;5;1;4;2;3;0;0;H6UYp
71;École doctorale Sciences pour l'ingénieur;;10;Sciences agronomiques et écologiques;2024;2023-24;2023;2023;3;2;1;5;4;1;0;0;0;0;0;0;0;H6UYp
74;École doctorale Sciences juridiques, politique et de gestion;SJPG;7;Sciences de la société;2024;2023-24;2023;2023;33;17;16;236;118;118;20;9;11;1;5;4;10;3A2RY
105;École doctorale Terre, univers, environnement;;3;Sciences de la terre et de l'univers, espace;2024;2023-24;2023;2023;62;29;33;181;78;103;43;16;27;17;24;2;0;lcWAf
119;École doctorale Science politique;;7;Sciences de la société;2024;2023-24;2023;2023;18;12;6;94;48;46;8;7;1;0;0;0;8;eyibb
120;École doctorale Littérature française et comparée;;6;Sciences humaines et humanités;2024;2023-24;2023;2023;38;28;10;212;154;58;29;21;8;2;9;7;11;3ULpe
122;École doctorale Europe latine - Amérique latine;;6;Sciences humaines et humanités;2024;2023-24;2023;2023;18;11;7;112;76;36;18;10;8;0;5;3;10;z9lZY
129;École doctorale Sciences de l'environnement d'Ile de France;SEIF;8;Sciences pour l'ingénieur;2024;2023-24;2023;2023;0;0;0;1;0;1;0;0;0;0;0;0;0;TnAPh
130;École doctorale Informatique, télécommunications et électronique de Paris;EDITE;2;Physique;2024;2023-24;2023;2023;0;0;0;1;1;0;0;0;0;0;0;0;0;O5ysj
139;École doctorale Connaissance, langage, modélisation;CLM;5;Biologie, médecine et santé;2024;2023-24;2023;2023;3;2;1;8;7;1;0;0;0;0;0;0;0;1lxGH
139;École doctorale Connaissance, langage, modélisation;CLM;7;Sciences de la société;2024;2023-24;2023;2023;0;0;0;5;2;3;1;1;0;0;0;1;0;1lxGH
139;École doctorale Connaissance, langage, modélisation;CLM;8;Sciences pour l'ingénieur;2024;2023-24;2023;2023;11;2;9;17;3;14;1;0;1;0;0;1;0;1lxGH
146;École doctorale Galilée;GALILEE;5;Biologie, médecine et santé;2024;2023-24;2023;2023;11;5;6;57;35;22;10;7;3;3;5;2;0;71hqm
146;École doctorale Galilée;GALILEE;9;Sciences et technologies de l'information et de la communication;2024;2023-24;2023;2023;11;4;7;50;17;33;15;4;11;9;5;1;0;71hqm
158;École doctorale Cerveau, cognition, comportement;3C;5;Biologie, médecine et santé;2024;2023-24;2023;2023;130;80;50;450;266;184;107;55;52;30;63;14;0;Il62F
158;École doctorale Cerveau, cognition, comportement;3C;7;Sciences de la société;2024;2023-24;2023;2023;0;0;0;1;0;1;0;0;0;0;0;0;0;Il62F
162;École doctorale Mécanique, énergétique, génie civil, acoustique;MEGA;8;Sciences pour l'ingénieur;2024;2023-24;2023;2023;69;14;55;345;93;252;118;26;92;55;51;12;0;7wCke
166;École doctorale Information, structures et systèmes;I2S;2;Physique;2024;2023-24;2023;2023;15;6;9;56;16;40;24;6;18;16;8;0;0;2uO68
166;École doctorale Information, structures et systèmes;I2S;3;Sciences de la terre et de l'univers, espace;2024;2023-24;2023;2023;0;0;0;1;0;1;0;0;0;0;0;0;0;2uO68
168;École doctorale Sciences chimiques et biologiques pour la santé;SCBS;5;Biologie, médecine et santé;2024;2023-24;2023;2023;126;82;44;462;277;185;128;71;57;44;68;16;0;8cEME
171;École doctorale Toulouse sciences économiques;TSE;7;Sciences de la société;2024;2023-24;2023;2023;12;4;8;80;21;59;18;8;10;0;0;14;4;Q5nNQ
173;École doctorale Sciences de l'univers, de l'environnement et de l'espace;SDU2E;9;Sciences et technologies de l'information et de la communication;2024;2023-24;2023;2023;2;1;1;7;1;6;1;0;1;1;0;0;0;R0Z9c
182;École doctorale Physique et chimie-physique;;8;Sciences pour l'ingénieur;2024;2023-24;2023;2023;2;0;2;7;2;5;0;0;0;0;0;0;0;3My6I
205;École doctorale Interdisciplinaire Sciences-Santé;EDISS;4;Chimie;2024;2023-24;2023;2023;0;0;0;1;0;1;0;0;0;0;0;0;0;69W38
205;École doctorale Interdisciplinaire Sciences-Santé;EDISS;5;Biologie, médecine et santé;2024;2023-24;2023;2023;52;22;30;247;151;96;67;45;22;31;28;8;0;69W38
209;École doctorale Sciences physiques et de L'ingénieur;SPI;9;Sciences et technologies de l'information et de la communication;2024;2023-24;2023;2023;48;12;36;158;39;119;45;10;35;24;18;3;0;tZcIZ
211;École doctorale Sciences exactes et leurs applications;ED SEA;4;Chimie;2024;2023-24;2023;2023;25;12;13;85;41;44;35;16;19;19;15;1;0;1G1iC
211;École doctorale Sciences exactes et leurs applications;ED SEA;9;Sciences et technologies de l'information et de la communication;2024;2023-24;2023;2023;5;2;3;18;7;11;1;0;1;0;1;0;0;1G1iC
216;École doctorale Ingénierie pour la santé, la cognition, l'environnement;EDISCE;5;Biologie, médecine et santé;2024;2023-24;2023;2023;67;37;30;223;118;105;64;31;33;29;27;4;4;fPs1t
218;École doctorale Chimie et sciences du vivant;EDCSV;10;Sciences agronomiques et écologiques;2024;2023-24;2023;2023;11;7;4;55;30;25;16;9;7;9;7;0;0;8bcJh
221;École doctorale Augustin Cournot - Sciences économiques et de gestion - Sciences, technologies et sociétés;EDAC;7;Sciences de la société;2024;2023-24;2023;2023;28;12;16;84;35;49;18;11;7;6;8;2;2;5z9rW
222;École doctorale Sciences chimiques;EDSC;5;Biologie, médecine et santé;2024;2023-24;2023;2023;2;1;1;6;2;4;0;0;0;0;0;0;0;AdU8Q
222;École doctorale Sciences chimiques;EDSC;8;Sciences pour l'ingénieur;2024;2023-24;2023;2023;2;2;0;7;5;2;2;0;2;1;1;0;0;AdU8Q
224;École doctorale Cognition, langage, interaction;;1;Mathématiques et leurs interactions;2024;2023-24;2023;2023;2;0;2;12;1;11;1;1;0;0;1;0;0;7v43e
227;École doctorale Sciences de la nature et de l'homme;;3;Sciences de la terre et de l'univers, espace;2024;2023-24;2023;2023;11;8;3;28;15;13;7;2;5;2;4;0;1;xiDA5
261;École doctorale Cognition, comportements, conduites humaines;3CH;6;Sciences humaines et humanités;2024;2023-24;2023;2023;37;26;11;161;116;45;33;25;8;9;14;10;0;KOLCy
269;École doctorale Mathématiques, sciences de l'information et de l'ingénieur;MSII;8;Sciences pour l'ingénieur;2024;2023-24;2023;2023;34;12;22;133;43;90;50;11;39;22;18;10;0;5E625
286;École doctorale de l'Ehess;;6;Sciences humaines et humanités;2024;2023-24;2023;2023;70;38;32;444;238;206;45;21;24;2;9;15;19;2S146
305;École doctorale Énergie et environnement;E2;2;Physique;2024;2023-24;2023;2023;0;0;0;4;0;4;5;0;5;1;3;1;0;Kbt8I
305;École doctorale Énergie et environnement;E2;3;Sciences de la terre et de l'univers, espace;2024;2023-24;2023;2023;4;3;1;8;3;5;6;1;5;2;3;0;1;Kbt8I
305;École doctorale Énergie et environnement;E2;9;Sciences et technologies de l'information et de la communication;2024;2023-24;2023;2023;1;0;1;5;2;3;0;0;0;0;0;0;0;Kbt8I
309;École doctorale Systèmes;EDSYS;1;Mathématiques et leurs interactions;2024;2023-24;2023;2023;5;0;5;6;1;5;0;0;0;0;0;0;0;8TT4b
309;École doctorale Systèmes;EDSYS;8;Sciences pour l'ingénieur;2024;2023-24;2023;2023;27;8;19;81;20;61;17;4;13;11;5;1;0;8TT4b
323;École doctorale Génie électrique, électronique et télécommunications;GEET;1;Mathématiques et leurs interactions;2024;2023-24;2023;2023;0;0;0;1;1;0;0;0;0;0;0;0;0;arcz6
323;École doctorale Génie électrique, électronique et télécommunications;GEET;5;Biologie, médecine et santé;2024;2023-24;2023;2023;3;2;1;5;2;3;3;2;1;1;2;0;0;arcz6
326;École doctorale Comportement, langage, éducation, socialisation, cognition;CLESCO;5;Biologie, médecine et santé;2024;2023-24;2023;2023;8;3;5;39;25;14;4;3;1;3;1;0;0;nWIlG
327;École doctorale Temps, espaces, sociétés, cultures;TESC;3;Sciences de la terre et de l'univers, espace;2024;2023-24;2023;2023;0;0;0;3;1;2;0;0;0;0;0;0;0;IjgiJ
328;École doctorale Arts, lettres, langues, philosophie et communication;ALLPH@;5;Biologie, médecine et santé;2024;2023-24;2023;2023;0;0;0;1;1;0;0;0;0;0;0;0;0;xLxMh
341;École doctorale Évolution, écosystèmes, microbiologie, modélisation;E2M2;3;Sciences de la terre et de l'univers, espace;2024;2023-24;2023;2023;0;0;0;2;2;0;0;0;0;0;0;0;0;J83I0
355;École doctorale Espaces, cultures, sociétés;;6;Sciences humaines et humanités;2024;2023-24;2023;2023;37;14;23;188;99;89;30;10;20;1;7;9;13;2kMf5
361;École doctorale Sciences et Technologies;ED ST;8;Sciences pour l'ingénieur;2024;2023-24;2023;2023;5;2;3;37;10;27;6;2;4;4;1;1;0;cOUmL
364;École doctorale Sciences fondamentales et appliquées;EDSFA;2;Physique;2024;2023-24;2023;2023;33;8;25;88;26;62;21;1;20;12;8;1;0;E483q
364;École doctorale Sciences fondamentales et appliquées;EDSFA;3;Sciences de la terre et de l'univers, espace;2024;2023-24;2023;2023;29;12;17;74;29;45;20;5;15;8;10;1;1;E483q
364;École doctorale Sciences fondamentales et appliquées;EDSFA;8;Sciences pour l'ingénieur;2024;2023-24;2023;2023;4;1;3;43;13;30;15;4;11;8;7;0;0;E483q
377;École doctorale Environnement et société;;4;Chimie;2024;2023-24;2023;2023;1;1;0;5;2;3;1;0;1;0;1;0;0;ZMG5u
377;École doctorale Environnement et société;;10;Sciences agronomiques et écologiques;2024;2023-24;2023;2023;2;2;0;7;5;2;2;2;0;0;2;0;0;ZMG5u
386;École doctorale Sciences mathématiques de Paris centre;SMPC;1;Mathématiques et leurs interactions;2024;2023-24;2023;2023;103;16;87;455;83;372;115;28;87;55;46;13;1;wMj98
394;École doctorale Physiologie et physiopathologie;p2t;5;Biologie, médecine et santé;2024;2023-24;2023;2023;65;39;26;249;152;97;44;23;21;19;22;3;0;VMYmT
395;École doctorale Milieux, cultures et sociétés du passé et du présent;MCSPP;6;Sciences humaines et humanités;2024;2023-24;2023;2023;30;17;13;176;115;61;24;16;8;0;2;7;15;2quEb
396;École doctorale Économie, organisations, société;EOS;6;Sciences humaines et humanités;2024;2023-24;2023;2023;4;0;4;9;2;7;0;0;0;0;0;0;0;Es5e7
396;École doctorale Économie, organisations, société;EOS;7;Sciences de la société;2024;2023-24;2023;2023;36;20;16;149;72;77;24;8;16;3;11;4;6;Es5e7
397;École doctorale Physique et chimie des matériaux;;4;Chimie;2024;2023-24;2023;2023;53;26;27;145;71;74;56;26;30;48;7;1;0;WxSt9
402;École doctorale Sciences de la vie et de la santé;SVS;8;Sciences pour l'ingénieur;2024;2023-24;2023;2023;0;0;0;2;1;1;0;0;0;0;0;0;0;YKgsU
413;École doctorale Sciences de la terre et de l'environnement;STE;3;Sciences de la terre et de l'univers, espace;2024;2023-24;2023;2023;17;6;11;65;25;40;9;1;8;4;3;2;0;u9BA9
417;École doctorale Sciences et Ingénierie;S&I;2;Physique;2024;2023-24;2023;2023;4;0;4;8;2;6;0;0;0;0;0;0;0;SSBvE
417;École doctorale Sciences et Ingénierie;S&I;8;Sciences pour l'ingénieur;2024;2023-24;2023;2023;11;4;7;45;17;28;13;3;10;5;7;1;0;SSBvE
446;École doctorale Biologie - Santé;EDBSL;1;Mathématiques et leurs interactions;2024;2023-24;2023;2023;0;0;0;1;1;0;0;0;0;0;0;0;0;4iEUF
446;École doctorale Biologie - Santé;EDBSL;6;Sciences humaines et humanités;2024;2023-24;2023;2023;0;0;0;3;0;3;2;1;1;1;1;0;0;4iEUF
467;École doctorale Aéronautique, astronautique;AA;9;Sciences et technologies de l'information et de la communication;2024;2023-24;2023;2023;0;0;0;7;3;4;5;1;4;2;3;0;0;U7l45
468;École doctorale Mécanique, énergétique, génie civil, procédés;MEGEP;3;Sciences de la terre et de l'univers, espace;2024;2023-24;2023;2023;1;1;0;1;1;0;0;0;0;0;0;0;0;4XUTB
469;École doctorale du Pacifique;EDP;7;Sciences de la société;2024;2023-24;2023;2023;6;4;2;15;10;5;1;1;0;0;1;0;0;t9Z2n
472;École doctorale de l'EPHE;;1;Mathématiques et leurs interactions;2024;2023-24;2023;2023;0;0;0;4;1;3;0;0;0;0;0;0;0;27zK4
474;École doctorale Interdisciplinaire européenne frontières du vivant;FDV;1;Mathématiques et leurs interactions;2024;2023-24;2023;2023;0;0;0;1;0;1;0;0;0;0;0;0;0;E727j
474;École doctorale Interdisciplinaire européenne frontières du vivant;FDV;4;Chimie;2024;2023-24;2023;2023;1;1;0;1;1;0;0;0;0;0;0;0;0;E727j
480;École doctorale Montaigne-humanités;;2;Physique;2024;2023-24;2023;2023;1;1;0;9;4;5;3;2;1;0;1;2;0;f3SeZ
481;École doctorale Sciences sociales et humanités;SSH;6;Sciences humaines et humanités;2024;2023-24;2023;2023;23;12;11;122;66;56;11;5;6;2;3;2;4;E3z5j
482;École doctorale Sciences de la matière;SDM;4;Chimie;2024;2023-24;2023;2023;55;25;30;191;87;104;69;27;42;38;28;3;0;kmeZ4
483;École doctorale Histoire, géographie, aménagement, urbanisme, archéologie, science politique, sociologie, anthropologie;SCSO;6;Sciences humaines et humanités;2024;2023-24;2023;2023;49;23;26;290;154;136;50;31;19;1;8;19;22;hc6u4
487;École doctorale Philosophie;PHCR;6;Sciences humaines et humanités;2024;2023-24;2023;2023;15;6;9;130;61;69;17;8;9;0;2;5;10;3BRzJ
488;École doctorale Sciences, ingénierie, santé;SIS;3;Sciences de la terre et de l'univers, espace;2024;2023-24;2023;2023;2;1;1;7;3;4;2;2;0;0;2;0;0;Fy2lK
488;École doctorale Sciences, ingénierie, santé;SIS;4;Chimie;2024;2023-24;2023;2023;4;4;0;15;9;6;4;0;4;2;2;0;0;Fy2lK
488;École doctorale Sciences, ingénierie, santé;SIS;5;Biologie, médecine et santé;2024;2023-24;2023;2023;23;13;10;104;51;53;21;9;12;11;7;3;0;Fy2lK
488;École doctorale Sciences, ingénierie, santé;SIS;10;Sciences agronomiques et écologiques;2024;2023-24;2023;2023;0;0;0;2;1;1;2;2;0;1;1;0;0;Fy2lK
493;École doctorale Erasme;;7;Sciences de la société;2024;2023-24;2023;2023;34;11;23;158;73;85;23;11;12;2;3;9;9;FPW4T
497;École doctorale Normande de Biologie Intégrative, Santé, Environnement;Ed NBISE;10;Sciences agronomiques et écologiques;2024;2023-24;2023;2023;3;0;3;10;2;8;0;0;0;0;0;0;0;0D9Je
509;École doctorale Civilisations et sociétés euro-méditerranéennes et comparées;;7;Sciences de la société;2024;2023-24;2023;2023;25;11;14;114;50;64;15;6;9;2;1;2;10;9tbyG
513;École doctorale Droit et sciences politiques, économiques et de gestion;DESPEG;5;Biologie, médecine et santé;2024;2023-24;2023;2023;0;0;0;1;0;1;0;0;0;0;0;0;0;aVHGU
529;École doctorale Cultures et sociétés;CS;6;Sciences humaines et humanités;2024;2023-24;2023;2023;47;21;26;231;136;95;26;14;12;2;10;2;12;XU9tb
532;École doctorale Mathématiques et sciences et technologies de l'information et de la communication;MSTIC;3;Sciences de la terre et de l'univers, espace;2024;2023-24;2023;2023;1;0;1;1;0;1;0;0;0;0;0;0;0;t43KM
536;École doctorale Sciences et agrosciences;;1;Mathématiques et leurs interactions;2024;2023-24;2023;2023;2;1;1;3;1;2;2;0;2;2;0;0;0;pHfqe
537;École doctorale Culture et patrimoine;C&P;6;Sciences humaines et humanités;2024;2023-24;2023;2023;10;7;3;62;30;32;11;4;7;1;1;6;3;GxI4a
540;"École doctorale École transdisciplinaire ""lettres/sciences""";;2;Physique;2024;2023-24;2023;2023;0;0;0;1;1;0;0;0;0;0;0;0;0;tWWw7
540;"École doctorale École transdisciplinaire ""lettres/sciences""";;4;Chimie;2024;2023-24;2023;2023;0;0;0;1;0;1;0;0;0;0;0;0;0;tWWw7
542;École doctorale de sciences de La Réunion;STS;9;Sciences et technologies de l'information et de la communication;2024;2023-24;2023;2023;1;0;1;5;2;3;1;0;1;1;0;0;0;2pAql
543;École doctorale de Dauphine;;1;Mathématiques et leurs interactions;2024;2023-24;2023;2023;14;7;7;54;9;45;13;4;9;5;6;2;0;u8w6A
543;École doctorale de Dauphine;;9;Sciences et technologies de l'information et de la communication;2024;2023-24;2023;2023;14;5;9;55;19;36;6;1;5;4;1;1;0;u8w6A
544;École doctorale Inter-Med : Espaces, temps, cultures;INTER-MED;7;Sciences de la société;2024;2023-24;2023;2023;16;9;7;116;50;66;16;3;13;2;4;6;4;7VjtD
548;École doctorale Mer et Sciences;;3;Sciences de la terre et de l'univers, espace;2024;2023-24;2023;2023;2;1;1;9;7;2;1;1;0;1;0;0;0;QX0fS
548;École doctorale Mer et Sciences;;9;Sciences et technologies de l'information et de la communication;2024;2023-24;2023;2023;13;2;11;32;7;25;4;1;3;3;1;0;0;QX0fS
551;École doctorale Mathématiques, Informatique, Physique Théorique et Ingénierie des Systèmes;MIPTIS;8;Sciences pour l'ingénieur;2024;2023-24;2023;2023;4;2;2;14;8;6;3;0;3;0;2;0;1;Mpudz
552;École doctorale Énergie - Matériaux - Sciences de la Terre et de l'Univers;EMTSU;8;Sciences pour l'ingénieur;2024;2023-24;2023;2023;24;4;20;102;24;78;39;10;29;17;16;5;1;NTZhw
553;École doctorale Carnot - Pasteur;;2;Physique;2024;2023-24;2023;2023;14;5;9;43;15;28;10;3;7;4;4;1;1;6h4Z7
556;École doctorale Homme, Sociétés, Risques, Territoire;HSRT;7;Sciences de la société;2024;2023-24;2023;2023;37;19;18;172;91;81;34;18;16;7;8;13;6;5QEaX
559;École doctorale Management Panthéon-Sorbonne;;7;Sciences de la société;2024;2023-24;2023;2023;28;12;16;190;94;96;22;17;5;1;5;11;5;4SP7k
563;École doctorale Médicament - Toxicologie - Chimie - Imageries;MTCI;4;Chimie;2024;2023-24;2023;2023;16;10;6;50;26;24;18;9;9;6;12;0;0;j8uk1
566;École doctorale Sciences du Sport, de la Motricité et du Mouvement Humain;SMMH;6;Sciences humaines et humanités;2024;2023-24;2023;2023;7;1;6;33;13;20;8;6;2;2;5;0;1;3iv8y
570;École doctorale Santé Publique;EDSP;6;Sciences humaines et humanités;2024;2023-24;2023;2023;1;1;0;7;4;3;1;1;0;0;0;1;0;9lgE4
570;École doctorale Santé Publique;EDSP;7;Sciences de la société;2024;2023-24;2023;2023;0;0;0;0;0;0;1;0;1;0;1;0;0;9lgE4
571;École doctorale Sciences Chimiques : Molécules, Matériaux, Instrumentation et Biosystemes;2MIB;2;Physique;2024;2023-24;2023;2023;7;2;5;25;10;15;7;2;5;4;2;1;0;zbi37
573;École doctorale Interfaces : Approches Interdisciplinaires, Fondements, Applications et Innovation;ED INTERFACES;2;Physique;2024;2023-24;2023;2023;4;0;4;10;4;6;7;2;5;3;4;0;0;gG820
573;École doctorale Interfaces : Approches Interdisciplinaires, Fondements, Applications et Innovation;ED INTERFACES;8;Sciences pour l'ingénieur;2024;2023-24;2023;2023;51;16;35;86;30;56;17;3;14;6;11;0;0;gG820
573;École doctorale Interfaces : Approches Interdisciplinaires, Fondements, Applications et Innovation;ED INTERFACES;10;Sciences agronomiques et écologiques;2024;2023-24;2023;2023;0;0;0;1;1;0;0;0;0;0;0;0;0;gG820
575;École doctorale Electrical, Optical, Bio : Physics and Engineering;EOBE;2;Physique;2024;2023-24;2023;2023;1;1;0;40;19;21;28;10;18;12;12;4;0;dfhyn
579;École doctorale Sciences mécaniques et energétiques, matériaux et géosciences;SMEMaG;3;Sciences de la terre et de l'univers, espace;2024;2023-24;2023;2023;11;5;6;33;13;20;16;4;12;6;8;2;0;atMj7
579;École doctorale Sciences mécaniques et energétiques, matériaux et géosciences;SMEMaG;8;Sciences pour l'ingénieur;2024;2023-24;2023;2023;57;14;43;250;60;190;63;17;46;33;24;5;1;atMj7
581;École doctorale Agriculture, alimentation, biologie, environnement, santé;ABIES;1;Mathématiques et leurs interactions;2024;2023-24;2023;2023;1;1;0;3;1;2;2;1;1;2;0;0;0;c1x56
581;École doctorale Agriculture, alimentation, biologie, environnement, santé;ABIES;6;Sciences humaines et humanités;2024;2023-24;2023;2023;3;1;2;19;10;9;1;1;0;0;1;0;0;c1x56
582;École doctorale Cancérologie, Biologie, Médecine, Santé;CBMS;2;Physique;2024;2023-24;2023;2023;0;0;0;1;1;0;0;0;0;0;0;0;0;75bj4
584;École doctorale Biodiversité, Agriculture, Alimentation, Environnement, Terre, Eau;GAIA;10;Sciences agronomiques et écologiques;2024;2023-24;2023;2023;86;41;45;320;163;157;139;80;59;71;60;8;0;F1h5f
585;École doctorale Sciences, Technologie,  Sante;EDSTS;1;Mathématiques et leurs interactions;2024;2023-24;2023;2023;10;5;5;36;14;22;12;6;6;6;4;2;0;NM3Dl
585;École doctorale Sciences, Technologie,  Sante;EDSTS;2;Physique;2024;2023-24;2023;2023;10;2;8;41;15;26;10;5;5;5;4;1;0;NM3Dl
585;École doctorale Sciences, Technologie,  Sante;EDSTS;5;Biologie, médecine et santé;2024;2023-24;2023;2023;40;24;16;118;64;54;25;20;5;14;7;3;1;NM3Dl
587;École doctorale Diversites, santé et développement en Amazonie;;3;Sciences de la terre et de l'univers, espace;2024;2023-24;2023;2023;0;0;0;2;1;1;0;0;0;0;0;0;0;V14tj
587;École doctorale Diversites, santé et développement en Amazonie;;4;Chimie;2024;2023-24;2023;2023;1;1;0;4;3;1;1;0;1;1;0;0;0;V14tj
587;École doctorale Diversites, santé et développement en Amazonie;;5;Biologie, médecine et santé;2024;2023-24;2023;2023;7;6;1;25;15;10;4;2;2;2;1;1;0;V14tj
587;École doctorale Diversites, santé et développement en Amazonie;;6;Sciences humaines et humanités;2024;2023-24;2023;2023;5;2;3;16;11;5;2;2;0;0;0;0;2;V14tj
590;École doctorale Mathematiques, Information, Ingenierie des Systemes;MIIS;1;Mathématiques et leurs interactions;2024;2023-24;2023;2023;14;3;11;58;14;44;11;2;9;7;4;0;0;L20t5
590;École doctorale Mathematiques, Information, Ingenierie des Systemes;MIIS;9;Sciences et technologies de l'information et de la communication;2024;2023-24;2023;2023;35;8;27;156;34;122;36;8;28;19;15;2;0;L20t5
591;École doctorale Physique, Sciences de l'Ingenieur, Materiaux, Énergie;PSIME;4;Chimie;2024;2023-24;2023;2023;6;4;2;47;19;28;12;2;10;9;3;0;0;Hn5Om
591;École doctorale Physique, Sciences de l'Ingenieur, Materiaux, Énergie;PSIME;8;Sciences pour l'ingénieur;2024;2023-24;2023;2023;40;17;23;184;66;118;43;15;28;20;21;2;0;Hn5Om
595;École doctorale Arts, Lettres, Langues;ED ALL;6;Sciences humaines et humanités;2024;2023-24;2023;2023;30;21;9;208;131;77;22;7;15;2;3;6;11;a8f9b
598;École doctorale Sciences de La Mer et du Littoral;SML;3;Sciences de la terre et de l'univers, espace;2024;2023-24;2023;2023;23;13;10;69;39;30;23;12;11;2;15;5;1;Smen6
602;École doctorale Sciences pour l'Ingénieur;SPI;8;Sciences pour l'ingénieur;2024;2023-24;2023;2023;82;27;55;310;96;214;96;23;73;43;38;13;2;8yWbu
612;École doctorale Humanités;;6;Sciences humaines et humanités;2024;2023-24;2023;2023;35;20;15;175;95;80;29;10;19;1;8;7;13;v30I8
616;École doctorale Humanités et Langues;H&L;6;Sciences humaines et humanités;2024;2023-24;2023;2023;67;43;24;278;154;124;33;15;18;2;8;11;12;FYOlf
617;École doctorale Sciences de la Société : Territoires, Economie et Droit;SSTED;3;Sciences de la terre et de l'univers, espace;2024;2023-24;2023;2023;0;0;0;0;0;0;2;1;1;0;0;1;1;Kl9ZX
618;École doctorale EUCLIDE;;4;Chimie;2024;2023-24;2023;2023;6;2;4;26;11;15;4;1;3;3;1;0;0;qveTN
620;École doctorale Sciences du Numérique et de l'Ingénieur;SNI;9;Sciences et technologies de l'information et de la communication;2024;2023-24;2023;2023;8;1;7;28;6;22;18;4;14;11;5;2;0;Dr40w
620;École doctorale Sciences du Numérique et de l'Ingénieur;SNI;10;Sciences agronomiques et écologiques;2024;2023-24;2023;2023;0;0;0;0;0;0;1;1;0;0;1;0;0;Dr40w
624;École doctorale Sciences des Sociétés;SDS;6;Sciences humaines et humanités;2024;2023-24;2023;2023;24;12;12;132;71;61;24;13;11;0;3;11;10;cGIjW
624;École doctorale Sciences des Sociétés;SDS;7;Sciences de la société;2024;2023-24;2023;2023;24;15;9;147;95;52;25;16;9;0;4;7;14;cGIjW
629;École doctorale Sciences sociales et Humanités;SSH;6;Sciences humaines et humanités;2024;2023-24;2023;2023;29;21;8;117;61;56;15;4;11;3;0;6;6;nnSns
633;École doctorale Cultures, Sociétés, Territoires;CST;6;Sciences humaines et humanités;2024;2023-24;2023;2023;6;3;3;49;29;20;10;5;5;4;3;1;2;54818
633;École doctorale Cultures, Sociétés, Territoires;CST;7;Sciences de la société;2024;2023-24;2023;2023;12;6;6;42;22;20;14;11;3;3;5;2;4;54818
634;École doctorale Sciences, Ingénierie, Environnement;SIE;9;Sciences et technologies de l'information et de la communication;2024;2023-24;2023;2023;5;2;3;27;10;17;2;1;1;1;1;0;0;TOc8f
635;École doctorale Polytechnique Hauts-de-France;PHF;1;Mathématiques et leurs interactions;2024;2023-24;2023;2023;3;2;1;9;4;5;0;0;0;0;0;0;0;p2m23
636;École doctorale Dynamique des environnements dans l'espace Caraïbes-Amériques;;6;Sciences humaines et humanités;2024;2023-24;2023;2023;23;14;9;69;43;26;9;6;3;0;0;6;3;s0yax
636;École doctorale Dynamique des environnements dans l'espace Caraïbes-Amériques;;9;Sciences et technologies de l'information et de la communication;2024;2023-24;2023;2023;1;0;1;2;0;2;1;1;0;0;1;0;0;s0yax
636;École doctorale Dynamique des environnements dans l'espace Caraïbes-Amériques;;10;Sciences agronomiques et écologiques;2024;2023-24;2023;2023;4;3;1;9;5;4;2;2;0;0;2;0;0;s0yax
638;École doctorale Science de la Matière, des Molécules et Matériaux;S3M;9;Sciences et technologies de l'information et de la communication;2024;2023-24;2023;2023;0;0;0;1;1;0;0;0;0;0;0;0;0;7artx
641;École doctorale Mathématiques et Sciences et Technologies du numérique, de l’Information et de la Communication;MaSTIC;1;Mathématiques et leurs interactions;2024;2023-24;2023;2023;23;5;18;62;14;48;16;1;15;8;3;4;1;4kq8w
641;École doctorale Mathématiques et Sciences et Technologies du numérique, de l’Information et de la Communication;MaSTIC;8;Sciences pour l'ingénieur;2024;2023-24;2023;2023;9;3;6;24;8;16;9;4;5;5;2;2;0;4kq8w
650;École doctorale Humains en Société;;7;Sciences de la société;2024;2023-24;2023;2023;18;10;8;87;42;45;13;5;8;4;1;3;5;llpbd
